Place,Total Housing Units,Occupied Units,Vacant Units,State ID,Place ID,Vacancy Rate
"Sibley village, Missouri",157,145,12,29,67718,7.643312101910828
"Laurel city, Mississippi",8053,6833,1220,28,39640,15.1496336768906
"Leland city, Mississippi",1954,1660,294,28,40280,15.046059365404298
"Corinth city, Mississippi",7253,6041,1212,28,15700,16.710326761340134
"Sullivan city, Missouri",3332,2946,386,29,71440,11.584633853541417
"Lewistown town, Missouri",329,277,52,29,41852,15.80547112462006
"Sugar Creek city, Missouri",1508,1393,115,29,71368,7.625994694960212
"La Grange city, Missouri",469,409,60,29,39764,12.79317697228145
"Livonia village, Missouri",52,19,33,29,43454,63.46153846153846
"Hunnewell city, Missouri",114,81,33,29,33760,28.947368421052634
"Center city, Missouri",256,203,53,29,12592,20.703125
"Puxico city, Missouri",460,370,90,29,60284,19.565217391304348
"Chamois city, Missouri",247,184,63,29,13060,25.506072874493928
"Linn city, Missouri",763,617,146,29,43238,19.134993446920053
"Doniphan city, Missouri",1056,885,171,29,19792,16.193181818181817
"Hollister city, Missouri",2315,1929,386,29,32662,16.673866090712743
"Gentry village, Missouri",30,19,11,29,26776,36.666666666666664
"King City city, Missouri",455,375,80,29,38774,17.582417582417584
"Stanberry city, Missouri",575,481,94,29,70270,16.34782608695652
"Benton city, Missouri",354,330,24,29,04798,6.779661016949152
"Vanduser village, Missouri",114,79,35,29,75724,30.701754385964914
"Creighton city, Missouri",146,136,10,29,17164,6.8493150684931505
"Garden City city, Missouri",769,632,137,29,26434,17.815344603381014
"Festus city, Missouri",5182,4642,540,29,24094,10.420686993438826
"Hawk Point city, Missouri",322,250,72,29,31024,22.36024844720497
"Silex village, Missouri",7,4,3,29,67808,42.857142857142854
"Troy city, Missouri",4376,3980,396,29,73942,9.049360146252285
"Morehouse city, Missouri",509,413,96,29,49898,18.860510805500983
"Aldrich village, Missouri",45,27,18,29,00568,40.0
"Halfway village, Missouri",90,61,29,29,29962,32.22222222222222
"Galt city, Missouri",160,108,52,29,26362,32.5
"Princeton city, Missouri",599,426,173,29,59942,28.881469115191987
"Ionia town, Missouri",54,42,12,29,35306,22.22222222222222
"Breckenridge city, Missouri",244,146,98,29,08128,40.16393442622951
"Jonesburg city, Missouri",337,269,68,29,37574,20.178041543026705
"McKittrick town, Missouri",40,25,15,29,45200,37.5
"Anderson city, Missouri",883,747,136,29,01198,15.402038505096263
"Rensselaer village, Missouri",105,100,5,29,61184,4.761904761904762
"Vandalia city, Missouri",1354,1109,245,29,75688,18.09453471196455
"Bloomfield city, Missouri",942,769,173,29,06382,18.365180467091292
"Dudley city, Missouri",103,86,17,29,20296,16.50485436893204
"Oak Grove city, Missouri",3007,2749,258,29,53624,8.579980046558031
"Lake Lotawana city, Missouri",1332,821,511,29,39980,38.36336336336336
"Unity Village village, Missouri",51,51,0,29,75202,0.0
"Dexter city, Missouri",3869,3267,602,29,19396,15.559576117859914
"Lexington city, Missouri",2214,1951,263,29,41870,11.878952122854562
"Napoleon city, Missouri",90,86,4,29,51140,4.444444444444445
"Jamestown town, Missouri",194,165,29,29,36368,14.948453608247423
"Velda City city, Missouri",741,567,174,29,75796,23.481781376518217
"Mill Spring village, Missouri",94,61,33,29,48386,35.1063829787234
"Ludlow town, Missouri",83,52,31,29,44390,37.34939759036144
"Excelsior Estates village, Missouri",91,73,18,29,23077,19.78021978021978
"Osage Beach city, Missouri",5660,1854,3806,29,55244,67.24381625441697
"Collins village, Missouri",92,73,19,29,15562,20.652173913043477
"Moundville town, Missouri",83,63,20,29,50330,24.096385542168676
"Chillicothe city, Missouri",3996,3467,529,29,13690,13.238238238238237
"Reeds Spring city, Missouri",433,385,48,29,61112,11.085450346420323
"Kennett city, Missouri",4970,4387,583,29,38306,11.730382293762576
"Golden City city, Missouri",450,333,117,29,27676,26.0
"Liberal city, Missouri",383,300,83,29,41906,21.671018276762403
"Stockton city, Missouri",942,802,140,29,70828,14.8619957537155
"Miller city, Missouri",441,314,127,29,48242,28.798185941043087
"Holliday village, Missouri",72,56,16,29,32626,22.22222222222222
"Newburg city, Missouri",307,220,87,29,51716,28.338762214983714
"Bel-Nor village, Missouri",704,612,92,29,04348,13.068181818181818
"Cool Valley city, Missouri",534,451,83,29,16228,15.543071161048688
"Crestwood city, Missouri",5174,4865,309,29,17218,5.972168534982606
"Flordell Hills city, Missouri",394,318,76,29,24706,19.289340101522843
"Hanley Hills village, Missouri",953,762,191,29,30196,20.041972717733472
"Marlborough village, Missouri",1633,1514,119,29,46208,7.287201469687692
"Rock Hill city, Missouri",2142,1898,244,29,62660,11.391223155929039
"St. Ann city, Missouri",6447,5655,792,29,63956,12.284783620288506
"Lake Ozark city, Missouri",1756,734,1022,29,40034,58.20045558086561
"Olean town, Missouri",69,31,38,29,54560,55.072463768115945
"Deerfield village, Missouri",24,22,2,29,18802,8.333333333333332
"Milo village, Missouri",35,31,4,29,48476,11.428571428571429
"Oronogo city, Missouri",821,792,29,29,54920,3.5322777101096223
"Bates City city, Missouri",122,87,35,29,03556,28.688524590163933
"Dover town, Missouri",43,35,8,29,19918,18.6046511627907
"Lake Lafayette city, Missouri",165,129,36,29,39952,21.818181818181817
"Farley village, Missouri",107,98,9,29,23698,8.411214953271028
"Ferrelview village, Missouri",274,246,28,29,24058,10.218978102189782
"Houston Lake city, Missouri",167,153,14,29,33292,8.383233532934131
"Northmoor city, Missouri",163,151,12,29,53174,7.361963190184049
"Parkville city, Missouri",2527,2467,60,29,56288,2.374356944994064
"Platte City city, Missouri",1975,1822,153,29,58178,7.746835443037975
"Tracy city, Missouri",96,91,5,29,73690,5.208333333333334
"South Gorin town, Missouri",70,33,37,29,68870,52.85714285714286
"Bel-Ridge village, Missouri",1179,1031,148,29,04366,12.55301102629347
"Bragg City town, Missouri",54,40,14,29,07876,25.925925925925924
"Fordland city, Missouri",383,354,29,29,25012,7.5718015665796345
"Malta Bend town, Missouri",117,84,33,29,45632,28.205128205128204
"St. James city, Missouri",1897,1625,272,29,64424,14.3384290985767
"Lupus town, Missouri",25,17,8,29,44498,32.0
"Rockville city, Missouri",81,50,31,29,62786,38.2716049382716
"Salem city, Missouri",2589,2361,228,29,65234,8.80648899188876
"Alba city, Missouri",333,307,26,29,00496,7.807807807807808
"Avilla town, Missouri",42,27,15,29,02746,35.714285714285715
"Brooklyn Heights town, Missouri",57,52,5,29,08776,8.771929824561402
"Carytown city, Missouri",161,103,58,29,11728,36.024844720496894
"Buffalo city, Missouri",1516,1255,261,29,09514,17.216358839050134
"Macon city, Missouri",2507,2077,430,29,45326,17.151974471479857
"Ashland city, Missouri",1528,1442,86,29,02242,5.6282722513089
"Harrisburg town, Missouri",138,122,16,29,30484,11.594202898550725
"Hartsburg town, Missouri",73,55,18,29,30718,24.65753424657534
"Oakwood village, Missouri",70,69,1,29,53894,1.4285714285714286
"Sheridan town, Missouri",156,89,67,29,67358,42.94871794871795
"Brookfield city, Missouri",2333,1877,456,29,08650,19.54564937848264
"Linneus city, Missouri",146,123,23,29,43292,15.753424657534246
"Joplin city, Missouri",23375,20251,3124,29,37592,13.364705882352942
"Leawood village, Missouri",293,229,64,29,41132,21.843003412969285
"Redings Mill village, Missouri",67,67,0,29,60986,0.0
"Stotesbury town, Missouri",8,8,0,29,70954,0.0
"Maplewood city, Missouri",4641,4182,459,29,45830,9.89010989010989
"Halltown village, Missouri",99,56,43,29,30016,43.43434343434344
"Pine Lawn city, Missouri",1671,1106,565,29,57800,33.81208856971873
"Brumley town, Missouri",44,37,7,29,08974,15.909090909090908
"Walker city, Missouri",151,121,30,29,76660,19.867549668874172
"Stoutsville village, Missouri",38,13,25,29,71026,65.78947368421053
"Crystal Lake Park city, Missouri",201,189,12,29,17650,5.970149253731343
"Eureka city, Missouri",3694,3420,274,29,22834,7.4174336762317274
"Florissant city, Missouri",21984,19824,2160,29,24778,9.82532751091703
"Norwood Court town, Missouri",574,531,43,29,53462,7.491289198606271
"Oakville CDP, Missouri",14873,14292,581,29,53876,3.9064075842130035
"Shrewsbury city, Missouri",3304,3099,205,29,67700,6.204600484261501
"Sycamore Hills village, Missouri",341,294,47,29,72034,13.78299120234604
"University City city, Missouri",17144,15468,1676,29,75220,9.776014932337844
"Blairstown city, Missouri",59,45,14,29,06238,23.728813559322035
"Diamond town, Missouri",441,395,46,29,19432,10.430839002267573
"Fairview town, Missouri",200,165,35,29,23518,17.5
"Loma Linda town, Missouri",357,335,22,29,43672,6.162464985994398
"Newtonia town, Missouri",75,70,5,29,52292,6.666666666666667
"Bolckow city, Missouri",102,77,25,29,06922,24.509803921568626
"Country Club village, Missouri",1022,993,29,29,16802,2.8375733855185907
"Rosendale city, Missouri",69,52,17,29,63200,24.637681159420293
"Merriam Woods village, Missouri",944,742,202,29,47520,21.398305084745765
"Lawson city, Missouri",986,860,126,29,40988,12.778904665314403
"Spanish Lake CDP, Missouri",8993,6945,2048,29,69266,22.773268097409098
"Utica village, Missouri",102,79,23,29,75364,22.54901960784314
"Elmira village, Missouri",34,11,23,29,22006,67.64705882352942
"Richmond city, Missouri",2824,2412,412,29,61670,14.589235127478753
"Hurley city, Missouri",98,80,18,29,33922,18.367346938775512
"Iberia city, Missouri",324,267,57,29,34228,17.59259259259259
"Gerster town, Missouri",22,13,9,29,26902,40.909090909090914
"Lowry City city, Missouri",349,290,59,29,44282,16.9054441260745
"Trenton city, Missouri",2890,2354,536,29,73816,18.546712802768166
"Mercer town, Missouri",217,151,66,29,47486,30.414746543778804
"Barnett city, Missouri",111,96,15,29,03376,13.513513513513514
"Worthington village, Missouri",72,50,22,29,81106,30.555555555555557
"Leonard village, Missouri",32,28,4,29,41546,12.5
"Shelbina city, Missouri",791,652,139,29,67178,17.572692793931733
"Anniston town, Missouri",92,65,27,29,01288,29.347826086956523
"Charleston city, Missouri",2076,1770,306,29,13366,14.739884393063585
"Pinhook village, Missouri",0,0,0,29,57926,
"Tarkio city, Missouri",867,739,128,29,72340,14.763552479815456
"Caruthersville city, Missouri",2818,2457,361,29,11692,12.810503903477644
"Holland town, Missouri",99,80,19,29,32590,19.19191919191919
"St. Mary city, Missouri",189,138,51,29,65034,26.984126984126984
"Bellflower city, Missouri",236,171,65,29,04330,27.54237288135593
"High Hill city, Missouri",110,97,13,29,31996,11.818181818181818
"Bismarck city, Missouri",727,588,139,29,05878,19.119669876203577
"Potosi city, Missouri",1170,1076,94,29,59330,8.034188034188034
"Triplett city, Missouri",18,13,5,29,73870,27.77777777777778
"Gray Summit CDP, Missouri",983,960,23,29,28918,2.3397761953204474
"Chain of Rocks village, Missouri",30,27,3,29,13006,10.0
"Winfield city, Missouri",521,458,63,29,80422,12.092130518234164
"Canalou city, Missouri",92,66,26,29,11026,28.26086956521739
"Risco city, Missouri",189,162,27,29,61994,14.285714285714285
"Humansville city, Missouri",445,368,77,29,33706,17.303370786516854
"Holt city, Missouri",177,149,28,29,32752,15.819209039548024
"Gower city, Missouri",681,635,46,29,28036,6.7547723935389135
"Mindenmines city, Missouri",177,134,43,29,48566,24.293785310734464
"El Dorado Springs city, Missouri",1737,1486,251,29,21502,14.45020149683362
"Osceola city, Missouri",601,450,151,29,55388,25.124792013311147
"Richards town, Missouri",45,40,5,29,61364,11.11111111111111
"Campbell city, Missouri",978,840,138,29,10864,14.11042944785276
"Clarkton city, Missouri",547,488,59,29,14212,10.786106032906764
"Knob Noster city, Missouri",1448,1261,187,29,39188,12.914364640883976
"Russellville city, Missouri",421,322,99,29,63704,23.51543942992874
"Bethany city, Missouri",1661,1393,268,29,05068,16.134858518964478
"Blythedale village, Missouri",94,80,14,29,06742,14.893617021276595
"Willard city, Missouri",2110,2071,39,29,79882,1.8483412322274881
"Chilhowee town, Missouri",180,143,37,29,13654,20.555555555555554
"Warrensburg city, Missouri",8045,7355,690,29,77092,8.576755748912369
"Lancaster city, Missouri",363,270,93,29,40610,25.6198347107438
"Curryville city, Missouri",110,86,24,29,17902,21.818181818181817
"Queen City city, Missouri",293,234,59,29,60356,20.13651877133106
"Hillsboro city, Missouri",1033,985,48,29,32248,4.646660212971927
"Kimmswick city, Missouri",61,52,9,29,38684,14.754098360655737
"Murphy CDP, Missouri",3590,3356,234,29,50834,6.518105849582173
"Parkdale village, Missouri",89,80,9,29,56226,10.112359550561797
"Purdy city, Missouri",533,445,88,29,60176,16.51031894934334
"Imperial CDP, Missouri",1821,1627,194,29,34354,10.653487095002747
"Fisk city, Missouri",180,149,31,29,24328,17.22222222222222
"Centertown town, Missouri",163,140,23,29,12664,14.11042944785276
"Josephville village, Missouri",172,157,15,29,37700,8.720930232558139
"Portage Des Sioux city, Missouri",162,139,23,29,59150,14.19753086419753
"St. Charles city, Missouri",29896,27872,2024,29,64082,6.770136473106771
"Wentzville city, Missouri",13002,12367,635,29,78442,4.883864020919859
"Summersville city, Missouri",298,233,65,29,71512,21.812080536912752
"Irondale city, Missouri",187,139,48,29,35396,25.668449197860966
"Fayette city, Missouri",1168,838,330,29,23842,28.25342465753425
"Arrow Rock town, Missouri",40,27,13,29,02044,32.5
"Mount Leonard town, Missouri",42,20,22,29,50510,52.38095238095239
"Diggins village, Missouri",145,114,31,29,19504,21.379310344827587
"Niangua city, Missouri",261,225,36,29,52418,13.793103448275861
"Laddonia city, Missouri",324,262,62,29,39602,19.1358024691358
"Vandiver village, Missouri",35,35,0,29,75706,0.0
"Cairo village, Missouri",131,117,14,29,10360,10.687022900763358
"Chain-O-Lakes village, Missouri",80,51,29,29,13015,36.25
"Lincoln city, Missouri",514,388,126,29,42608,24.5136186770428
"Carl Junction city, Missouri",2939,2786,153,29,11368,5.205852330724737
"St. Peters city, Missouri",23354,22532,822,29,65126,3.5197396591590304
"Wardell town, Missouri",162,117,45,29,76966,27.77777777777778
"Van Buren town, Missouri",464,384,80,29,75580,17.24137931034483
"Airport Drive village, Missouri",421,350,71,29,00424,16.864608076009503
"Duenweg city, Missouri",643,581,62,29,20314,9.642301710730948
"Lucerne village, Missouri",82,34,48,29,44372,58.536585365853654
"Unionville city, Missouri",1005,750,255,29,75166,25.37313432835821
"Clarence city, Missouri",455,366,89,29,13978,19.560439560439562
"La Russell city, Missouri",48,44,4,29,40790,8.333333333333332
"Platte Woods city, Missouri",190,163,27,29,58196,14.210526315789473
"Ridgely village, Missouri",25,25,0,29,61886,0.0
"Camdenton city, Missouri",1356,1190,166,29,10810,12.24188790560472
"Brandsville city, Missouri",66,47,19,29,07948,28.78787878787879
"Riverside city, Missouri",1533,1365,168,29,62156,10.95890410958904
"Arbela town, Missouri",25,17,8,29,01576,32.0
"Rutledge town, Missouri",73,31,42,29,63776,57.534246575342465
"Huntsville city, Missouri",702,551,151,29,33886,21.50997150997151
"Blackwater city, Missouri",80,66,14,29,06148,17.5
"Deepwater city, Missouri",264,187,77,29,18730,29.166666666666668
"Odessa city, Missouri",2358,2029,329,29,54038,13.952502120441052
"Jefferson City city, Missouri",18970,16839,2131,29,37000,11.233526620980495
"Rocheport city, Missouri",153,112,41,29,62498,26.797385620915033
"Leadwood city, Missouri",650,538,112,29,41078,17.23076923076923
"Arcola village, Missouri",63,35,28,29,01720,44.44444444444444
"Altenburg city, Missouri",163,149,14,29,00928,8.588957055214724
"Frohna city, Missouri",127,104,23,29,26092,18.11023622047244
"Moberly city, Missouri",5604,4460,1144,29,49034,20.41399000713776
"Iatan village, Missouri",36,16,20,29,34210,55.55555555555556
"Duquesne village, Missouri",877,795,82,29,20512,9.35005701254276
"Sarcoxie city, Missouri",553,479,74,29,65990,13.381555153707053
"Edgerton city, Missouri",240,197,43,29,21250,17.916666666666668
"Kansas City city, Missouri",230335,200420,29915,29,38000,12.987605010093993
"Carrollton city, Missouri",1910,1470,440,29,11566,23.036649214659686
"Cowgill city, Missouri",106,74,32,29,16984,30.18867924528302
"Kidder city, Missouri",135,101,34,29,38522,25.185185185185183
"Bourbon city, Missouri",899,802,97,29,07534,10.789766407119021
"Brunswick city, Missouri",513,351,162,29,09046,31.57894736842105
"New Haven city, Missouri",917,744,173,29,51914,18.86586695747001
"Grandin city, Missouri",122,89,33,29,28180,27.049180327868854
"Granger village, Missouri",29,10,19,29,28360,65.51724137931035
"Fidelity town, Missouri",105,90,15,29,24120,14.285714285714285
"Neck City city, Missouri",64,59,5,29,51356,7.8125
"Reeds town, Missouri",40,36,4,29,61094,10.0
"Weston city, Missouri",800,715,85,29,78856,10.625
"Revere town, Missouri",39,23,16,29,61292,41.02564102564102
"Fremont Hills city, Missouri",442,427,15,29,25957,3.3936651583710407
"Hermann city, Missouri",1225,1083,142,29,31762,11.591836734693878
"Rock Port city, Missouri",737,687,50,29,62696,6.7842605156037985
"Bloomsdale city, Missouri",303,303,0,29,06454,0.0
"Innsbrook village, Missouri",1501,300,1201,29,35240,80.01332445036641
"Warrenton city, Missouri",3428,3084,344,29,77128,10.035005834305718
"Hume town, Missouri",136,124,12,29,33724,8.823529411764707
"Camden Point city, Missouri",192,179,13,29,10792,6.770833333333333
"Weatherby Lake city, Missouri",847,756,91,29,78046,10.743801652892563
"Hartville city, Missouri",293,250,43,29,30754,14.675767918088736
"Mansfield city, Missouri",696,634,62,29,45740,8.908045977011495
"Cosby village, Missouri",80,63,17,29,16588,21.25
"Bland city, Missouri",317,240,77,29,06256,24.290220820189273
"Naylor city, Missouri",314,279,35,29,51302,11.146496815286625
"Oaks village, Missouri",69,56,13,29,53804,18.84057971014493
"Liberty city, Missouri",11782,11119,663,29,42032,5.627227974876932
"Missouri City city, Missouri",264,237,27,29,48980,10.227272727272728
"North Kansas City city, Missouri",2657,2398,259,29,53102,9.74783590515619
"Republic city, Missouri",6315,6112,203,29,61238,3.214568487727633
"Strafford city, Missouri",848,795,53,29,71062,6.25
"Kingsville city, Missouri",110,92,18,29,38918,16.363636363636363
"Frankford city, Missouri",230,206,24,29,25552,10.434782608695652
"Winston village, Missouri",133,98,35,29,80548,26.31578947368421
"Pilot Knob city, Missouri",348,282,66,29,57656,18.96551724137931
"Viburnum city, Missouri",349,269,80,29,76012,22.922636103151863
"Birmingham village, Missouri",93,82,11,29,05824,11.827956989247312
"Gladstone city, Missouri",12109,11130,979,29,27190,8.08489553224874
"Battlefield city, Missouri",2326,2293,33,29,03592,1.4187446259673258
"Pleasant Hill city, Missouri",3003,2948,55,29,58394,1.8315018315018317
"Oakview village, Missouri",187,176,11,29,53858,5.88235294117647
"De Soto city, Missouri",3066,2654,412,29,19252,13.437703848662752
"Morley city, Missouri",334,302,32,29,49988,9.580838323353294
"Byrnes Mill city, Missouri",1227,1122,105,29,10240,8.557457212713937
"Scotsdale town, Missouri",82,64,18,29,66337,21.951219512195124
"Cassville city, Missouri",1329,1177,152,29,11890,11.43717080511663
"Emerald Beach village, Missouri",248,138,110,29,22250,44.354838709677416
"Wheaton city, Missouri",309,241,68,29,79126,22.006472491909385
"Norborne city, Missouri",428,358,70,29,52760,16.355140186915886
"Kimberling City city, Missouri",1469,1110,359,29,38612,24.438393464942138
"Lakeside city, Missouri",0,0,0,29,40142,
"Bakersfield village, Missouri",150,108,42,29,03052,28.000000000000004
"Gainesville city, Missouri",401,319,82,29,26218,20.448877805486283
"Vista village, Missouri",30,20,10,29,76390,33.33333333333333
"Bronaugh city, Missouri",81,59,22,29,08614,27.160493827160494
"Umber View Heights village, Missouri",36,27,9,29,74473,25.0
"Cole Camp city, Missouri",591,490,101,29,15436,17.089678510998308
"Qulin city, Missouri",274,208,66,29,60428,24.087591240875913
"Augusta town, Missouri",138,114,24,29,02512,17.391304347826086
"St. Paul city, Missouri",906,873,33,29,65108,3.642384105960265
"Warsaw city, Missouri",1283,1002,281,29,77146,21.901792673421667
"Monroe City city, Missouri",1256,1096,160,29,49394,12.738853503184714
"Perryville city, Missouri",3838,3479,359,29,57116,9.353830119854091
"Benton City village, Missouri",79,72,7,29,04834,8.860759493670885
"Rush Hill village, Missouri",78,58,20,29,63560,25.64102564102564
"Arkoe town, Missouri",24,19,5,29,01864,20.833333333333336
"Warson Woods city, Missouri",761,758,3,29,77182,0.39421813403416556
"Piedmont city, Missouri",1155,1041,114,29,57422,9.87012987012987
"Vienna city, Missouri",302,247,55,29,76102,18.211920529801322
"Clyde village, Missouri",32,28,4,29,15130,12.5
"Guilford town, Missouri",33,25,8,29,29692,24.242424242424242
"Pickering town, Missouri",72,55,17,29,57404,23.61111111111111
"Harris town, Missouri",28,14,14,29,30466,50.0
"Humphreys village, Missouri",102,40,62,29,33742,60.78431372549019
"Milan city, Missouri",1072,839,233,29,48062,21.73507462686567
"Newtown town, Missouri",79,46,33,29,52328,41.77215189873418
"Claycomo village, Missouri",768,704,64,29,14554,8.333333333333332
"Glenwood village, Missouri",99,71,28,29,27514,28.28282828282828
"Louisiana city, Missouri",1735,1370,365,29,44174,21.037463976945244
"Paynesville village, Missouri",32,23,9,29,56612,28.125
"Grant City town, Missouri",488,392,96,29,28594,19.672131147540984
"Bevier city, Missouri",362,289,73,29,05266,20.165745856353592
"Elmer city, Missouri",38,29,9,29,21988,23.684210526315788
"Holts Summit city, Missouri",1803,1653,150,29,32770,8.319467554076539
"Eolia village, Missouri",215,192,23,29,22474,10.69767441860465
"Tarrants village, Missouri",0,0,0,29,72376,
"Wyaconda city, Missouri",146,105,41,29,81142,28.08219178082192
"Sparta city, Missouri",752,649,103,29,69302,13.696808510638297
"Stella town, Missouri",63,56,7,29,70648,11.11111111111111
"Winona city, Missouri",648,544,104,29,80512,16.049382716049383
"Prairie Home city, Missouri",141,105,36,29,59726,25.53191489361702
"Penermon village, Missouri",43,36,7,29,56900,16.27906976744186
"Wellsville city, Missouri",534,421,113,29,78406,21.161048689138575
"Noel city, Missouri",996,797,199,29,52742,19.979919678714857
"Advance city, Missouri",700,592,108,29,00262,15.428571428571427
"Everton city, Missouri",186,127,59,29,22996,31.72043010752688
"Delta city, Missouri",196,157,39,29,19072,19.897959183673468
"Arrow Point village, Missouri",90,53,37,29,02034,41.11111111111111
"Franklin city, Missouri",39,34,5,29,25624,12.82051282051282
"East Prairie city, Missouri",1400,1302,98,29,21052,7.000000000000001
"Malden city, Missouri",1977,1717,260,29,45614,13.151239251390997
"Junction City village, Missouri",173,154,19,29,37736,10.982658959537572
"Marquand city, Missouri",151,134,17,29,46244,11.258278145695364
"Gordonville village, Missouri",226,212,14,29,27928,6.1946902654867255
"Oak Ridge town, Missouri",78,74,4,29,53786,5.128205128205128
"Indian Point village, Missouri",755,221,534,29,35186,70.72847682119206
"Annapolis city, Missouri",219,172,47,29,01270,21.461187214611872
"Blue Eye town, Missouri",248,124,124,29,06526,50.0
"Lamar city, Missouri",2037,1880,157,29,40376,7.7074128620520375
"Rives town, Missouri",35,20,15,29,62228,42.857142857142854
"Dutchtown village, Missouri",17,11,6,29,20566,35.294117647058826
"Altamont village, Missouri",98,63,35,29,00910,35.714285714285715
"Des Arc village, Missouri",98,81,17,29,19198,17.346938775510203
"Bunker city, Missouri",186,166,20,29,09694,10.75268817204301
"Barnard city, Missouri",95,82,13,29,03340,13.684210526315791
"Clearmont city, Missouri",90,73,17,29,14662,18.88888888888889
"Linn Creek city, Missouri",121,113,8,29,43274,6.6115702479338845
"Louisburg village, Missouri",80,35,45,29,44156,56.25
"Hallsville city, Missouri",664,617,47,29,29998,7.078313253012049
"Glenaire city, Missouri",217,217,0,29,27262,0.0
"Pleasant Valley city, Missouri",1199,1126,73,29,58520,6.0884070058381985
"Fair Grove city, Missouri",647,609,38,29,23338,5.873261205564142
"Kearney city, Missouri",3595,3305,290,29,38072,8.066759388038943
"Flint Hill city, Missouri",209,198,11,29,24688,5.263157894736842
"Lohman city, Missouri",86,66,20,29,43652,23.25581395348837
"Mount Moriah town, Missouri",49,28,21,29,50528,42.857142857142854
"Ridgeway city, Missouri",211,163,48,29,61904,22.748815165876778
"Weldon Spring Heights town, Missouri",38,38,0,29,78334,0.0
"Dixon city, Missouri",593,433,160,29,19630,26.981450252951095
"Shoal Creek Drive village, Missouri",190,169,21,29,67628,11.052631578947368
"Wentworth village, Missouri",70,41,29,29,78424,41.42857142857143
"Crocker city, Missouri",494,384,110,29,17344,22.267206477732792
"La Belle city, Missouri",363,282,81,29,39512,22.31404958677686
"Bunceton city, Missouri",184,135,49,29,09658,26.6304347826087
"Aullville village, Missouri",43,26,17,29,02530,39.53488372093023
"Corder city, Missouri",172,142,30,29,16408,17.441860465116278
"Tipton city, Missouri",1079,911,168,29,73420,15.569972196478222
"Laclede city, Missouri",217,182,35,29,39566,16.129032258064516
"Marceline city, Missouri",1048,843,205,29,45866,19.561068702290076
"Dennis Acres village, Missouri",24,20,4,29,19090,16.666666666666664
"Stark City town, Missouri",66,47,19,29,70414,28.78787878787879
"St. Robert city, Missouri",3313,2376,937,29,65144,28.282523392695442
"Canton city, Missouri",1039,936,103,29,11134,9.913378248315688
"Gravois Mills town, Missouri",88,48,40,29,28828,45.45454545454545
"Stover city, Missouri",564,505,59,29,71044,10.460992907801419
"Syracuse city, Missouri",63,59,4,29,72106,6.349206349206349
"Auxvasse city, Missouri",530,467,63,29,02638,11.88679245283019
"Pagedale city, Missouri",1617,1322,295,29,55964,18.24366110080396
"St. John city, Missouri",2939,2601,338,29,64478,11.500510377679483
"Emma city, Missouri",101,89,12,29,22312,11.881188118811881
"Lathrop city, Missouri",927,880,47,29,40826,5.070118662351672
"Spickard city, Missouri",131,103,28,29,69464,21.374045801526716
"Sunrise Beach village, Missouri",460,146,314,29,71728,68.26086956521739
"Sedgewickville village, Missouri",69,53,16,29,66476,23.18840579710145
"Marshfield city, Missouri",2889,2749,140,29,46388,4.8459674627898925
"Rogersville city, Missouri",1372,1259,113,29,62894,8.236151603498543
"Marble Hill city, Missouri",903,675,228,29,45848,25.249169435215947
"Hayti Heights city, Missouri",278,206,72,29,31168,25.899280575539567
"Foristell city, Missouri",233,227,6,29,25120,2.575107296137339
"Forsyth city, Missouri",1180,982,198,29,25192,16.779661016949152
"McFall city, Missouri",53,36,17,29,45020,32.075471698113205
"Diehlstadt village, Missouri",66,59,7,29,19486,10.606060606060606
"East Lynne city, Missouri",101,93,8,29,20980,7.920792079207921
"Arnold city, Missouri",8697,8318,379,29,01972,4.357824537196735
"Laredo city, Missouri",161,88,73,29,40736,45.3416149068323
"Brashear city, Missouri",119,75,44,29,08002,36.97478991596639
"Newark village, Missouri",56,40,16,29,51662,28.57142857142857
"Hamilton city, Missouri",859,751,108,29,30034,12.572759022118744
"Bosworth city, Missouri",204,74,130,29,07426,63.725490196078425
"Tina village, Missouri",97,92,5,29,73330,5.154639175257731
"Iron Mountain Lake city, Missouri",424,293,131,29,35450,30.89622641509434
"Caledonia village, Missouri",68,68,0,29,10432,0.0
"New Franklin city, Missouri",577,424,153,29,51824,26.51646447140381
"Butler city, Missouri",2022,1706,316,29,10054,15.62809099901088
"Poplar Bluff city, Missouri",8195,6737,1458,29,59096,17.791336180597924
"Cainsville city, Missouri",164,98,66,29,10342,40.243902439024396
"Pleasant Hope city, Missouri",300,269,31,29,58448,10.333333333333334
"Easton city, Missouri",121,108,13,29,21034,10.743801652892563
"South Lineville town, Missouri",15,6,9,29,68942,60.0
"Castle Point CDP, Missouri",1391,973,418,29,11908,30.050323508267436
"Paris city, Missouri",684,551,133,29,56144,19.444444444444446
"Edgar Springs city, Missouri",111,79,32,29,21214,28.82882882882883
"Brentwood city, Missouri",4286,4031,255,29,08236,5.949603359776015
"Charlack city, Missouri",701,634,67,29,13330,9.557774607703282
"Chesterfield city, Missouri",20078,19281,797,29,13600,3.9695188763821094
"Clayton city, Missouri",6244,5633,611,29,14572,9.78539397821909
"Glasgow Village CDP, Missouri",1983,1342,641,29,27226,32.32476046394352
"Greendale city, Missouri",415,360,55,29,29152,13.253012048192772
"Huntleigh city, Missouri",163,154,9,29,33850,5.521472392638037
"Kirkwood city, Missouri",12648,11704,944,29,39044,7.463630613535736
"Excelsior Springs city, Missouri",4921,4444,477,29,23086,9.693151798414956
"Hornersville city, Missouri",316,273,43,29,33076,13.60759493670886
"Coffey city, Missouri",73,64,9,29,15274,12.32876712328767
"Parnell city, Missouri",145,76,69,29,56360,47.58620689655172
"Fleming city, Missouri",56,32,24,29,24562,42.857142857142854
"Orrick city, Missouri",342,271,71,29,54938,20.760233918128655
"Coney Island village, Missouri",97,31,66,29,16115,68.04123711340206
"Crane city, Missouri",651,549,102,29,17074,15.668202764976957
"Milford village, Missouri",15,9,6,29,48098,40.0
"Cardwell city, Missouri",395,294,101,29,11350,25.569620253164555
"Senath city, Missouri",758,626,132,29,66638,17.41424802110818
"Cobalt village, Missouri",140,126,14,29,15220,10.0
"Jackson city, Missouri",6120,5567,553,29,35648,9.0359477124183
"Pocahontas town, Missouri",29,28,1,29,58628,3.4482758620689653
"Sturgeon city, Missouri",380,330,50,29,71224,13.157894736842104
"Downing city, Missouri",239,172,67,29,19990,28.03347280334728
"Greentop city, Missouri",251,234,17,29,29422,6.772908366533864
"Prathersville village, Missouri",65,58,7,29,59816,10.76923076923077
"Craig city, Missouri",138,88,50,29,17056,36.231884057971016
"Fortescue town, Missouri",25,12,13,29,25228,52.0
"Elmo city, Missouri",109,83,26,29,22024,23.853211009174313
"Oregon city, Missouri",454,415,39,29,54848,8.590308370044053
"Rothville village, Missouri",42,20,22,29,63236,52.38095238095239
"Catron town, Missouri",29,21,8,29,12052,27.586206896551722
"Skidmore city, Missouri",153,103,50,29,68132,32.6797385620915
"Green City city, Missouri",344,229,115,29,29134,33.43023255813954
"Kahoka city, Missouri",987,910,77,29,37790,7.801418439716312
"Clever city, Missouri",1025,935,90,29,14788,8.780487804878048
"Nixa city, Missouri",8757,8155,602,29,52616,6.874500399680255
"Denver village, Missouri",29,15,14,29,19162,48.275862068965516
"Walnut Grove city, Missouri",309,269,40,29,76840,12.944983818770226
"Palmyra city, Missouri",1715,1431,284,29,56036,16.559766763848398
"Bowling Green city, Missouri",1464,1353,111,29,07660,7.581967213114754
"Luray village, Missouri",41,41,0,29,44516,0.0
"Spokane CDP, Missouri",34,34,0,29,69518,0.0
"Bucklin city, Missouri",267,202,65,29,09388,24.344569288389515
"Meadville city, Missouri",212,188,24,29,47036,11.320754716981133
"Neosho city, Missouri",4928,4405,523,29,51572,10.612824675324676
"Ashburn town, Missouri",28,0,28,29,02152,100.0
"Otterville city, Missouri",169,155,14,29,55478,8.284023668639055
"Springfield city, Missouri",81396,73665,7731,29,70000,9.498009730207873
"Leeton city, Missouri",300,214,86,29,41402,28.666666666666668
"Clarksville city, Missouri",294,215,79,29,14194,26.87074829931973
"Ethel town, Missouri",39,18,21,29,22672,53.84615384615385
"New Cambria city, Missouri",105,63,42,29,51734,40.0
"Fulton city, Missouri",4405,3784,621,29,26182,14.09761634506243
"Cuba city, Missouri",1621,1434,187,29,17668,11.536088834053054
"Bigelow village, Missouri",18,6,12,29,05464,66.66666666666666
"Mendon city, Missouri",125,76,49,29,47288,39.2
"Salisbury city, Missouri",879,683,196,29,65450,22.29806598407281
"Sumner town, Missouri",60,37,23,29,71620,38.333333333333336
"Gerald city, Missouri",602,502,100,29,26866,16.611295681063122
"Miramiguoa Park village, Missouri",55,39,16,29,48880,29.09090909090909
"Union city, Missouri",4584,4410,174,29,74626,3.7958115183246073
"Rockaway Beach city, Missouri",614,408,206,29,62570,33.55048859934853
"Taneyville village, Missouri",185,121,64,29,72232,34.5945945945946
"Powersville village, Missouri",38,17,21,29,59420,55.26315789473685
"Bethel village, Missouri",73,53,20,29,05104,27.397260273972602
"Wyatt city, Missouri",181,135,46,29,81178,25.41436464088398
"Coffeeville town, Mississippi",551,462,89,28,14740,16.152450090744104
"Stonewall town, Mississippi",566,403,163,28,70760,28.79858657243816
"Pearl city, Mississippi",11272,10460,812,28,55760,7.203690560681335
"Myrtle town, Mississippi",218,176,42,28,50280,19.26605504587156
"North Carrollton town, Mississippi",234,124,110,28,52400,47.008547008547005
"Collins city, Mississippi",1075,939,136,28,15140,12.651162790697674
"Kilmichael town, Mississippi",442,356,86,28,37560,19.457013574660635
"Winona city, Mississippi",2216,1839,377,28,80760,17.012635379061372
"Kosciusko city, Mississippi",3219,2712,507,28,38320,15.7502329916123
"Ethel town, Mississippi",240,200,40,28,23220,16.666666666666664
"Sallis town, Mississippi",109,105,4,28,64800,3.669724770642202
"Ashland town, Mississippi",266,224,42,28,02140,15.789473684210526
"Learned town, Mississippi",42,34,8,28,39880,19.047619047619047
"Raymond city, Mississippi",584,502,82,28,61160,14.04109589041096
"Standing Pine CDP, Mississippi",128,128,0,28,70120,0.0
"Drew city, Mississippi",881,769,112,28,20020,12.712826333711691
"North Tunica CDP, Mississippi",275,275,0,28,52680,0.0
"Monticello town, Mississippi",726,619,107,28,48560,14.738292011019283
"Bay St. Louis city, Mississippi",7632,5610,2022,28,03980,26.493710691823903
"Vardaman town, Mississippi",481,441,40,28,76320,8.316008316008316
"Houston city, Mississippi",1469,1254,215,28,33900,14.635806671204902
"Okolona city, Mississippi",1321,1147,174,28,53680,13.171839515518545
"Waveland city, Mississippi",3281,2581,700,28,78200,21.334958854007922
"Webb town, Mississippi",200,167,33,28,78480,16.5
"Belmont town, Mississippi",1032,832,200,28,05100,19.379844961240313
"Golden town, Mississippi",146,99,47,28,27940,32.19178082191781
"Osyka town, Mississippi",200,141,59,28,54640,29.5
"Southaven city, Mississippi",20551,19174,1377,28,69280,6.7004038732908375
"Helena CDP, Mississippi",775,586,189,28,31460,24.387096774193548
"Sandersville town, Mississippi",382,292,90,28,64920,23.56020942408377
"Louisville city, Mississippi",2756,2359,397,28,42280,14.404934687953554
"Macon city, Mississippi",1283,1008,275,28,44240,21.434138737334372
"Shuqualak town, Mississippi",260,209,51,28,67640,19.615384615384617
"Eden village, Mississippi",55,51,4,28,21420,7.2727272727272725
"Itta Bena city, Mississippi",835,583,252,28,35260,30.179640718562872
"Silver City town, Mississippi",132,121,11,28,67920,8.333333333333332
"Blue Mountain town, Mississippi",385,338,47,28,07060,12.207792207792208
"Dumas town, Mississippi",208,180,28,28,20340,13.461538461538462
"Gattman village, Mississippi",57,47,10,28,26780,17.543859649122805
"Smithville town, Mississippi",314,275,39,28,68720,12.420382165605096
"Goodman town, Mississippi",372,263,109,28,28220,29.301075268817208
"Wesson town, Mississippi",688,577,111,28,78640,16.13372093023256
"McLain town, Mississippi",220,143,77,28,43840,35.0
"Cruger town, Mississippi",178,155,23,28,16980,12.921348314606742
"Pickens town, Mississippi",465,335,130,28,57200,27.956989247311824
"Tchula town, Mississippi",798,716,82,28,72440,10.275689223057643
"Fulton city, Mississippi",1421,1257,164,28,26300,11.541168191414497
"Gunnison town, Mississippi",157,141,16,28,29900,10.191082802547772
"Rosedale city, Mississippi",702,625,77,28,63720,10.968660968660968
"Crystal Springs city, Mississippi",1733,1549,184,28,17060,10.617426428159261
"Jackson city, Mississippi",74543,62109,12434,28,36000,16.680305327126625
"Tunica town, Mississippi",509,477,32,28,74760,6.286836935166994
"New Albany city, Mississippi",3586,2976,610,28,51000,17.01059676519799
"Sherman town, Mississippi",299,269,30,28,67200,10.033444816053512
"Duck Hill town, Mississippi",633,544,89,28,20260,14.06003159557662
"Maben town, Mississippi",355,293,62,28,42980,17.464788732394364
"Mathiston town, Mississippi",259,225,34,28,45720,13.127413127413126
"Yazoo City city, Mississippi",4534,3899,635,28,81520,14.005293339214822
"State Line town, Mississippi",281,218,63,28,70320,22.419928825622776
"Gulf Hills CDP, Mississippi",3511,2813,698,28,29620,19.880375961264598
"Gulf Park Estates CDP, Mississippi",2258,2073,185,28,29660,8.193091231178034
"Hurley CDP, Mississippi",511,469,42,28,34340,8.21917808219178
"Pascagoula city, Mississippi",10492,8304,2188,28,55360,20.853983987800227
"St. Martin CDP, Mississippi",3584,2832,752,28,64680,20.982142857142858
"Como town, Mississippi",706,599,107,28,15500,15.155807365439095
"Mayersville town, Mississippi",158,150,8,28,46000,5.063291139240507
"Big Creek village, Mississippi",86,68,18,28,06060,20.930232558139537
"Bruce town, Mississippi",932,742,190,28,09180,20.386266094420602
"Slate Springs village, Mississippi",53,38,15,28,68320,28.30188679245283
"Columbia city, Mississippi",2755,2118,637,28,15340,23.121597096188747
"New Houlka town, Mississippi",301,241,60,28,51420,19.93355481727575
"Crenshaw town, Mississippi",415,337,78,28,16460,18.795180722891565
"Prentiss town, Mississippi",598,473,125,28,59920,20.903010033444815
"D'Iberville city, Mississippi",5781,5308,473,28,19180,8.181975436775645
"Rolling Fork city, Mississippi",957,893,64,28,63560,6.687565308254964
"Tucker CDP, Mississippi",181,164,17,28,74675,9.392265193370166
"Morton city, Mississippi",1263,1125,138,28,49080,10.926365795724466
"Tishomingo town, Mississippi",209,178,31,28,73720,14.832535885167463
"Olive Branch city, Mississippi",14110,13347,763,28,54040,5.407512402551382
"Roxie town, Mississippi",215,169,46,28,64080,21.3953488372093
"Redwater CDP, Mississippi",272,264,8,28,61400,2.941176470588235
"McCool town, Mississippi",67,45,22,28,43400,32.83582089552239
"Schlater town, Mississippi",139,94,45,28,66080,32.37410071942446
"Lena town, Mississippi",81,71,10,28,40360,12.345679012345679
"Walnut Grove town, Mississippi",256,195,61,28,77520,23.828125
"Hatley town, Mississippi",242,224,18,28,30980,7.43801652892562
"Duncan town, Mississippi",166,115,51,28,20380,30.72289156626506
"Shelby city, Mississippi",877,712,165,28,67040,18.814139110604334
"Winstonville town, Mississippi",78,67,11,28,80800,14.102564102564102
"Leakesville town, Mississippi",513,440,73,28,39840,14.230019493177387
"Alligator town, Mississippi",72,59,13,28,00940,18.055555555555554
"Marion town, Mississippi",704,624,80,28,45160,11.363636363636363
"Poplarville city, Mississippi",849,668,181,28,59480,21.319199057714957
"Gloster town, Mississippi",615,419,196,28,27820,31.869918699186993
"Pachuta town, Mississippi",120,87,33,28,54960,27.500000000000004
"Toccopola town, Mississippi",130,108,22,28,73760,16.923076923076923
"Horn Lake city, Mississippi",10564,9506,1058,28,33700,10.01514577811435
"Artesia town, Mississippi",200,163,37,28,02100,18.5
"Caledonia town, Mississippi",566,551,15,28,10460,2.65017667844523
"Aberdeen city, Mississippi",2380,2023,357,28,00180,15.0
"Falkner town, Mississippi",305,264,41,28,24220,13.442622950819672
"Paden village, Mississippi",60,44,16,28,55000,26.666666666666668
"Alcorn State University CDP, Mississippi",203,148,55,28,00680,27.093596059113302
"Arnold Line CDP, Mississippi",945,822,123,28,02060,13.015873015873018
"Port Gibson city, Mississippi",749,592,157,28,59560,20.961281708945258
"Kiln CDP, Mississippi",1053,944,109,28,37600,10.351377018043685
"Pontotoc city, Mississippi",2178,1967,211,28,59160,9.687786960514233
"Mantee village, Mississippi",108,100,8,28,44960,7.4074074074074066
"Louise town, Mississippi",118,100,18,28,42240,15.254237288135593
"Walnut town, Mississippi",416,354,62,28,77480,14.903846153846153
"Long Beach city, Mississippi",6929,6357,572,28,41680,8.25515947467167
"Hattiesburg city, Mississippi",21032,17495,3537,28,31020,16.817230886268543
"Marietta town, Mississippi",123,108,15,28,45120,12.195121951219512
"Lumberton city, Mississippi",939,739,200,28,42640,21.299254526091588
"Columbus AFB CDP, Mississippi",588,560,28,28,15420,4.761904761904762
"Silver Creek town, Mississippi",74,56,18,28,67960,24.324324324324326
"Gulfport city, Mississippi",33848,28478,5370,28,29700,15.865043724887734
"Beaumont town, Mississippi",543,427,116,28,04500,21.36279926335175
"Tillatoba town, Mississippi",12,12,0,28,73440,0.0
"Utica town, Mississippi",375,332,43,28,75760,11.466666666666667
"Batesville city, Mississippi",2909,2517,392,28,03620,13.475421106909591
"Potts Camp town, Mississippi",293,266,27,28,59720,9.215017064846416
"Jumpertown town, Mississippi",277,236,41,28,37040,14.801444043321299
"Algoma town, Mississippi",282,241,41,28,00820,14.539007092198581
"Mize town, Mississippi",110,80,30,28,48240,27.27272727272727
"Bude town, Mississippi",533,369,164,28,09460,30.76923076923077
"Cleveland city, Mississippi",5177,4360,817,28,14260,15.781340544717018
"Fayette city, Mississippi",666,516,150,28,24500,22.52252252252252
"Isola town, Mississippi",357,313,44,28,35220,12.324929971988796
"West town, Mississippi",101,56,45,28,78680,44.554455445544555
"Quitman city, Mississippi",1064,864,200,28,60720,18.796992481203006
"Picayune city, Mississippi",5312,4336,976,28,57160,18.373493975903614
"Richland city, Mississippi",2663,2459,204,28,62400,7.660533233195645
"Waynesboro city, Mississippi",2052,1695,357,28,78360,17.39766081871345
"Walthall village, Mississippi",48,41,7,28,77640,14.583333333333334
"Jonestown town, Mississippi",512,440,72,28,36800,14.0625
"Edwards town, Mississippi",501,443,58,28,21580,11.57684630738523
"Kossuth village, Mississippi",141,105,36,28,38360,25.53191489361702
"Weir town, Mississippi",280,232,48,28,78520,17.142857142857142
"Nellieburg CDP, Mississippi",547,487,60,28,50720,10.968921389396709
"Sidon town, Mississippi",135,110,25,28,67840,18.51851851851852
"West Point city, Mississippi",4826,4245,581,28,79120,12.038955656858683
"Chunky town, Mississippi",197,166,31,28,13580,15.736040609137056
"Eupora city, Mississippi",1003,836,167,28,23420,16.650049850448653
"Verona city, Mississippi",1674,1323,351,28,76560,20.967741935483872
"Greenwood city, Mississippi",6491,5128,1363,28,29340,20.998305345863503
"Belzoni city, Mississippi",866,757,109,28,05140,12.58660508083141
"Terry town, Mississippi",544,470,74,28,72680,13.602941176470587
"Columbus city, Mississippi",12054,9749,2305,28,15380,19.12228305956529
"Petal city, Mississippi",4139,3795,344,28,56800,8.311186276878473
"Amory city, Mississippi",3278,2940,338,28,01260,10.311165344722392
"Boyle town, Mississippi",350,310,40,28,08180,11.428571428571429
"Sunflower town, Mississippi",466,426,40,28,71600,8.583690987124463
"Saucier CDP, Mississippi",544,467,77,28,65720,14.154411764705882
"Union town, Mississippi",874,745,129,28,75360,14.759725400457665
"Sebastopol town, Mississippi",146,142,4,28,66280,2.73972602739726
"Tutwiler town, Mississippi",405,346,59,28,75040,14.5679012345679
"Iuka city, Mississippi",1517,1164,353,28,35300,23.269611074489124
"Natchez city, Mississippi",7939,6228,1711,28,50440,21.551832724524502
"Montrose town, Mississippi",81,55,26,28,48640,32.098765432098766
"Summit town, Mississippi",878,748,130,28,71480,14.80637813211845
"Sumrall town, Mississippi",657,582,75,28,71560,11.415525114155251
"Starkville city, Mississippi",12495,9925,2570,28,70240,20.568227290916365
"McComb city, Mississippi",5913,4955,958,28,43280,16.20158971757145
"New Augusta town, Mississippi",284,241,43,28,51040,15.140845070422534
"Richton town, Mississippi",437,307,130,28,62480,29.74828375286041
"Crowder town, Mississippi",317,269,48,28,16940,15.141955835962145
"Sledge town, Mississippi",203,177,26,28,68400,12.807881773399016
"Enterprise town, Mississippi",272,217,55,28,22580,20.22058823529412
"De Kalb town, Mississippi",583,470,113,28,18340,19.382504288164665
"Wade CDP, Mississippi",467,411,56,28,77080,11.991434689507495
"Glen town, Mississippi",231,189,42,28,27540,18.181818181818183
"Collinsville CDP, Mississippi",645,645,0,28,15180,0.0
"Meridian city, Mississippi",19302,15815,3487,28,46640,18.06548544192312
"Ellisville city, Mississippi",1580,1352,228,28,22020,14.430379746835442
"Soso town, Mississippi",186,169,17,28,69160,9.13978494623656
"Oakland town, Mississippi",268,230,38,28,53200,14.17910447761194
"Cary town, Mississippi",174,136,38,28,11820,21.839080459770116
"West Hattiesburg CDP, Mississippi",2607,2266,341,28,78890,13.080168776371309
"Crosby town, Mississippi",147,112,35,28,16620,23.809523809523807
"Shubuta town, Mississippi",212,161,51,28,67520,24.056603773584907
"Anguilla town, Mississippi",327,280,47,28,01500,14.37308868501529
"Centreville town, Mississippi",818,638,180,28,12740,22.00488997555012
"Purvis city, Mississippi",911,802,109,28,60480,11.964873765093303
"Liberty town, Mississippi",378,297,81,28,40640,21.428571428571427
"Hernando city, Mississippi",5754,5509,245,28,31780,4.257907542579075
"Ocean Springs city, Mississippi",7246,6345,901,28,53520,12.434446591222743
"Meadville town, Mississippi",271,227,44,28,46200,16.236162361623617
"Scooba town, Mississippi",248,201,47,28,66160,18.951612903225808
"Moss Point city, Mississippi",6602,5206,1396,28,49240,21.145107543168738
"Arcola town, Mississippi",184,115,69,28,01820,37.5
"Hollandale city, Mississippi",1078,916,162,28,32900,15.0278293135436
"Water Valley city, Mississippi",1704,1399,305,28,78000,17.899061032863848
"Pace town, Mississippi",107,82,25,28,54920,23.364485981308412
"Mantachie town, Mississippi",633,562,71,28,44920,11.216429699842022
"Forest city, Mississippi",2566,2188,378,28,25340,14.731098986749805
"Sumner town, Mississippi",174,124,50,28,71520,28.735632183908045
"Senatobia city, Mississippi",2980,2583,397,28,66440,13.322147651006711
"Baldwyn city, Mississippi",1514,1331,183,28,02700,12.087186261558784
"Sylvarena village, Mississippi",51,36,15,28,72040,29.411764705882355
"Vicksburg city, Mississippi",11053,9240,1813,28,76720,16.402786573780876
"Clarksdale city, Mississippi",7272,5862,1410,28,13820,19.389438943894387
"Ridgeland city, Mississippi",11669,10570,1099,28,62520,9.418116376724656
"Vaiden town, Mississippi",372,220,152,28,75880,40.86021505376344
"Canton city, Mississippi",5130,4519,611,28,11100,11.910331384015596
"Flora town, Mississippi",721,647,74,28,24940,10.263522884882107
"Guntown town, Mississippi",945,886,59,28,29940,6.243386243386243
"Shannon town, Mississippi",799,693,106,28,66720,13.266583229036296
"Satartia village, Mississippi",21,15,6,28,65680,28.57142857142857
"Ruleville city, Mississippi",1105,934,171,28,64200,15.475113122171946
"Braxton village, Mississippi",92,70,22,28,08460,23.91304347826087
"Mendenhall city, Mississippi",1086,919,167,28,46600,15.377532228360957
"Indianola city, Mississippi",3959,3524,435,28,34740,10.987623137155847
"Booneville city, Mississippi",3316,2806,510,28,07780,15.379975874547647
"Lyman CDP, Mississippi",1003,911,92,28,42800,9.172482552342972
"Philadelphia city, Mississippi",3301,2701,600,28,56960,18.17631020902757
"Magee city, Mississippi",1764,1437,327,28,44600,18.537414965986397
"Benoit town, Mississippi",187,172,15,28,05220,8.02139037433155
"Merigold town, Mississippi",200,166,34,28,46720,17.0
"Durant city, Mississippi",1196,942,254,28,20500,21.237458193979933
"Doddsville town, Mississippi",92,88,4,28,19420,4.3478260869565215
"Sturgis town, Mississippi",113,103,10,28,71320,8.849557522123893
"Lake town, Mississippi",158,142,16,28,38600,10.126582278481013
"Beulah town, Mississippi",184,163,21,28,05820,11.41304347826087
"Renova town, Mississippi",368,361,7,28,61890,1.9021739130434785
"Georgetown town, Mississippi",153,130,23,28,26980,15.032679738562091
"Lucedale city, Mississippi",1186,955,231,28,42440,19.477234401349072
"Inverness town, Mississippi",413,352,61,28,35020,14.769975786924938
"Flowood city, Mississippi",4089,3828,261,28,25100,6.382978723404255
"Puckett village, Mississippi",139,128,11,28,60360,7.913669064748201
"Tylertown town, Mississippi",739,597,142,28,75160,19.215155615696887
"Ackerman town, Mississippi",773,638,135,28,00300,17.46442432082794
"Carrollton town, Mississippi",79,68,11,28,11580,13.924050632911392
"Morgan City town, Mississippi",104,75,29,28,48800,27.884615384615387
"Hickory Flat town, Mississippi",237,194,43,28,32020,18.143459915611814
"Clinton city, Mississippi",9959,9161,798,28,14420,8.012852696053821
"Latimer CDP, Mississippi",2880,2589,291,28,39520,10.104166666666666
"Nettleton city, Mississippi",972,784,188,28,50880,19.34156378600823
"Saltillo city, Mississippi",1921,1812,109,28,64840,5.674128058302967
"Meridian Station CDP, Mississippi",98,98,0,28,46680,0.0
"Lynchburg CDP, Mississippi",880,880,0,28,42840,0.0
"Big Point CDP, Mississippi",307,257,50,28,06180,16.286644951140065
"Rienzi town, Mississippi",146,127,19,28,62560,13.013698630136986
"Metcalfe town, Mississippi",463,355,108,28,46880,23.326133909287257
"Farmington town, Mississippi",1016,890,126,28,24420,12.401574803149607
"Woodville town, Mississippi",547,371,176,28,81120,32.17550274223035
"Bentonia town, Mississippi",180,159,21,28,05380,11.666666666666666
"Snow Lake Shores town, Mississippi",323,170,153,28,68960,47.368421052631575
"Bolton town, Mississippi",320,266,54,28,07540,16.875
"Crawford town, Mississippi",233,183,50,28,16420,21.45922746781116
"French Camp town, Mississippi",57,46,11,28,26020,19.298245614035086
"Falcon town, Mississippi",64,54,10,28,24180,15.625
"Biloxi city, Mississippi",21608,17954,3654,28,06220,16.91040355423917
"Pass Christian city, Mississippi",2929,2103,826,28,55400,28.200751109593718
"New Hope CDP, Mississippi",1336,1265,71,28,51400,5.31437125748503
"Carthage city, Mississippi",1643,1434,209,28,11780,12.720632988435787
"Hickory town, Mississippi",257,209,48,28,31980,18.67704280155642
"Courtland town, Mississippi",202,175,27,28,15980,13.366336633663368
"Sardis town, Mississippi",949,769,180,28,65560,18.967334035827186
"Ripley city, Mississippi",2225,1813,412,28,62600,18.516853932584272
"Pearlington CDP, Mississippi",599,412,187,28,55920,31.21869782971619
"Mound Bayou city, Mississippi",698,617,81,28,49320,11.60458452722063
"Beauregard village, Mississippi",151,128,23,28,04540,15.2317880794702
"D'Lo town, Mississippi",213,201,12,28,19340,5.633802816901409
"Hazlehurst city, Mississippi",1528,1155,373,28,31220,24.410994764397905
"Lexington city, Mississippi",913,682,231,28,40600,25.301204819277107
"Tremont town, Mississippi",217,189,28,28,74400,12.903225806451612
"Moorhead city, Mississippi",678,573,105,28,48760,15.486725663716813
"Shaw city, Mississippi",732,658,74,28,67000,10.10928961748634
"Brandon city, Mississippi",9258,8764,494,28,08300,5.335925685893281
"Pelahatchie town, Mississippi",603,510,93,28,56200,15.422885572139302
"Blue Springs village, Mississippi",110,88,22,28,07100,20.0
"Pope village, Mississippi",93,89,4,28,59240,4.301075268817205
"Heidelberg town, Mississippi",408,345,63,28,31420,15.441176470588236
"Louin town, Mississippi",159,115,44,28,42200,27.67295597484277
"Pittsboro village, Mississippi",79,50,29,28,58360,36.708860759493675
"Newton city, Mississippi",1526,1372,154,28,51720,10.091743119266056
"Charleston city, Mississippi",990,738,252,28,12900,25.454545454545453
"Madison city, Mississippi",9355,8940,415,28,44520,4.436130411544629
"Plantersville town, Mississippi",422,353,69,28,58440,16.350710900473935
"Tupelo city, Mississippi",16861,14762,2099,28,74840,12.448846450388471
"Pearl River CDP, Mississippi",1291,1162,129,28,55930,9.992254066615027
"Walls town, Mississippi",529,469,60,28,77400,11.342155009451796
"Polkville town, Mississippi",322,205,117,28,58960,36.33540372670808
"Glendora village, Mississippi",34,25,9,28,27660,26.47058823529412
"Coldwater town, Mississippi",740,655,85,28,14900,11.486486486486488
"Burnsville town, Mississippi",455,355,100,28,09820,21.978021978021978
"Magnolia city, Mississippi",939,684,255,28,44680,27.15654952076677
"Ecru town, Mississippi",420,389,31,28,21340,7.380952380952381
"Thaxton town, Mississippi",360,298,62,28,72760,17.22222222222222
"Brooksville town, Mississippi",488,408,80,28,08980,16.39344262295082
"Grenada city, Mississippi",6240,4919,1321,28,29460,21.169871794871796
"Mount Olive town, Mississippi",446,358,88,28,49520,19.730941704035875
"Seminary town, Mississippi",192,171,21,28,66400,10.9375
"Calhoun City town, Mississippi",789,693,96,28,10580,12.167300380228136
"Raleigh town, Mississippi",680,480,200,28,60840,29.411764705882355
"Taylorsville town, Mississippi",781,693,88,28,72400,11.267605633802818
"Bay Springs city, Mississippi",760,606,154,28,04060,20.263157894736842
"Friars Point town, Mississippi",537,460,77,28,26060,14.338919925512103
"Holly Springs city, Mississippi",2855,2451,404,28,33100,14.15061295971979
"Conehatta CDP, Mississippi",510,382,128,28,15540,25.098039215686274
"Decatur town, Mississippi",706,599,107,28,18180,15.155807365439095
"Lula town, Mississippi",130,95,35,28,42600,26.923076923076923
"Bassfield town, Mississippi",187,135,52,28,03580,27.807486631016044
"Abbeville town, Mississippi",164,134,30,28,00100,18.29268292682927
"Oxford city, Mississippi",13331,9250,4081,28,54840,30.612857250018756
"Taylor village, Mississippi",147,113,34,28,72360,23.12925170068027
"Wiggins city, Mississippi",1459,1312,147,28,80160,10.075394105551748
"Escatawpa CDP, Mississippi",1589,1276,313,28,22900,19.697923222152298
"Gautier city, Mississippi",8059,6697,1362,28,26860,16.900359846134755
"Vancleave CDP, Mississippi",2398,1832,566,28,76200,23.603002502085072
"Greenville city, Mississippi",14294,12277,2017,28,29180,14.110815726878412
"Noxapater town, Mississippi",241,187,54,28,52880,22.40663900414938
"New Hebron town, Mississippi",240,214,26,28,51360,10.833333333333334
"Derma town, Mississippi",494,435,59,28,18940,11.94331983805668
"Byhalia town, Mississippi",698,615,83,28,10060,11.89111747851003
"Woodland village, Mississippi",90,77,13,28,81000,14.444444444444443
"Coahoma town, Mississippi",138,125,13,28,14580,9.420289855072465
"Lyon town, Mississippi",237,205,32,28,42960,13.502109704641349
"Lambert town, Mississippi",673,589,84,28,39080,12.481426448736999
"Marks city, Mississippi",790,681,109,28,45240,13.79746835443038
"Brookhaven city, Mississippi",5477,4474,1003,28,08820,18.3129450429067
"Beechwood CDP, Mississippi",1494,1356,138,28,04705,9.236947791164658
"Bogue Chitto CDP (Kemper and Neshoba Counties), Mississippi",213,192,21,28,07330,9.859154929577464
"Bogue Chitto CDP (Lincoln County), Mississippi",176,131,45,28,07340,25.568181818181817
"Bridgetown CDP, Mississippi",807,807,0,28,08655,0.0
"Buckatunna CDP, Mississippi",196,137,59,28,09380,30.102040816326532
"Byram city, Mississippi",4795,4404,391,28,10140,8.154327424400417
"Clara CDP, Mississippi",181,181,0,28,13700,0.0
"Cleary CDP, Mississippi",554,554,0,28,14140,0.0
"Cloverdale CDP, Mississippi",249,249,0,28,14540,0.0
"Darling CDP, Mississippi",94,86,8,28,17700,8.51063829787234
"DeLisle CDP, Mississippi",535,478,57,28,18420,10.654205607476635
"Elliott CDP, Mississippi",423,379,44,28,21940,10.401891252955082
"Farrell CDP, Mississippi",204,184,20,28,24460,9.803921568627452
"Foxworth CDP, Mississippi",212,184,28,28,25740,13.20754716981132
"Glendale CDP, Mississippi",893,767,126,28,27620,14.109742441209406
"Hamilton CDP, Mississippi",189,189,0,28,30220,0.0
"Henderson Point CDP, Mississippi",321,122,199,28,31540,61.99376947040498
"Hide-A-Way Lake CDP, Mississippi",1121,869,252,28,32110,22.47992863514719
"Hillsboro CDP, Mississippi",485,373,112,28,32460,23.09278350515464
"Holcomb CDP, Mississippi",162,162,0,28,32820,0.0
"Kearney Park CDP, Mississippi",398,351,47,28,37190,11.809045226130653
"Lauderdale CDP, Mississippi",223,179,44,28,39600,19.730941704035875
"Mississippi State CDP, Mississippi",106,106,0,28,48030,0.0
"Mississippi Valley State University CDP, Mississippi",321,203,118,28,48120,36.7601246105919
"Morgantown CDP, Mississippi",693,629,64,28,48880,9.235209235209235
"New Hamilton CDP, Mississippi",213,213,0,28,51240,0.0
"Nicholson CDP, Mississippi",1238,1060,178,28,51840,14.378029079159935
"Rawls Springs CDP, Mississippi",387,387,0,28,61080,0.0
"Robinhood CDP, Mississippi",691,566,125,28,62900,18.08972503617945
"Sharon CDP, Mississippi",515,377,138,28,66840,26.796116504854368
"Toomsuba CDP, Mississippi",392,302,90,28,73880,22.95918367346939
"Mooreville CDP, Mississippi",347,317,30,28,48720,8.645533141210375
"Tunica Resorts CDP, Mississippi",1419,1054,365,28,74820,25.72233967582805
"University CDP, Mississippi",50,21,29,28,75520,57.99999999999999
"White Oak CDP, Mississippi",217,178,39,28,79620,17.972350230414747
"Florence city, Mississippi",1645,1517,128,28,24980,7.781155015197569
"Diamondhead city, Mississippi",4220,3497,723,28,19100,17.13270142180095
"Worth village, Missouri",48,25,23,29,81070,47.91666666666667
"Three Creeks village, Missouri",4,4,0,29,73127,0.0
"Ginger Blue village, Missouri",31,20,11,29,27100,35.483870967741936
"Huntsdale town, Missouri",6,6,0,29,33868,0.0
"Oak Grove Village village, Missouri",198,159,39,29,53650,19.696969696969695
"Saddlebrooke village, Missouri",106,97,9,29,63857,8.49056603773585
"Waco city, Missouri",32,25,7,29,76444,21.875
"Windsor Place village, Missouri",146,137,9,29,80380,6.164383561643835
"Wood Heights city, Missouri",276,243,33,29,80767,11.956521739130435
"Grayridge CDP, Missouri",51,42,9,29,28864,17.647058823529413
"Hartwell CDP, Missouri",9,9,0,29,30772,0.0
"Harviell CDP, Missouri",24,0,24,29,30844,100.0
"Hayward CDP, Missouri",54,42,12,29,31186,22.22222222222222
"Hunter CDP, Missouri",56,44,12,29,33778,21.428571428571427
"Irwin CDP, Missouri",41,41,0,29,35486,0.0
"Kissee Mills CDP, Missouri",598,506,92,29,39080,15.384615384615385
"LaBarque Creek CDP, Missouri",602,591,11,29,39503,1.8272425249169437
"Lake Tekakwitha village, Missouri",124,100,24,29,40214,19.35483870967742
"Lake Viking CDP, Missouri",548,180,368,29,40304,67.15328467153284
"La Tour CDP, Missouri",49,49,0,29,40880,0.0
"Laurie city, Missouri",518,485,33,29,40916,6.370656370656371
"Leisure Lake CDP, Missouri",136,60,76,29,41417,55.88235294117647
"Mine La Motte CDP, Missouri",177,152,25,29,48602,14.124293785310735
"Montier CDP, Missouri",23,23,0,29,49610,0.0
"Old Jamestown CDP, Missouri",7685,7232,453,29,54352,5.894599869876382
"Oxly CDP, Missouri",109,79,30,29,55694,27.522935779816514
"Ozora CDP, Missouri",60,50,10,29,55892,16.666666666666664
"Peaceful Village village, Missouri",11,11,0,29,56620,0.0
"Phelps City CDP, Missouri",0,0,0,29,57332,
"Plevna CDP, Missouri",53,13,40,29,58574,75.47169811320755
"Pomona CDP, Missouri",235,141,94,29,58934,40.0
"Pontiac CDP, Missouri",193,99,94,29,59060,48.704663212435236
"Ravanna CDP, Missouri",52,36,16,29,60644,30.76923076923077
"St. Clement CDP, Missouri",43,43,0,29,64154,0.0
"St. Francisville CDP, Missouri",79,63,16,29,64244,20.253164556962027
"Shoal Creek Estates village, Missouri",34,34,0,29,67632,0.0
"South Fork CDP, Missouri",96,49,47,29,68762,48.95833333333333
"Sundown CDP, Missouri",23,17,6,29,71628,26.08695652173913
"Thomasville CDP, Missouri",23,0,23,29,73006,100.0
"Wasola CDP, Missouri",95,68,27,29,77794,28.421052631578945
"Weingarten CDP, Missouri",28,28,0,29,78226,0.0
"West Sullivan town, Missouri",55,53,2,29,79000,3.6363636363636362
"Winigan CDP, Missouri",44,12,32,29,80440,72.72727272727273
"Wortham CDP, Missouri",129,81,48,29,81088,37.2093023255814
"Ashley CDP, Missouri",71,43,28,29,02260,39.436619718309856
"Bennett Springs CDP, Missouri",192,79,113,29,04525,58.854166666666664
"Biehle CDP, Missouri",10,10,0,29,05320,0.0
"Big Spring CDP, Missouri",103,76,27,29,05608,26.21359223300971
"Blanchard CDP, Missouri",5,5,0,29,06247,0.0
"Brewer CDP, Missouri",116,116,0,29,08272,0.0
"Cherokee Pass CDP, Missouri",154,127,27,29,13474,17.532467532467532
"Dawn CDP, Missouri",111,80,31,29,18496,27.927927927927925
"Chesapeake CDP, Missouri",14,14,0,29,13582,0.0
"Conception CDP, Missouri",33,33,0,29,15886,0.0
"Danville CDP, Missouri",9,9,0,29,18190,0.0
"Defiance CDP, Missouri",61,61,0,29,18910,0.0
"Doe Run CDP, Missouri",403,403,0,29,19684,0.0
"Eagle Rock CDP, Missouri",174,65,109,29,20656,62.643678160919535
"Edinburg CDP, Missouri",64,64,0,29,21340,0.0
"Excello CDP, Missouri",19,11,8,29,23050,42.10526315789473
"Fairdealing CDP, Missouri",425,282,143,29,23248,33.64705882352941
"Frankclay CDP, Missouri",106,106,0,29,25516,0.0
"Fremont CDP, Missouri",18,18,0,29,25948,0.0
"Gilliam city, Missouri",111,84,27,29,27028,24.324324324324326
"Golden CDP, Missouri",380,281,99,29,27658,26.052631578947366
"Grayhawk CDP, Missouri",467,278,189,29,28860,40.471092077087796
"Calverton Park city, Missouri",595,541,54,29,10612,9.07563025210084
"Climax Springs CDP, Missouri",100,82,18,29,14914,18.0
"Velda Village Hills city, Missouri",442,373,69,29,75814,15.610859728506787
"Bellerive Acres city, Missouri",84,76,8,29,04248,9.523809523809524
"Zalma CDP, Missouri",49,29,20,29,81430,40.816326530612244
"Burgess CDP, Missouri",22,22,0,29,09802,0.0
"Butterfield city, Missouri",293,168,125,29,10144,42.66211604095563
"Eugene CDP, Missouri",114,109,5,29,22798,4.385964912280701
"Goodman city, Missouri",557,490,67,29,27874,12.028725314183124
"Lithium CDP, Missouri",61,48,13,29,43346,21.311475409836063
"Quitman CDP, Missouri",32,11,21,29,60410,65.625
"St. George CDP, Missouri",864,835,29,29,64370,3.356481481481482
"Terre du Lac CDP, Missouri",1383,1113,270,29,72772,19.522776572668114
"Jane town, Missouri",184,155,29,29,36422,15.760869565217392
"Macks Creek CDP, Missouri",157,119,38,29,45218,24.203821656050955
"Charmwood town, Missouri",19,16,3,29,13390,15.789473684210526
"Rayville CDP, Missouri",34,34,0,29,60824,0.0
"Montreal CDP, Missouri",55,55,0,29,49646,0.0
"Centerview city, Missouri",104,85,19,29,12682,18.269230769230766
"Annada village, Missouri",29,19,10,29,01252,34.48275862068966
"Irena village, Missouri",8,8,0,29,35324,0.0
"Centerville city, Missouri",89,56,33,29,12718,37.07865168539326
"Burlington Junction city, Missouri",259,204,55,29,09838,21.235521235521233
"Conception Junction town, Missouri",82,76,6,29,15922,7.317073170731707
"Osgood village, Missouri",29,6,23,29,55424,79.3103448275862
"Village of Four Seasons village, Missouri",2572,816,1756,29,76157,68.27371695178849
"Atlanta city, Missouri",224,190,34,29,02422,15.178571428571427
"South Gifford village, Missouri",32,17,15,29,68852,46.875
"Boonville city, Missouri",3562,3072,490,29,07318,13.756316676024705
"Tightwad village, Missouri",27,25,2,29,73240,7.4074074074074066
"Concordia city, Missouri",1250,1026,224,29,16102,17.919999999999998
"Higginsville city, Missouri",2167,1804,363,29,31960,16.751269035532996
"Mayview city, Missouri",129,102,27,29,46964,20.930232558139537
"Waverly city, Missouri",406,345,61,29,77866,15.024630541871922
"California city, Missouri",1844,1641,203,29,10468,11.008676789587852
"Ellington city, Missouri",615,483,132,29,21844,21.463414634146343
"Browning city, Missouri",121,83,38,29,08884,31.40495867768595
"Greencastle city, Missouri",124,67,57,29,29116,45.96774193548387
"Pollock village, Missouri",28,17,11,29,58898,39.285714285714285
"Urbana city, Missouri",219,157,62,29,75310,28.31050228310502
"West Plains city, Missouri",5679,5128,551,29,78928,9.702412396548688
"Alexandria city, Missouri",55,46,9,29,00604,16.363636363636363
"Lake Waukomis city, Missouri",429,401,28,29,40322,6.526806526806526
"Lewis and Clark Village town, Missouri",66,54,12,29,41834,18.181818181818183
"Ellsinore city, Missouri",250,194,56,29,21916,22.400000000000002
"Carthage city, Missouri",5733,5130,603,29,11656,10.518053375196232
"Clarksburg city, Missouri",149,100,49,29,14140,32.88590604026846
"Wayland city, Missouri",332,273,59,29,77920,17.771084337349397
"Highlandville city, Missouri",474,414,60,29,32068,12.658227848101266
"Fairfax city, Missouri",366,320,46,29,23266,12.568306010928962
"Westboro city, Missouri",74,53,21,29,78622,28.37837837837838
"St. Martins city, Missouri",501,492,9,29,65018,1.7964071856287425
"Taos city, Missouri",501,475,26,29,72304,5.189620758483033
"Eagleville town, Missouri",168,133,35,29,20674,20.833333333333336
"Weldon Spring city, Missouri",2334,2296,38,29,78314,1.6281062553556127
"Stewartsville city, Missouri",323,314,9,29,70738,2.786377708978328
"Grain Valley city, Missouri",5195,5039,156,29,28090,3.0028873917228105
"McCord Bend village, Missouri",166,120,46,29,44829,27.710843373493976
"Schell City city, Missouri",124,109,15,29,66134,12.096774193548388
"Clinton CDP, Montana",336,313,23,30,15475,6.845238095238096
"Frenchtown CDP, Montana",895,842,53,30,29350,5.921787709497207
"Lewistown city, Montana",3246,2864,382,30,43375,11.768330252618608
"Lincoln CDP, Montana",797,423,374,30,43675,46.92597239648683
"Drummond town, Montana",184,129,55,30,21850,29.891304347826086
"Big Sandy town, Montana",280,217,63,30,06250,22.5
"Box Elder CDP, Montana",49,35,14,30,08725,28.57142857142857
"Bearcreek town, Montana",66,58,8,30,04300,12.121212121212121
"Belfry CDP, Montana",129,121,8,30,04900,6.2015503875969
"Ronan city, Montana",893,827,66,30,64150,7.3908174692049275
"Alberton town, Montana",235,204,31,30,00700,13.191489361702127
"Superior town, Montana",385,340,45,30,72625,11.688311688311687
"Plevna town, Montana",94,81,13,30,58450,13.829787234042554
"Azure CDP, Montana",82,71,11,30,03212,13.414634146341465
"East Missoula CDP, Montana",905,901,4,30,23200,0.44198895027624313
"Wye CDP, Montana",240,240,0,30,81980,0.0
"Froid town, Montana",102,72,30,30,29500,29.411764705882355
"Wolf Point city, Montana",1041,832,209,30,81475,20.076849183477425
"Alder CDP, Montana",55,33,22,30,00850,40.0
"Sheridan town, Montana",411,348,63,30,67600,15.328467153284672
"Kevin town, Montana",99,70,29,30,40525,29.292929292929294
"Cascade town, Montana",346,285,61,30,12775,17.63005780346821
"Sun Prairie CDP, Montana",578,578,0,30,72380,0.0
"Roundup city, Montana",980,774,206,30,64525,21.020408163265305
"Butte-Silver Bow (balance), Montana",16734,14837,1897,30,11397,11.3362017449504
"Loma CDP, Montana",55,41,14,30,44800,25.454545454545453
"Dodson town, Montana",71,42,29,30,21025,40.845070422535215
"Antelope CDP, Montana",32,32,0,30,02050,0.0
"Clancy CDP, Montana",756,713,43,30,15100,5.6878306878306875
"Harlem city, Montana",337,309,28,30,34375,8.30860534124629
"Crow Agency CDP, Montana",446,387,59,30,18250,13.228699551569505
"Havre North CDP, Montana",351,281,70,30,35125,19.943019943019944
"North Browning CDP, Montana",774,680,94,30,54510,12.144702842377262
"Jette CDP, Montana",209,110,99,30,39627,47.368421052631575
"Harrison CDP, Montana",51,39,12,30,34525,23.52941176470588
"Sangrey CDP, Montana",124,99,25,30,66212,20.161290322580644
"Wyola CDP, Montana",81,64,17,30,82075,20.98765432098765
"Westby town, Montana",115,69,46,30,78925,40.0
"Sun River CDP, Montana",59,44,15,30,72475,25.423728813559322
"Dutton town, Montana",183,147,36,30,22600,19.672131147540984
"Walkerville town, Montana",416,321,95,30,77650,22.83653846153846
"Hobson city, Montana",118,95,23,30,36700,19.491525423728813
"Finley Point CDP, Montana",824,284,540,30,26226,65.53398058252428
"Radersburg CDP, Montana",72,72,0,30,60475,0.0
"Harlowton city, Montana",641,450,191,30,34450,29.797191887675506
"St. Pierre CDP, Montana",101,84,17,30,65537,16.831683168316832
"Fairview town, Montana",414,357,57,30,25300,13.768115942028986
"Augusta CDP, Montana",178,133,45,30,03025,25.280898876404496
"Somers CDP, Montana",767,445,322,30,69475,41.98174706649283
"Ulm CDP, Montana",284,259,25,30,75775,8.80281690140845
"East Glacier Park Village CDP, Montana",271,191,80,30,22985,29.520295202952028
"Highwood CDP, Montana",96,81,15,30,36250,15.625
"Elliston CDP, Montana",145,123,22,30,23950,15.172413793103448
"Fallon CDP, Montana",67,36,31,30,25375,46.26865671641791
"Big Timber city, Montana",886,737,149,30,06475,16.817155756207676
"Fort Benton city, Montana",811,661,150,30,28000,18.495684340320594
"Circle town, Montana",343,251,92,30,14950,26.82215743440233
"Musselshell CDP, Montana",48,29,19,30,52600,39.58333333333333
"Winston CDP, Montana",93,93,0,30,81175,0.0
"Carter CDP, Montana",33,22,11,30,12625,33.33333333333333
"Arlee CDP, Montana",279,246,33,30,02425,11.827956989247312
"Charlo CDP, Montana",168,143,25,30,13900,14.880952380952381
"Avon CDP, Montana",67,58,9,30,03175,13.432835820895523
"Pablo CDP, Montana",914,806,108,30,56350,11.816192560175056
"St. Ignatius town, Montana",339,298,41,30,65275,12.094395280235988
"Turtle Lake CDP, Montana",70,70,0,30,75287,0.0
"Deer Lodge city, Montana",1633,1379,254,30,19825,15.554194733619106
"Ryegate town, Montana",123,88,35,30,64975,28.455284552845526
"Fairfield town, Montana",348,291,57,30,25225,16.379310344827587
"Opheim town, Montana",79,67,12,30,55525,15.18987341772152
"Bonner-West Riverside CDP, Montana",849,717,132,30,08462,15.547703180212014
"Evaro CDP, Montana",140,140,0,30,25000,0.0
"Orchard Homes CDP, Montana",2362,2232,130,30,55675,5.50381033022862
"Paradise CDP, Montana",83,77,6,30,56425,7.228915662650602
"Trout Creek CDP, Montana",125,78,47,30,74950,37.6
"Bridger town, Montana",350,310,40,30,09475,11.428571428571429
"Big Arm CDP, Montana",187,115,72,30,05800,38.50267379679144
"Dayton CDP, Montana",91,40,51,30,19525,56.043956043956044
"West Havre CDP, Montana",106,76,30,30,79098,28.30188679245283
"Victor CDP, Montana",344,324,20,30,76900,5.813953488372093
"Belgrade city, Montana",3487,3207,280,30,04975,8.02982506452538
"Willow Creek CDP, Montana",131,118,13,30,80800,9.923664122137405
"Lolo CDP, Montana",1450,1350,100,30,44650,6.896551724137931
"Livingston city, Montana",3797,3621,176,30,43975,4.635238346062681
"Whitefish city, Montana",4652,3217,1435,30,79825,30.8469475494411
"Moore town, Montana",81,74,7,30,51550,8.641975308641975
"South Browning CDP, Montana",545,500,45,30,69680,8.256880733944955
"Darby town, Montana",412,340,72,30,19300,17.475728155339805
"Pinesdale town, Montana",176,169,7,30,57700,3.977272727272727
"Three Forks city, Montana",881,808,73,30,73975,8.286038592508513
"Hardin city, Montana",1349,1227,122,30,34225,9.04373610081542
"Columbus town, Montana",984,860,124,30,16825,12.601626016260163
"Choteau city, Montana",920,824,96,30,14650,10.434782608695652
"Custer CDP, Montana",89,71,18,30,18700,20.224719101123593
"Kalispell city, Montana",9457,8945,512,30,40075,5.413979063127842
"Martin City CDP, Montana",255,185,70,30,48100,27.450980392156865
"Medicine Lake town, Montana",212,149,63,30,48775,29.71698113207547
"Outlook town, Montana",31,26,5,30,56050,16.129032258064516
"Plentywood city, Montana",989,874,115,30,58375,11.627906976744185
"Ismay town, Montana",2,0,2,30,38950,100.0
"Denton town, Montana",134,107,27,30,20425,20.149253731343283
"Browning town, Montana",381,337,44,30,10375,11.548556430446194
"Conrad city, Montana",1237,1010,227,30,17275,18.350848827809216
"Fort Peck town, Montana",152,113,39,30,28450,25.657894736842106
"Glasgow city, Montana",1575,1466,109,30,31075,6.92063492063492
"Nashua town, Montana",212,171,41,30,52900,19.339622641509436
"Broadview town, Montana",56,54,2,30,09775,3.571428571428571
"Birney CDP, Montana",41,22,19,30,06925,46.34146341463415
"Stanford town, Montana",216,182,34,30,70675,15.74074074074074
"Virginia City town, Montana",184,94,90,30,77125,48.91304347826087
"Greycliff CDP, Montana",52,40,12,30,33250,23.076923076923077
"Lame Deer CDP, Montana",657,508,149,30,42250,22.67884322678843
"Bigfork CDP, Montana",3251,2054,1197,30,05875,36.819440172254694
"Ekalaka town, Montana",277,203,74,30,23650,26.714801444043324
"Whitehall town, Montana",454,394,60,30,79900,13.215859030837004
"Lavina town, Montana",118,99,19,30,42850,16.101694915254235
"Power CDP, Montana",105,91,14,30,59500,13.333333333333334
"St. Marie CDP, Montana",808,230,578,30,65400,71.53465346534654
"Ballantine CDP, Montana",90,90,0,30,03625,0.0
"Seeley Lake CDP, Montana",1147,582,565,30,67150,49.258936355710546
"Flaxville town, Montana",40,16,24,30,26800,60.0
"Scobey city, Montana",749,606,143,30,66925,19.092122830440587
"Rexford town, Montana",83,51,32,30,62200,38.55421686746988
"Poplar city, Montana",376,300,76,30,58975,20.212765957446805
"Ashland CDP, Montana",326,275,51,30,02800,15.644171779141105
"Forsyth city, Montana",1016,801,215,30,27700,21.161417322834648
"Shelby city, Montana",1353,1124,229,30,67450,16.925351071692535
"Grass Range town, Montana",77,65,12,30,32575,15.584415584415584
"Helena West Side CDP, Montana",728,657,71,30,35640,9.752747252747254
"Valier town, Montana",279,235,44,30,76225,15.770609318996415
"Corvallis CDP, Montana",478,423,55,30,17725,11.506276150627615
"Florence CDP, Montana",303,227,76,30,26950,25.082508250825082
"Glendive city, Montana",2390,2215,175,30,31450,7.322175732217573
"Clyde Park town, Montana",122,99,23,30,15550,18.852459016393443
"Chester town, Montana",611,472,139,30,14200,22.749590834697216
"Terry town, Montana",374,292,82,30,73675,21.92513368983957
"Great Falls city, Montana",27858,25717,2141,30,32800,7.685404551654821
"Vaughn CDP, Montana",314,289,25,30,76675,7.961783439490445
"Boneau CDP, Montana",112,103,9,30,08162,8.035714285714286
"Fortine CDP, Montana",165,119,46,30,28150,27.878787878787882
"Heron CDP, Montana",110,82,28,30,35875,25.454545454545453
"Noxon CDP, Montana",122,103,19,30,54925,15.573770491803279
"Fromberg town, Montana",221,185,36,30,29575,16.289592760180994
"Red Lodge city, Montana",1648,1018,630,30,61525,38.228155339805824
"Elmo CDP, Montana",97,69,28,30,24100,28.865979381443296
"Kerr CDP, Montana",37,37,0,30,40355,0.0
"Ravalli CDP, Montana",30,30,0,30,61075,0.0
"Bainville town, Montana",133,109,24,30,03400,18.045112781954884
"Kremlin CDP, Montana",49,49,0,30,41725,0.0
"Missoula city, Montana",33320,31393,1927,30,50200,5.783313325330132
"Dillon city, Montana",2013,1761,252,30,20800,12.518628912071536
"Culbertson town, Montana",324,255,69,30,18475,21.296296296296298
"Winifred town, Montana",84,58,26,30,81025,30.952380952380953
"Helena Valley Northwest CDP, Montana",1470,1449,21,30,35631,1.4285714285714286
"Geraldine town, Montana",132,104,28,30,30400,21.21212121212121
"Parker School CDP, Montana",116,101,15,30,56650,12.931034482758621
"Neihart town, Montana",147,23,124,30,53200,84.35374149659864
"Dixon CDP, Montana",101,89,12,30,20950,11.881188118811881
"Simms CDP, Montana",146,128,18,30,68575,12.32876712328767
"Philipsburg town, Montana",388,260,128,30,57175,32.98969072164948
"Klein CDP, Montana",93,41,52,30,41050,55.91397849462365
"Lonepine CDP, Montana",88,74,14,30,44950,15.909090909090908
"Plains town, Montana",529,395,134,30,58150,25.330812854442343
"Thompson Falls city, Montana",554,485,69,30,73825,12.454873646209386
"Judith Gap city, Montana",59,43,16,30,40000,27.11864406779661
"Townsend city, Montana",966,852,114,30,74575,11.801242236024844
"Saco town, Montana",141,113,28,30,65050,19.858156028368796
"Hot Springs town, Montana",389,264,125,30,37825,32.13367609254499
"Niarada CDP, Montana",6,6,0,30,53725,0.0
"Wibaux town, Montana",329,268,61,30,80350,18.541033434650455
"Polson city, Montana",2563,2058,505,30,58750,19.703472493172065
"Rocky Point CDP, Montana",79,49,30,30,63940,37.9746835443038
"Rollins CDP, Montana",287,109,178,30,64075,62.02090592334495
"Riverbend CDP, Montana",149,122,27,30,63042,18.120805369127517
"St. Regis CDP, Montana",155,125,30,30,65575,19.35483870967742
"Garrison CDP, Montana",77,21,56,30,30175,72.72727272727273
"Helena Valley Southeast CDP, Montana",3045,3010,35,30,35634,1.1494252873563218
"Herron CDP, Montana",68,45,23,30,35912,33.82352941176471
"Inverness CDP, Montana",30,15,15,30,38725,50.0
"Rudyard CDP, Montana",110,73,37,30,64900,33.63636363636363
"Helena Valley West Central CDP, Montana",3295,3049,246,30,35637,7.465857359635812
"Columbia Falls city, Montana",2368,2289,79,30,16600,3.3361486486486487
"Lakeside CDP, Montana",1351,903,448,30,41950,33.160621761658035
"Reserve CDP, Montana",20,18,2,30,62125,10.0
"Richey town, Montana",130,87,43,30,62275,33.07692307692307
"Fort Belknap Agency CDP, Montana",486,394,92,30,27850,18.930041152263374
"Lodge Pole CDP, Montana",76,70,6,30,44350,7.894736842105263
"Joplin CDP, Montana",115,115,0,30,39775,0.0
"Cardwell CDP, Montana",29,25,4,30,12400,13.793103448275861
"Busby CDP, Montana",187,143,44,30,11200,23.52941176470588
"Muddy CDP, Montana",189,147,42,30,52315,22.22222222222222
"St. Xavier CDP, Montana",52,19,33,30,65650,63.46153846153846
"Absarokee CDP, Montana",557,393,164,30,00175,29.443447037701976
"Frazer CDP, Montana",162,123,39,30,29275,24.074074074074073
"Belt town, Montana",290,270,20,30,05275,6.896551724137931
"Boulder city, Montana",436,354,82,30,08575,18.807339449541285
"Rocky Boy's Agency CDP, Montana",162,120,42,30,63900,25.925925925925924
"Alzada CDP, Montana",21,14,7,30,01300,33.33333333333333
"Amsterdam CDP, Montana",65,55,10,30,01525,15.384615384615385
"Babb CDP, Montana",79,33,46,30,03250,58.22784810126582
"Batavia CDP, Montana",136,128,8,30,04230,5.88235294117647
"Bear Dance CDP, Montana",224,108,116,30,04410,51.78571428571429
"Belknap CDP, Montana",129,112,17,30,05050,13.178294573643413
"Biddle CDP, Montana",30,21,9,30,05650,30.0
"Boyd CDP, Montana",23,17,6,30,08800,26.08695652173913
"Brady CDP, Montana",88,54,34,30,09250,38.63636363636363
"Bridger CDP, Montana",25,25,0,30,09500,0.0
"Bynum CDP, Montana",25,18,7,30,11500,28.000000000000004
"Camas CDP, Montana",49,31,18,30,11800,36.734693877551024
"Carlton CDP, Montana",313,313,0,30,12435,0.0
"Charlos Heights CDP, Montana",90,53,37,30,13975,41.11111111111111
"Churchill CDP, Montana",377,356,21,30,14875,5.570291777188329
"Condon CDP, Montana",318,141,177,30,17050,55.660377358490564
"Conner CDP, Montana",56,42,14,30,17200,25.0
"Cooke City CDP, Montana",125,30,95,30,17350,76.0
"Dupuyer CDP, Montana",65,44,21,30,22450,32.30769230769231
"Corwin Springs CDP, Montana",87,43,44,30,17800,50.57471264367817
"Craig CDP, Montana",36,20,16,30,18025,44.44444444444444
"Crane CDP, Montana",64,64,0,30,18100,0.0
"East Helena city, Montana",863,811,52,30,23125,6.025492468134415
"Edgar CDP, Montana",57,57,0,30,23500,0.0
"Elkhorn CDP, Montana",20,0,20,30,23865,100.0
"Emigrant CDP, Montana",178,135,43,30,24325,24.15730337078652
"Forest Hill Village CDP, Montana",172,172,0,30,27595,0.0
"Gallatin Gateway CDP, Montana",447,366,81,30,29875,18.120805369127517
"Gallatin River Ranch CDP, Montana",50,45,5,30,29885,10.0
"Geyser CDP, Montana",66,56,10,30,30550,15.151515151515152
"Gibson Flats CDP, Montana",83,83,0,30,30625,0.0
"Happys Inn CDP, Montana",168,66,102,30,34110,60.71428571428571
"Hebgen Lake Estates CDP, Montana",97,55,42,30,35435,43.29896907216495
"Helena Flats CDP, Montana",405,372,33,30,35622,8.148148148148149
"Hinsdale CDP, Montana",230,180,50,30,36475,21.73913043478261
"Huson CDP, Montana",18,18,0,30,38275,0.0
"Indian Springs CDP, Montana",17,17,0,30,38480,0.0
"Jardine CDP, Montana",19,15,4,30,39175,21.052631578947366
"Kila CDP, Montana",151,142,9,30,40675,5.960264900662252
"King Arthur Park CDP, Montana",552,512,40,30,40685,7.246376811594203
"Lake Mary Ronan CDP, Montana",156,38,118,30,41910,75.64102564102564
"Lindisfarne CDP, Montana",425,98,327,30,43710,76.94117647058823
"Little Bitterroot Lake CDP, Montana",298,77,221,30,43830,74.16107382550335
"Little Browning CDP, Montana",65,47,18,30,43835,27.692307692307693
"Logan CDP, Montana",23,23,0,30,44500,0.0
"Marion CDP, Montana",454,304,150,30,47875,33.03964757709251
"Martinsdale CDP, Montana",62,13,49,30,48175,79.03225806451613
"Marysville CDP, Montana",54,41,13,30,48250,24.074074074074073
"Maxville CDP, Montana",117,91,26,30,48625,22.22222222222222
"Midvale CDP, Montana",163,163,0,30,49400,0.0
"Olney CDP, Montana",93,75,18,30,55450,19.35483870967742
"Piltzville CDP, Montana",205,205,0,30,57475,0.0
"Pioneer Junction CDP, Montana",582,414,168,30,57950,28.865979381443296
"Ponderosa Pines CDP, Montana",169,146,23,30,58840,13.609467455621301
"Pony CDP, Montana",88,47,41,30,58900,46.590909090909086
"Pray CDP, Montana",514,374,140,30,59725,27.237354085603112
"Rader Creek CDP, Montana",198,117,81,30,60450,40.909090909090914
"Roberts CDP, Montana",210,132,78,30,63400,37.142857142857146
"Rocky Boy West CDP, Montana",266,234,32,30,63928,12.030075187969924
"Roscoe CDP, Montana",16,10,6,30,64300,37.5
"Rosebud CDP, Montana",75,45,30,30,64375,40.0
"Roy CDP, Montana",66,62,4,30,64675,6.0606060606060606
"Sand Coulee CDP, Montana",126,108,18,30,65950,14.285714285714285
"Santa Rita CDP, Montana",98,98,0,30,66250,0.0
"Sedan CDP, Montana",90,59,31,30,67075,34.44444444444444
"Shawmut CDP, Montana",42,30,12,30,67225,28.57142857142857
"Silesia CDP, Montana",25,10,15,30,68050,60.0
"Silver Gate CDP, Montana",179,11,168,30,68425,93.85474860335195
"South Hills CDP, Montana",184,184,0,30,69725,0.0
"Spokane Creek CDP, Montana",156,156,0,30,69900,0.0
"Springdale CDP, Montana",19,19,0,30,70150,0.0
"Springhill CDP, Montana",75,53,22,30,70375,29.333333333333332
"Stockett CDP, Montana",101,82,19,30,71350,18.81188118811881
"Stryker CDP, Montana",22,12,10,30,71575,45.45454545454545
"Sula CDP, Montana",43,36,7,30,71800,16.27906976744186
"Swan Lake CDP, Montana",213,77,136,30,72850,63.84976525821596
"Trego CDP, Montana",328,247,81,30,74725,24.695121951219512
"Sweet Grass CDP, Montana",48,29,19,30,73075,39.58333333333333
"Sylvanite CDP, Montana",101,38,63,30,73165,62.37623762376238
"The Silos CDP, Montana",283,267,16,30,73760,5.6537102473498235
"Turah CDP, Montana",129,125,4,30,75175,3.10077519379845
"Turner CDP, Montana",39,34,5,30,75250,12.82051282051282
"Weeksville CDP, Montana",46,28,18,30,78775,39.130434782608695
"West Glacier CDP, Montana",300,76,224,30,79075,74.66666666666667
"West Kootenai CDP, Montana",141,50,91,30,79105,64.53900709219859
"Wheatland CDP, Montana",151,151,0,30,79695,0.0
"White Haven CDP, Montana",292,239,53,30,79935,18.15068493150685
"Whitewater CDP, Montana",57,40,17,30,80200,29.82456140350877
"Wineglass CDP, Montana",187,161,26,30,80975,13.903743315508022
"Yaak CDP, Montana",293,121,172,30,82130,58.703071672354945
"Zortman CDP, Montana",57,30,27,30,82675,47.368421052631575
"South Glastonbury CDP, Montana",239,159,80,30,69713,33.47280334728033
"Savage CDP, Montana",140,115,25,30,66550,17.857142857142858
"Kenesaw village, Nebraska",423,403,20,31,25160,4.7281323877068555
"Prosser village, Nebraska",30,23,7,31,40430,23.333333333333332
"Wauneta village, Nebraska",367,315,52,31,51700,14.168937329700274
"Memphis village, Nebraska",38,35,3,31,31640,7.894736842105263
"Yutan city, Nebraska",437,426,11,31,54115,2.517162471395881
"Deweese village, Nebraska",48,26,22,31,12945,45.83333333333333
"Glenvil village, Nebraska",145,127,18,31,19070,12.413793103448276
"Leshara village, Nebraska",47,47,0,31,26630,0.0
"Albion city, Nebraska",765,692,73,31,00555,9.542483660130719
"Arnold village, Nebraska",361,321,40,31,02095,11.080332409972298
"Newcastle village, Nebraska",190,148,42,31,34090,22.105263157894736
"Marquette village, Nebraska",106,106,0,31,30730,0.0
"Santee village, Nebraska",146,123,23,31,43475,15.753424657534246
"Prague village, Nebraska",156,139,17,31,39975,10.897435897435898
"Valparaiso village, Nebraska",289,265,24,31,50125,8.304498269896193
"Roseland village, Nebraska",103,89,14,31,42355,13.592233009708737
"Hadar village, Nebraska",97,94,3,31,20470,3.0927835051546393
"McLean village, Nebraska",19,15,4,31,30065,21.052631578947366
"Osmond city, Nebraska",430,398,32,31,37595,7.441860465116279
"Pierce city, Nebraska",824,764,60,31,39100,7.281553398058252
"Plainview city, Nebraska",708,625,83,31,39170,11.72316384180791
"Byron village, Nebraska",67,48,19,31,07555,28.35820895522388
"Hebron city, Nebraska",939,803,136,31,21905,14.48349307774228
"Minden city, Nebraska",1288,1184,104,31,32340,8.074534161490684
"Lexington city, Nebraska",3652,3439,213,31,26910,5.832420591456736
"Bennington city, Nebraska",787,719,68,31,04405,8.640406607369759
"Ralston city, Nebraska",3213,3121,92,31,40605,2.863367569249922
"Brady village, Nebraska",171,162,9,31,06085,5.263157894736842
"Maxwell village, Nebraska",119,102,17,31,31220,14.285714285714285
"Wood River city, Nebraska",579,515,64,31,53660,11.053540587219343
"Springview village, Nebraska",153,114,39,31,46625,25.49019607843137
"Burchard village, Nebraska",34,26,8,31,07065,23.52941176470588
"Lewiston village, Nebraska",40,31,9,31,26875,22.5
"Henry village, Nebraska",55,40,15,31,22150,27.27272727272727
"Denton village, Nebraska",102,97,5,31,12770,4.901960784313726
"Hickman city, Nebraska",743,722,21,31,22325,2.826379542395693
"Sprague village, Nebraska",52,52,0,31,46380,0.0
"Inman village, Nebraska",62,46,16,31,24075,25.806451612903224
"Clarkson city, Nebraska",372,310,62,31,09200,16.666666666666664
"Whitney village, Nebraska",54,48,6,31,52925,11.11111111111111
"Waterbury village, Nebraska",39,28,11,31,51630,28.205128205128204
"North Bend city, Nebraska",523,478,45,31,34720,8.604206500956023
"Omaha city, Nebraska",197869,183160,14709,31,37000,7.433706138910087
"Hay Springs village, Nebraska",326,263,63,31,21730,19.32515337423313
"Ulysses village, Nebraska",129,113,16,31,49460,12.4031007751938
"Clarks village, Nebraska",174,156,18,31,09165,10.344827586206897
"Merriman village, Nebraska",88,64,24,31,31815,27.27272727272727
"Kearney city, Nebraska",13721,13064,657,31,25055,4.788280737555572
"Miller village, Nebraska",93,79,14,31,32130,15.053763440860216
"Bushnell village, Nebraska",118,83,35,31,07415,29.66101694915254
"Lincoln city, Nebraska",118258,112124,6134,31,28000,5.186964095452316
"Abie village, Nebraska",44,30,14,31,00205,31.818181818181817
"Bellwood village, Nebraska",166,146,20,31,04020,12.048192771084338
"Brainard village, Nebraska",198,178,20,31,06120,10.1010101010101
"Dwight village, Nebraska",97,85,12,31,14065,12.371134020618557
"Garrison village, Nebraska",20,16,4,31,18300,20.0
"Linwood village, Nebraska",47,37,10,31,28245,21.27659574468085
"Palmer village, Nebraska",246,205,41,31,38160,16.666666666666664
"Silver Creek village, Nebraska",235,200,35,31,45400,14.893617021276595
"Cedar Rapids village, Nebraska",246,204,42,31,08220,17.073170731707318
"Oakland city, Nebraska",617,585,32,31,35490,5.186385737439222
"Imperial city, Nebraska",911,857,54,31,23690,5.92755214050494
"Lamar village, Nebraska",5,5,0,31,26175,0.0
"Ansley village, Nebraska",282,239,43,31,01535,15.24822695035461
"Merna village, Nebraska",200,170,30,31,31780,15.0
"Martinsburg village, Nebraska",61,50,11,31,30940,18.0327868852459
"Ainsworth city, Nebraska",1050,872,178,31,00415,16.952380952380953
"Johnstown village, Nebraska",51,34,17,31,24740,33.33333333333333
"Norman village, Nebraska",17,15,2,31,34650,11.76470588235294
"Clinton village, Nebraska",19,14,5,31,09655,26.31578947368421
"Gordon city, Nebraska",899,792,107,31,19350,11.902113459399333
"Ruskin village, Nebraska",78,43,35,31,42810,44.871794871794876
"Superior city, Nebraska",1092,888,204,31,47815,18.681318681318682
"Benkelman city, Nebraska",605,453,152,31,04230,25.123966942148762
"Haigler village, Nebraska",121,101,20,31,20540,16.528925619834713
"Firth village, Nebraska",187,171,16,31,16935,8.55614973262032
"Rising City village, Nebraska",160,154,6,31,41480,3.75
"Moorefield village, Nebraska",16,5,11,31,32760,68.75
"Odell village, Nebraska",152,142,10,31,35735,6.578947368421052
"Dalton village, Nebraska",165,136,29,31,12070,17.575757575757574
"Cushing village, Nebraska",25,22,3,31,11860,12.0
"Farwell village, Nebraska",57,52,5,31,16760,8.771929824561402
"Osceola city, Nebraska",431,369,62,31,37525,14.385150812064964
"Stromsburg city, Nebraska",545,464,81,31,47465,14.862385321100918
"Waco village, Nebraska",153,153,0,31,50895,0.0
"Kimball city, Nebraska",1342,1144,198,31,25475,14.754098360655737
"Dunning village, Nebraska",67,53,14,31,13960,20.8955223880597
"Clatonia village, Nebraska",157,139,18,31,09270,11.464968152866243
"Du Bois village, Nebraska",58,47,11,31,13750,18.96551724137931
"Hamlet village, Nebraska",52,44,8,31,20750,15.384615384615385
"Bridgeport city, Nebraska",789,672,117,31,06295,14.82889733840304
"Emerson village, Nebraska",381,348,33,31,15710,8.661417322834646
"Table Rock village, Nebraska",191,159,32,31,48270,16.75392670157068
"Gering city, Nebraska",3369,3119,250,31,18580,7.420599584446423
"Lisco CDP, Nebraska",43,24,19,31,28315,44.18604651162791
"Terrytown city, Nebraska",517,461,56,31,48585,10.831721470019342
"Louisville city, Nebraska",508,458,50,31,29260,9.84251968503937
"Belmar CDP, Nebraska",529,52,477,31,04055,90.17013232514176
"Ames CDP, Nebraska",26,26,0,31,01220,0.0
"Archer CDP, Nebraska",16,16,0,31,01920,0.0
"Aten CDP, Nebraska",25,9,16,31,02480,64.0
"Berea CDP, Nebraska",34,10,24,31,04545,70.58823529411765
"Bow Valley CDP, Nebraska",59,50,9,31,05980,15.254237288135593
"Brownlee CDP, Nebraska",13,2,11,31,06680,84.61538461538461
"Champion CDP, Nebraska",25,25,0,31,08745,0.0
"Enders CDP, Nebraska",19,8,11,31,15885,57.89473684210527
"Fontanelle CDP, Nebraska",10,10,0,31,17040,0.0
"Glenwood CDP, Nebraska",158,158,0,31,19160,0.0
"Holmesville CDP, Nebraska",27,10,17,31,22780,62.96296296296296
"Inavale CDP, Nebraska",55,32,23,31,23725,41.81818181818181
"Keystone CDP, Nebraska",20,20,0,31,25335,0.0
"King Lake CDP, Nebraska",105,105,0,31,25510,0.0
"Lakeview CDP, Nebraska",130,130,0,31,26150,0.0
"La Platte CDP, Nebraska",58,58,0,31,26315,0.0
"Lemoyne CDP, Nebraska",235,38,197,31,26595,83.82978723404256
"Lindy CDP, Nebraska",16,12,4,31,28140,25.0
"Lorenzo CDP, Nebraska",19,6,13,31,29120,68.42105263157895
"Loretto CDP, Nebraska",29,29,0,31,29155,0.0
"Martin CDP, Nebraska",114,11,103,31,30905,90.35087719298247
"Max CDP, Nebraska",44,44,0,31,31150,0.0
"Odessa CDP, Nebraska",41,41,0,31,35770,0.0
"Overland CDP, Nebraska",145,55,90,31,37735,62.06896551724138
"Parks CDP, Nebraska",8,8,0,31,38365,0.0
"Poole CDP, Nebraska",10,10,0,31,39835,0.0
"Raeville CDP, Nebraska",0,0,0,31,40535,
"Richfield CDP, Nebraska",35,35,0,31,41340,0.0
"Roscoe CDP, Nebraska",15,15,0,31,42285,0.0
"St. Libory CDP, Nebraska",93,86,7,31,43160,7.526881720430108
"Sarben CDP, Nebraska",35,35,0,31,43650,0.0
"Sunol CDP, Nebraska",37,37,0,31,47745,0.0
"Tamora CDP, Nebraska",21,21,0,31,48340,0.0
"Tryon CDP, Nebraska",85,62,23,31,49320,27.058823529411764
"Venice CDP, Nebraska",88,57,31,31,50265,35.22727272727273
"Walton CDP, Nebraska",65,65,0,31,51280,0.0
"Wann CDP, Nebraska",17,17,0,31,51350,0.0
"Westerville CDP, Nebraska",0,0,0,31,52330,
"White Clay CDP, Nebraska",0,0,0,31,52855,
"Willow Island CDP, Nebraska",3,3,0,31,53205,0.0
"Woodland Hills CDP, Nebraska",69,69,0,31,53575,0.0
"Woodland Park CDP, Nebraska",697,652,45,31,53580,6.456241032998565
"Yankee Hill CDP, Nebraska",107,107,0,31,54020,0.0
"Seneca CDP, Nebraska",42,29,13,31,44385,30.952380952380953
"Inland CDP, Nebraska",7,7,0,31,24005,0.0
"Cedar Creek village, Nebraska",349,195,154,31,08185,44.126074498567334
"Murdock village, Nebraska",115,102,13,31,33320,11.304347826086957
"Diller village, Nebraska",146,124,22,31,13085,15.068493150684931
"Harbine village, Nebraska",40,31,9,31,20960,22.5
"Plymouth village, Nebraska",240,198,42,31,39590,17.5
"Steele City village, Nebraska",68,34,34,31,47010,50.0
"Bellevue city, Nebraska",21653,20466,1187,31,03950,5.481919364522237
"Madrid village, Nebraska",124,100,24,31,30275,19.35483870967742
"Obert village, Nebraska",15,9,6,31,35560,40.0
"St. Helena village, Nebraska",35,30,5,31,43090,14.285714285714285
"Wynot village, Nebraska",110,88,22,31,53905,20.0
"Campbell village, Nebraska",172,143,29,31,07870,16.86046511627907
"Valentine city, Nebraska",1475,1312,163,31,49950,11.05084745762712
"Humphrey city, Nebraska",403,389,14,31,23480,3.4739454094292808
"Platte Center village, Nebraska",183,170,13,31,39310,7.103825136612022
"Shubert village, Nebraska",128,92,36,31,45225,28.125
"Holdrege city, Nebraska",2615,2464,151,31,22640,5.774378585086042
"Chester village, Nebraska",140,118,22,31,09095,15.714285714285714
"Davenport village, Nebraska",174,143,31,31,12245,17.81609195402299
"Hubbell village, Nebraska",48,33,15,31,23410,31.25
"Ayr village, Nebraska",38,38,0,31,02865,0.0
"Wellfleet village, Nebraska",25,22,3,31,52085,12.0
"Pilger village, Nebraska",166,152,14,31,39135,8.433734939759036
"Hoskins village, Nebraska",132,116,16,31,23235,12.121212121212121
"Wakefield city, Nebraska",559,524,35,31,51070,6.261180679785331
"Milligan village, Nebraska",188,150,38,31,32200,20.212765957446805
"Emmet village, Nebraska",27,20,7,31,15815,25.925925925925924
"Ewing village, Nebraska",218,188,30,31,16270,13.761467889908257
"Elm Creek village, Nebraska",470,444,26,31,15360,5.531914893617021
"Pleasanton village, Nebraska",137,134,3,31,39450,2.18978102189781
"Riverdale village, Nebraska",97,97,0,31,41515,0.0
"Eddyville village, Nebraska",45,39,6,31,14380,13.333333333333334
"Auburn city, Nebraska",1737,1418,319,31,02655,18.364997121473806
"Brownville village, Nebraska",123,59,64,31,06750,52.03252032520326
"Arthur village, Nebraska",98,69,29,31,02200,29.591836734693878
"Carroll village, Nebraska",114,92,22,31,08010,19.298245614035086
"Wayne city, Nebraska",2236,2111,125,31,51840,5.590339892665474
"Beaver City city, Nebraska",378,258,120,31,03495,31.746031746031743
"Malmo village, Nebraska",77,63,14,31,30380,18.181818181818183
"Harvard city, Nebraska",489,434,55,31,21345,11.247443762781186
"Lewellen village, Nebraska",198,96,102,31,26805,51.515151515151516
"Oshkosh city, Nebraska",449,383,66,31,37560,14.699331848552339
"Edison village, Nebraska",98,83,15,31,14520,15.306122448979592
"Holbrook village, Nebraska",143,101,42,31,22605,29.37062937062937
"Bayard city, Nebraska",554,429,125,31,03285,22.563176895306857
"Rosalie village, Nebraska",80,66,14,31,42250,17.5
"Boys Town village, Nebraska",25,11,14,31,06015,56.00000000000001
"Wallace village, Nebraska",129,117,12,31,51175,9.30232558139535
"Clearwater village, Nebraska",158,142,16,31,09445,10.126582278481013
"Elgin city, Nebraska",412,343,69,31,14730,16.74757281553398
"Oakdale village, Nebraska",182,155,27,31,35385,14.835164835164836
"Orchard village, Nebraska",251,202,49,31,37210,19.52191235059761
"Royal village, Nebraska",59,45,14,31,42495,23.728813559322035
"Columbus city, Nebraska",9682,9256,426,31,10110,4.39991737244371
"Thedford village, Nebraska",133,94,39,31,48760,29.32330827067669
"Harrisburg CDP, Nebraska",39,31,8,31,21030,20.51282051282051
"Tarnov village, Nebraska",15,11,4,31,48410,26.666666666666668
"Indianola city, Nebraska",280,236,44,31,23830,15.714285714285714
"Dawson village, Nebraska",114,88,26,31,12420,22.807017543859647
"Nenzel village, Nebraska",14,14,0,31,33985,0.0
"Monowi village, Nebraska",5,0,5,31,32550,100.0
"Hartington city, Nebraska",850,728,122,31,21275,14.352941176470587
"Laurel city, Nebraska",514,438,76,31,26350,14.785992217898833
"Cornlea village, Nebraska",10,7,3,31,10600,30.0
"Bartley village, Nebraska",165,136,29,31,03180,17.575757575757574
"Danbury village, Nebraska",75,43,32,31,12105,42.66666666666667
"Blackburn city, Missouri",146,130,16,29,05950,10.95890410958904
"Marshall city, Missouri",5200,4598,602,29,46316,11.576923076923077
"Slater city, Missouri",1109,886,223,29,68204,20.108205590622184
"Gallatin city, Missouri",892,716,176,29,26308,19.730941704035875
"Fountain N' Lakes village, Missouri",70,66,4,29,25411,5.714285714285714
"Holden city, Missouri",1110,943,167,29,32572,15.045045045045043
"Bull Creek village, Missouri",253,190,63,29,09642,24.90118577075099
"Arcadia city, Missouri",358,324,34,29,01648,9.497206703910614
"Jamesport city, Missouri",288,219,69,29,36332,23.958333333333336
"Chaffee city, Missouri",1306,1129,177,29,12988,13.552833078101074
"Haywood City village, Missouri",87,63,24,29,31204,27.586206896551722
"Miner city, Missouri",457,416,41,29,48656,8.971553610503284
"Archie city, Missouri",550,487,63,29,01702,11.454545454545455
"Belton city, Missouri",9611,8896,715,29,04384,7.4393923629174905
"Lake Winnebago city, Missouri",526,489,37,29,40340,7.0342205323193925
"Peculiar city, Missouri",2142,2017,125,29,56756,5.835667600373482
"Desloge city, Missouri",2598,2235,363,29,19216,13.97228637413395
"Leadington city, Missouri",298,253,45,29,41024,15.100671140939598
"Park Hills city, Missouri",3764,3372,392,29,56272,10.414452709883102
"Armstrong city, Missouri",151,103,48,29,01954,31.788079470198678
"Novinger city, Missouri",237,153,84,29,53534,35.44303797468354
"Green Ridge city, Missouri",184,170,14,29,29332,7.608695652173914
"Houstonia city, Missouri",78,61,17,29,33256,21.794871794871796
"Bogard city, Missouri",82,70,12,29,06832,14.634146341463413
"Hale city, Missouri",199,168,31,29,29908,15.577889447236181
"Farmington city, Missouri",7070,6433,637,29,23752,9.009900990099009
"Glen Allen town, Missouri",48,37,11,29,27280,22.916666666666664
"Cooter city, Missouri",189,171,18,29,16336,9.523809523809524
"Graham town, Missouri",95,72,23,29,28072,24.210526315789473
"Hopkins city, Missouri",216,162,54,29,33004,25.0
"Maryville city, Missouri",5030,4335,695,29,46640,13.817097415506957
"Callao city, Missouri",166,113,53,29,10486,31.92771084337349
"Billings city, Missouri",492,426,66,29,05626,13.414634146341465
"Wooldridge village, Missouri",23,13,10,29,81016,43.47826086956522
"Westwood village, Missouri",125,125,0,29,79054,0.0
"Allenville village, Missouri",54,46,8,29,00748,14.814814814814813
"Whitewater town, Missouri",48,44,4,29,79612,8.333333333333332
"Jameson town, Missouri",35,34,1,29,36314,2.857142857142857
"Urich city, Missouri",319,272,47,29,75346,14.733542319749215
"Raymondville town, Missouri",195,169,26,29,60734,13.333333333333334
"Washburn city, Missouri",232,201,31,29,77200,13.36206896551724
"La Due village, Missouri",34,14,20,29,39638,58.82352941176471
"Martinsburg town, Missouri",176,135,41,29,46460,23.295454545454543
"Savannah city, Missouri",2214,2047,167,29,66044,7.542908762420958
"Calhoun city, Missouri",173,151,22,29,10450,12.716763005780345
"Clinton city, Missouri",4460,3877,583,29,14986,13.071748878923767
"St. Louis city, Missouri",176375,140455,35920,29,65000,20.365698086463503
"Wellington city, Missouri",392,324,68,29,78352,17.346938775510203
"Purdin city, Missouri",85,51,34,29,60158,40.0
"Granby city, Missouri",968,840,128,29,28108,13.223140495867769
"Ritchey town, Missouri",39,27,12,29,62030,30.76923076923077
"Versailles city, Missouri",1196,1023,173,29,75922,14.464882943143811
"Cape Girardeau city, Missouri",17746,15072,2674,29,11242,15.068184379578497
"Hayti city, Missouri",1425,1149,276,29,31132,19.36842105263158
"Pascola village, Missouri",43,35,8,29,56432,18.6046511627907
"Amsterdam city, Missouri",120,101,19,29,01090,15.833333333333332
"Foster village, Missouri",107,89,18,29,25372,16.822429906542055
"Merwin village, Missouri",25,23,2,29,47540,8.0
"Gilman City city, Missouri",208,168,40,29,27064,19.230769230769234
"Jacksonville village, Missouri",51,32,19,29,36224,37.254901960784316
"New Melle city, Missouri",182,172,10,29,52148,5.4945054945054945
"St. Thomas town, Missouri",93,89,4,29,65162,4.301075268817205
"Wardsville village, Missouri",645,631,14,29,77002,2.1705426356589146
"Lake St. Louis city, Missouri",6559,6032,527,29,40043,8.034761396554353
"Houston city, Missouri",1256,998,258,29,33238,20.541401273885352
"Bonne Terre city, Missouri",1730,1671,59,29,07102,3.410404624277456
"Gibbs village, Missouri",57,31,26,29,26920,45.614035087719294
"Millard village, Missouri",30,26,4,29,48134,13.333333333333334
"Kirksville city, Missouri",7696,6514,1182,29,39026,15.358627858627857
"River Bend village, Missouri",2,2,0,29,62056,0.0
"Corning town, Missouri",3,3,0,29,16462,0.0
"Maitland city, Missouri",161,137,24,29,45596,14.906832298136646
"Keytesville city, Missouri",242,171,71,29,38468,29.338842975206614
"Parkway village, Missouri",215,215,0,29,56306,0.0
"Elsberry city, Missouri",967,776,191,29,22114,19.751809720785936
"Moscow Mills city, Missouri",1007,877,130,29,50204,12.909632571996028
"Truxton village, Missouri",54,41,13,29,74014,24.074074074074073
"New Madrid city, Missouri",1509,1248,261,29,52076,17.296222664015904
"Agency village, Missouri",294,266,28,29,00298,9.523809523809524
"Brimson village, Missouri",30,24,6,29,08470,20.0
"Trimble city, Missouri",297,273,24,29,73852,8.080808080808081
"Tindall town, Missouri",43,35,8,29,73348,18.6046511627907
"Avondale city, Missouri",278,229,49,29,02800,17.62589928057554
"Montgomery City city, Missouri",1376,1180,196,29,49574,14.244186046511627
"Breckenridge Hills city, Missouri",2171,1878,293,29,08164,13.496084753569784
"Pasadena Hills city, Missouri",503,451,52,29,56396,10.337972166998012
"Theodosia village, Missouri",226,100,126,29,72898,55.75221238938053
"Moline Acres city, Missouri",1080,865,215,29,49088,19.90740740740741
"Northwoods city, Missouri",2070,1817,253,29,53408,12.222222222222221
"Twin Oaks village, Missouri",170,162,8,29,74284,4.705882352941177
"Grand Pass village, Missouri",39,23,16,29,28198,41.02564102564102
"Mexico city, Missouri",5177,4533,644,29,47648,12.439636855321615
"Edina city, Missouri",697,496,201,29,21322,28.83787661406026
"New Florence city, Missouri",335,293,42,29,51770,12.53731343283582
"Gunn City village, Missouri",52,43,9,29,29764,17.307692307692307
"North Lilbourn village, Missouri",6,3,3,29,53138,50.0
"Lebanon city, Missouri",6711,6005,706,29,41168,10.520041722545075
"Essex city, Missouri",246,210,36,29,22600,14.634146341463413
"Sedalia city, Missouri",10224,8720,1504,29,66440,14.710485133020345
"Lake Tapawingo city, Missouri",419,365,54,29,40196,12.887828162291171
"Drexel city, Missouri",427,381,46,29,20134,10.772833723653395
"Lee's Summit city, Missouri",38073,36134,1939,29,41348,5.092847949990807
"West Alton city, Missouri",227,181,46,29,78514,20.26431718061674
"Eminence city, Missouri",347,274,73,29,22276,21.037463976945244
"Doolittle city, Missouri",334,315,19,29,19828,5.688622754491018
"Overland city, Missouri",6981,6473,508,29,55550,7.276894427732417
"Cliff Village village, Missouri",16,14,2,29,14806,12.5
"Rhineland town, Missouri",64,59,5,29,61328,7.8125
"Dadeville village, Missouri",118,97,21,29,17992,17.796610169491526
"Arbyrd city, Missouri",245,180,65,29,01630,26.53061224489796
"Osborn city, Missouri",236,195,41,29,55352,17.372881355932204
"Bell City city, Missouri",211,175,36,29,04132,17.061611374407583
"Appleton City city, Missouri",690,516,174,29,01522,25.217391304347824
"New London city, Missouri",384,333,51,29,52058,13.28125
"Weaubleau city, Missouri",277,204,73,29,78064,26.353790613718413
"Old Monroe city, Missouri",121,100,21,29,54416,17.355371900826448
"Mountain View city, Missouri",1284,1120,164,29,50438,12.77258566978193
"La Plata city, Missouri",736,531,205,29,40682,27.853260869565215
"Morrison city, Missouri",56,51,5,29,50060,8.928571428571429
"Washington city, Missouri",6048,5810,238,29,77416,3.935185185185185
"St. Cloud village, Missouri",23,17,6,29,64172,26.08695652173913
"Berger city, Missouri",97,76,21,29,04888,21.649484536082475
"Clarkson Valley city, Missouri",936,936,0,29,14176,0.0
"Independence city, Missouri",53841,48166,5675,29,35000,10.5402945710518
"Horine CDP, Missouri",368,368,0,29,33040,0.0
"Hoberg village, Missouri",30,22,8,29,32410,26.666666666666668
"Green Park city, Missouri",1043,1001,42,29,29324,4.026845637583892
"Rolla city, Missouri",8968,7784,1184,29,62912,13.202497769848351
"Webb City city, Missouri",4746,4485,261,29,78118,5.499367888748419
"Smithton city, Missouri",220,188,32,29,68384,14.545454545454545
"Asbury city, Missouri",117,110,7,29,02098,5.982905982905983
"Homestown city, Missouri",65,45,20,29,32824,30.76923076923077
"Dearborn city, Missouri",247,210,37,29,18658,14.979757085020243
"Amazonia village, Missouri",141,125,16,29,01018,11.347517730496454
"Mokane city, Missouri",80,66,14,29,49070,17.5
"West Line village, Missouri",46,46,0,29,78838,0.0
"Monticello village, Missouri",67,54,13,29,49592,19.402985074626866
"Seymour city, Missouri",976,855,121,29,66800,12.397540983606557
"Alton city, Missouri",371,282,89,29,00964,23.98921832884097
"Kingston city, Missouri",132,90,42,29,38846,31.818181818181817
"Mineral Point town, Missouri",150,124,26,29,48710,17.333333333333336
"Willow Springs city, Missouri",992,844,148,29,80098,14.919354838709678
"Belle city, Missouri",840,703,137,29,04150,16.30952380952381
"Maysville city, Missouri",589,476,113,29,46946,19.185059422750424
"Portageville city, Missouri",1351,1265,86,29,59186,6.365655070318282
"Galena city, Missouri",280,201,79,29,26254,28.214285714285715
"Pattonsburg city, Missouri",82,63,19,29,56558,23.170731707317074
"Mosby city, Missouri",103,66,37,29,50168,35.92233009708738
"Branson West city, Missouri",240,210,30,29,07989,12.5
"Marthasville city, Missouri",497,433,64,29,46424,12.877263581488934
"Nevada city, Missouri",4274,3573,701,29,51644,16.40149742629855
"Williamsville city, Missouri",199,162,37,29,80026,18.592964824120603
"Ravenwood town, Missouri",219,183,36,29,60716,16.43835616438356
"Centralia city, Missouri",1955,1859,96,29,12898,4.910485933503836
"Seneca city, Missouri",1019,937,82,29,66674,8.04710500490677
"Freeburg village, Missouri",219,190,29,29,25822,13.24200913242009
"Alma city, Missouri",193,170,23,29,00802,11.917098445595855
"Fort Leonard Wood CDP, Missouri",2529,2101,428,29,25264,16.923685251087388
"Jasper city, Missouri",466,394,72,29,36512,15.450643776824036
"Rosebud city, Missouri",245,209,36,29,63110,14.69387755102041
"Goss town, Missouri",0,0,0,29,28000,
"Kirbyville village, Missouri",96,78,18,29,39008,18.75
"Pendleton village, Missouri",14,12,2,29,56882,14.285714285714285
"Plato village, Missouri",51,34,17,29,58088,33.33333333333333
"Stoutland city, Missouri",104,68,36,29,71008,34.61538461538461
"Allendale village, Missouri",59,29,30,29,00712,50.847457627118644
"Preston village, Missouri",138,120,18,29,59870,13.043478260869565
"Riverview Estates village, Missouri",31,31,0,29,62210,0.0
"Dardenne Prairie city, Missouri",4422,4345,77,29,18253,1.7412935323383085
"Evergreen village, Missouri",9,6,3,29,22951,33.33333333333333
"Goodnight village, Missouri",12,7,5,29,27900,41.66666666666667
"South Greenfield village, Missouri",65,61,4,29,68888,6.153846153846154
"Hannibal city, Missouri",7931,7023,908,29,30214,11.448745429327953
"Fair Play city, Missouri",228,161,67,29,23428,29.385964912280706
"Perry city, Missouri",454,331,123,29,57080,27.09251101321586
"Clark city, Missouri",124,102,22,29,14068,17.741935483870968
"Whiteman AFB CDP, Missouri",923,901,22,29,79432,2.38353196099675
"Hughesville village, Missouri",74,62,12,29,33652,16.216216216216218
"Glasgow city, Missouri",556,436,120,29,27208,21.58273381294964
"Hurdland city, Missouri",103,66,37,29,33904,35.92233009708738
"Conway city, Missouri",303,255,48,29,16192,15.841584158415841
"Amity town, Missouri",35,19,16,29,01054,45.714285714285715
"Clarksdale city, Missouri",143,128,15,29,14158,10.48951048951049
"Union Star town, Missouri",222,173,49,29,75130,22.07207207207207
"Blue Springs city, Missouri",20591,19556,1035,29,06652,5.0264678743140205
"Albany city, Missouri",968,867,101,29,00514,10.433884297520661
"Commerce village, Missouri",43,28,15,29,15760,34.883720930232556
"Scott City city, Missouri",1722,1564,158,29,66368,9.175377468060395
"Sikeston city, Missouri",7731,6871,860,29,67790,11.124046048376664
"Baldwin Park village, Missouri",53,44,9,29,03124,16.9811320754717
"Harrisonville city, Missouri",3940,3826,114,29,30610,2.8934010152284264
"Raymore city, Missouri",8239,8091,148,29,60752,1.7963345066148804
"Crystal City city, Missouri",2065,1921,144,29,17632,6.973365617433414
"Koshkonong town, Missouri",108,77,31,29,39440,28.703703703703702
"Herculaneum city, Missouri",1585,1436,149,29,31708,9.400630914826499
"Exeter city, Missouri",355,312,43,29,23122,12.112676056338028
"Westphalia city, Missouri",200,186,14,29,78910,7.000000000000001
"Lambert village, Missouri",0,0,0,29,40448,
"Oran city, Missouri",656,604,52,29,54758,7.926829268292683
"Bertrand city, Missouri",371,365,6,29,04996,1.6172506738544474
"Ste. Genevieve city, Missouri",2023,1924,99,29,64180,4.893722194760257
"Truesdale city, Missouri",309,269,40,29,73978,12.944983818770226
"Shelbyville city, Missouri",280,229,51,29,67196,18.21428571428571
"Wilson City village, Missouri",52,31,21,29,80260,40.38461538461539
"Bellefontaine Neighbors city, Missouri",4267,3972,295,29,04222,6.913522381063979
"Lakeshire city, Missouri",872,789,83,29,40088,9.51834862385321
"Manchester city, Missouri",7455,7180,275,29,45668,3.688799463447351
"Chula city, Missouri",102,89,13,29,13852,12.745098039215685
"Mount Vernon city, Missouri",2091,1896,195,29,50672,9.32568149210904
"Bella Villa city, Missouri",383,357,26,29,04114,6.7885117493472595
"Beverly Hills city, Missouri",278,232,46,29,05248,16.546762589928058
"Black Jack city, Missouri",2708,2543,165,29,06004,6.0930576070901035
"Ellisville city, Missouri",4100,3827,273,29,21898,6.658536585365854
"Glen Echo Park village, Missouri",60,51,9,29,27370,15.0
"Grantwood Village town, Missouri",387,381,6,29,28630,1.550387596899225
"Hillsdale village, Missouri",647,437,210,29,32266,32.45749613601237
"Ladue city, Missouri",3445,3276,169,29,39656,4.905660377358491
"Lemay CDP, Missouri",7530,6932,598,29,41438,7.941567065073041
"Mehlville CDP, Missouri",13939,13077,862,29,47180,6.184087811177273
"Town and Country city, Missouri",4191,4080,111,29,73618,2.6485325697924123
"Wilbur Park village, Missouri",256,249,7,29,79756,2.734375
"Camden city, Missouri",131,118,13,29,10738,9.923664122137405
"Henrietta city, Missouri",153,114,39,29,31654,25.49019607843137
"Florida village, Missouri",33,0,33,29,24760,100.0
"Ballwin city, Missouri",12434,11903,531,29,03160,4.270548496059193
"Berkeley city, Missouri",4266,3602,664,29,04906,15.564932020628222
"Bridgeton city, Missouri",4840,4328,512,29,08398,10.578512396694215
"Des Peres city, Missouri",3127,2954,173,29,19270,5.532459226095298
"Edmundson city, Missouri",391,341,50,29,21376,12.787723785166241
"Fenton city, Missouri",1671,1638,33,29,23950,1.9748653500897666
"Maryland Heights city, Missouri",12306,11787,519,29,46586,4.2174549000487564
"Frontenac city, Missouri",1493,1368,125,29,26110,8.372404554588078
"Oakland city, Missouri",576,546,30,29,53750,5.208333333333334
"Jennings city, Missouri",7823,6388,1435,29,37178,18.343346542247218
"Normandy city, Missouri",3017,2370,647,29,52796,21.445144182963208
"Olivette city, Missouri",3150,2882,268,29,54650,8.507936507936508
"Pasadena Park village, Missouri",262,231,31,29,56414,11.83206106870229
"Richmond Heights city, Missouri",4345,4056,289,29,61706,6.6513233601841195
"Riverview village, Missouri",1627,1196,431,29,62192,26.490473263675472
"Webster Groves city, Missouri",9313,8792,521,29,78154,5.594330505744658
"Greenville city, Missouri",243,203,40,29,29476,16.46090534979424
"Fredericktown city, Missouri",1993,1700,293,29,25768,14.701455092824887
"Old Appleton town, Missouri",23,19,4,29,54200,17.391304347826086
"Dalton town, Missouri",19,2,17,29,18118,89.47368421052632
"Leslie village, Missouri",45,39,6,29,41690,13.333333333333334
"Villa Ridge CDP, Missouri",1102,1102,0,29,76192,0.0
"Cave town, Missouri",11,3,8,29,12079,72.72727272727273
"Lilbourn city, Missouri",570,478,92,29,42536,16.140350877192983
"Matthews city, Missouri",296,289,7,29,46730,2.364864864864865
"Tallapoosa city, Missouri",62,45,17,29,72196,27.419354838709676
"Brownington town, Missouri",70,52,18,29,08902,25.71428571428571
"Montrose city, Missouri",194,150,44,29,49664,22.68041237113402
"Pilot Grove city, Missouri",292,267,25,29,57602,8.561643835616438
"Saginaw village, Missouri",206,190,16,29,63902,7.766990291262135
"Richland city, Missouri",903,675,228,29,61562,25.249169435215947
"Waynesville city, Missouri",2499,1898,601,29,77992,24.049619847939173
"Affton CDP, Missouri",9158,8877,281,29,00280,3.0683555361432626
"Jerico Springs village, Missouri",107,98,9,29,37214,8.411214953271028
"Holcomb city, Missouri",290,240,50,29,32536,17.24137931034483
"Aurora city, Missouri",3566,3120,446,29,02548,12.507010656197421
"Country Life Acres village, Missouri",37,33,4,29,16876,10.81081081081081
"Creve Coeur city, Missouri",8541,8140,401,29,17272,4.695000585411544
"Glendale city, Missouri",2285,2239,46,29,27334,2.013129102844639
"Monett city, Missouri",3646,3042,604,29,49196,16.566099835436095
"Stotts City city, Missouri",70,43,27,29,70990,38.57142857142858
"Wheeling city, Missouri",122,116,6,29,79180,4.918032786885246
"Wildwood city, Missouri",12660,12233,427,29,79820,3.3728278041074247
"Winchester city, Missouri",618,584,34,29,80314,5.501618122977346
"Bagnell town, Missouri",53,24,29,29,02962,54.71698113207547
"Eldon city, Missouri",2180,2012,168,29,21484,7.706422018348624
"St. Elizabeth village, Missouri",131,113,18,29,64190,13.740458015267176
"Hardin city, Missouri",276,222,54,29,30322,19.565217391304348
"Freistatt village, Missouri",103,94,9,29,25912,8.737864077669903
"Marionville city, Missouri",1008,841,167,29,46172,16.567460317460316
"Pierce City city, Missouri",628,512,116,29,57494,18.471337579617835
"Verona town, Missouri",234,191,43,29,75886,18.37606837606838
"De Witt city, Missouri",49,44,5,29,19378,10.204081632653061
"Knox City city, Missouri",121,94,27,29,39278,22.31404958677686
"Phillipsburg village, Missouri",93,73,20,29,57368,21.50537634408602
"La Monte city, Missouri",551,467,84,29,40520,15.245009074410163
"Buckner city, Missouri",1311,1177,134,29,09424,10.221205186880244
"Grandview city, Missouri",10941,9823,1118,29,28324,10.218444383511562
"Greenwood city, Missouri",2128,2099,29,29,29494,1.362781954887218
"Lone Jack city, Missouri",443,436,7,29,43760,1.580135440180587
"Raytown city, Missouri",13276,12076,1200,29,60788,9.038867128653209
"New Hampton city, Missouri",158,112,46,29,51860,29.11392405063291
"Cottleville city, Missouri",1911,1763,148,29,16678,7.744636316064887
"Clifton Hill city, Missouri",36,23,13,29,14896,36.11111111111111
"O'Fallon city, Missouri",31798,30766,1032,29,54074,3.245487137555821
"Cabool city, Missouri",1143,929,214,29,10288,18.722659667541556
"Madison city, Missouri",337,246,91,29,45470,27.002967359050444
"Higbee city, Missouri",332,220,112,29,31924,33.734939759036145
"Kelso village, Missouri",258,230,28,29,38216,10.852713178294573
"Cleveland city, Missouri",257,251,6,29,14770,2.3346303501945527
"Freeman city, Missouri",218,195,23,29,25894,10.550458715596331
"Barnhart CDP, Missouri",2217,2187,30,29,03394,1.3531799729364005
"Cedar Hill CDP, Missouri",777,715,62,29,12358,7.979407979407979
"High Ridge CDP, Missouri",1730,1680,50,29,32140,2.8901734104046244
"Licking city, Missouri",821,704,117,29,42464,14.250913520097441
"Middletown town, Missouri",129,103,26,29,47900,20.155038759689923
"Forest City city, Missouri",149,118,31,29,25066,20.80536912751678
"Branson city, Missouri",8688,5026,3662,29,07966,42.15009208103131
"Lake Mykee Town village, Missouri",161,154,7,29,39990,4.3478260869565215
"Wheatland city, Missouri",260,172,88,29,79090,33.84615384615385
"Mound City city, Missouri",659,525,134,29,50312,20.333839150227618
"Strasburg city, Missouri",68,50,18,29,71098,26.47058823529412
"Sappington CDP, Missouri",3779,3390,389,29,65954,10.29372849960307
"Vinita Park city, Missouri",947,805,142,29,76246,14.994720168954592
"Lake Annette city, Missouri",83,65,18,29,39845,21.686746987951807
"Ava city, Missouri",1375,1168,207,29,02674,15.054545454545455
"Cedar Hill Lakes village, Missouri",141,123,18,29,12376,12.76595744680851
"Olympian Village city, Missouri",256,219,37,29,54686,14.453125
"Pevely city, Missouri",2440,2273,167,29,57278,6.8442622950819665
"Baring city, Missouri",81,47,34,29,03322,41.9753086419753
"Levasy city, Missouri",47,35,12,29,41762,25.53191489361702
"Turney village, Missouri",104,83,21,29,74176,20.192307692307693
"Fillmore city, Missouri",87,82,5,29,24184,5.747126436781609
"Argyle town, Missouri",108,86,22,29,01828,20.37037037037037
"Meta city, Missouri",111,78,33,29,47594,29.72972972972973
"Thayer city, Missouri",1238,934,304,29,72826,24.55573505654281
"Cameron city, Missouri",2772,2446,326,29,10828,11.76046176046176
"Weatherby town, Missouri",49,32,17,29,78028,34.69387755102041
"Champ village, Missouri",3,3,0,29,13078,0.0
"Concord CDP, Missouri",7472,7395,77,29,16030,1.0305139186295502
"Country Club Hills city, Missouri",630,526,104,29,16822,16.507936507936506
"Dellwood city, Missouri",2229,1870,359,29,19018,16.10587707492149
"Ferguson city, Missouri",9616,8131,1485,29,23986,15.443011647254576
"Hazelwood city, Missouri",12060,11084,976,29,31276,8.092868988391375
"Kinloch city, Missouri",185,122,63,29,38972,34.054054054054056
"Mackenzie village, Missouri",81,73,8,29,45110,9.876543209876543
"Pacific city, Missouri",2666,2532,134,29,55910,5.026256564141035
"Sunset Hills city, Missouri",3544,3402,142,29,71746,4.006772009029345
"Uplands Park village, Missouri",168,133,35,29,75238,20.833333333333336
"Valley Park city, Missouri",3273,3003,270,29,75472,8.249312557286894
"Wellston city, Missouri",935,682,253,29,78370,27.058823529411764
"Woodson Terrace city, Missouri",1630,1560,70,29,80962,4.294478527607362
"Harwood village, Missouri",45,33,12,29,30862,26.666666666666668
"Tuscumbia town, Missouri",54,39,15,29,74194,27.77777777777778
"Roscoe village, Missouri",70,43,27,29,63074,38.57142857142858
"Metz town, Missouri",30,18,12,29,47612,40.0
"Sheldon city, Missouri",182,153,29,29,67214,15.934065934065933
"Mooresville village, Missouri",71,52,19,29,49790,26.76056338028169
"Crystal Lakes city, Missouri",142,135,7,29,17660,4.929577464788732
"Homestead village, Missouri",58,53,5,29,32806,8.620689655172415
"Amoret city, Missouri",91,69,22,29,01072,24.175824175824175
"Shell Knob CDP, Missouri",1284,562,722,29,67232,56.230529595015575
"Norwood city, Missouri",307,285,22,29,53454,7.166123778501629
"Adrian city, Missouri",823,722,101,29,00244,12.27217496962333
"Rich Hill city, Missouri",738,603,135,29,61418,18.29268292682927
"New Bloomfield city, Missouri",251,236,15,29,51680,5.9760956175298805
"Leasburg village, Missouri",170,141,29,29,41114,17.058823529411764
"Cross Timbers city, Missouri",96,80,16,29,17524,16.666666666666664
"Gideon city, Missouri",497,415,82,29,26974,16.498993963782695
"Howardville city, Missouri",203,144,59,29,33364,29.064039408866993
"Marston city, Missouri",230,146,84,29,46406,36.52173913043478
"Parma city, Missouri",361,238,123,29,56342,34.07202216066482
"Bolivar city, Missouri",4504,4011,493,29,06976,10.945825932504441
"Flemington village, Missouri",93,39,54,29,24580,58.06451612903226
"St. Joseph city, Missouri",33463,28666,4797,29,64550,14.33523593222365
"Carterville city, Missouri",809,710,99,29,11638,12.237330037082819
"Purcell city, Missouri",173,147,26,29,60140,15.028901734104046
"Memphis city, Missouri",1016,823,193,29,47270,18.996062992125985
"Mountain Grove city, Missouri",2287,2061,226,29,50402,9.881941407958024
"Columbia city, Missouri",52257,48027,4230,29,15670,8.094609334634594
"Passaic town, Missouri",11,11,0,29,56468,0.0
"Lock Springs village, Missouri",17,13,4,29,43472,23.52941176470588
"Ironton city, Missouri",795,671,124,29,35468,15.59748427672956
"McBaine town, Missouri",7,7,0,29,44768,0.0
"Oakwood Park village, Missouri",109,103,6,29,53948,5.5045871559633035
"Randolph village, Missouri",18,12,6,29,60590,33.33333333333333
"Smithville city, Missouri",3677,3476,201,29,68420,5.4664128365515365
"Watson village, Missouri",28,19,9,29,77848,32.142857142857146
"Nelson city, Missouri",98,63,35,29,51500,35.714285714285715
"Sweet Springs city, Missouri",700,578,122,29,71890,17.42857142857143
"Farber city, Missouri",196,148,48,29,23662,24.489795918367346
"Steele city, Missouri",903,704,199,29,70558,22.03765227021041
"Wright City city, Missouri",1353,1200,153,29,81124,11.30820399113082
"Novelty village, Missouri",71,57,14,29,53516,19.718309859154928
"Windsor city, Missouri",1367,1083,284,29,80350,20.775420629114848
"Braymer city, Missouri",447,347,100,29,08038,22.371364653243848
"Polo city, Missouri",310,261,49,29,58916,15.806451612903224
"Greenfield city, Missouri",734,607,127,29,29206,17.302452316076295
"Lockwood city, Missouri",523,454,69,29,43490,13.193116634799235
"Lanagan town, Missouri",198,153,45,29,40592,22.727272727272727
"Baker village, Missouri",0,0,0,29,03034,
"Bernie city, Missouri",903,737,166,29,04960,18.383167220376524
"Neelyville city, Missouri",189,128,61,29,51446,32.27513227513227
"Longtown town, Missouri",49,44,5,29,43940,10.204081632653061
"Renick village, Missouri",90,75,15,29,61166,16.666666666666664
"Seligman city, Missouri",446,349,97,29,66530,21.748878923766814
"Grand Falls Plaza town, Missouri",60,47,13,29,28170,21.666666666666668
"Birch Tree city, Missouri",399,303,96,29,05734,24.06015037593985
"Ewing city, Missouri",192,180,12,29,23032,6.25
"Miami city, Missouri",50,31,19,29,47684,38.0
"Rea city, Missouri",24,24,0,29,60842,0.0
"Darlington village, Missouri",57,35,22,29,18316,38.59649122807017
"Blodgett village, Missouri",93,62,31,29,06346,33.33333333333333
"Foley city, Missouri",55,50,5,29,24886,9.090909090909092
"Whiteside village, Missouri",33,33,0,29,79558,0.0
"Morrisville town, Missouri",182,162,20,29,50078,10.989010989010989
"De Kalb town, Missouri",93,79,14,29,18946,15.053763440860216
"Loch Lloyd village, Missouri",313,301,12,29,43468,3.8338658146964857
"Rushville town, Missouri",108,90,18,29,63596,16.666666666666664
"Plattsburg city, Missouri",1116,1009,107,29,58250,9.587813620071685
"Lamar Heights city, Missouri",81,76,5,29,40430,6.172839506172839
"Pierpont village, Missouri",27,26,1,29,57512,3.7037037037037033
"Pineville city, Missouri",419,337,82,29,57818,19.570405727923628
"Southwest City town, Missouri",431,342,89,29,69230,20.649651972157773
"Ozark city, Missouri",7718,7115,603,29,55766,7.812904897641876
"Gasconade city, Missouri",156,115,41,29,26578,26.282051282051285
"Owensville city, Missouri",1169,982,187,29,55640,15.996578272027373
"Kingdom City village, Missouri",90,70,20,29,38792,22.22222222222222
"Steelville city, Missouri",786,600,186,29,70576,23.66412213740458
"Hermitage city, Missouri",325,279,46,29,31780,14.153846153846153
"Big Lake village, Missouri",298,57,241,29,05495,80.87248322147651
"St. Clair city, Missouri",2348,1929,419,29,64136,17.844974446337307
"Ash Grove city, Missouri",688,632,56,29,02188,8.13953488372093
"Huntley CDP, Montana",211,184,27,30,38200,12.796208530805686
"Laurel city, Montana",3017,2872,145,30,42700,4.806098773616175
"Gildford CDP, Montana",76,60,16,30,30700,21.052631578947366
"Eureka town, Montana",671,567,104,30,24850,15.499254843517138
"Troy city, Montana",468,371,97,30,75025,20.726495726495727
"Miles City city, Montana",4159,3629,530,30,49525,12.74344794421736
"Joliet town, Montana",222,190,32,30,39700,14.414414414414415
"Wisdom CDP, Montana",116,54,62,30,81250,53.44827586206896
"Fox Lake CDP, Montana",45,38,7,30,29087,15.555555555555555
"Brockton town, Montana",86,60,26,30,10000,30.23255813953488
"Black Eagle CDP, Montana",514,487,27,30,07150,5.252918287937743
"Malmstrom AFB CDP, Montana",1199,1147,52,30,47275,4.336947456213512
"Camp Three CDP, Montana",110,86,24,30,11995,21.818181818181817
"Malta city, Montana",1064,946,118,30,47425,11.090225563909774
"Old Agency CDP, Montana",51,39,12,30,55260,23.52941176470588
"Toston CDP, Montana",59,59,0,30,74500,0.0
"Hysham town, Montana",173,146,27,30,38350,15.606936416184972
"Kicking Horse CDP, Montana",41,34,7,30,40580,17.073170731707318
"Kings Point CDP, Montana",332,80,252,30,40725,75.90361445783132
"Ovando CDP, Montana",55,33,22,30,56125,40.0
"Havre city, Montana",4365,4046,319,30,35050,7.308132875143185
"Libby city, Montana",1339,1098,241,30,43450,17.99850634802091
"Lima town, Montana",145,91,54,30,43525,37.24137931034483
"Broadus town, Montana",299,221,78,30,09700,26.08695652173913
"Colstrip city, Montana",984,787,197,30,16525,20.020325203252032
"Cut Bank city, Montana",1299,1091,208,30,18775,16.012317167051577
"Starr School CDP, Montana",84,84,0,30,70825,0.0
"Helena Valley Northeast CDP, Montana",1216,1176,40,30,35628,3.289473684210526
"Ennis town, Montana",509,397,112,30,24475,22.00392927308448
"Woods Bay CDP, Montana",587,352,235,30,81700,40.03407155025553
"De Borgia CDP, Montana",62,37,25,30,19675,40.32258064516129
"Winnett town, Montana",115,77,38,30,81100,33.04347826086956
"Twin Bridges town, Montana",187,153,34,30,75475,18.181818181818183
"Beaver Creek CDP, Montana",124,124,0,30,04575,0.0
"Hingham town, Montana",80,53,27,30,36400,33.75
"Saddle Butte CDP, Montana",26,26,0,30,65065,0.0
"Big Sky CDP, Montana",3743,1106,2637,30,06325,70.45150948437082
"Four Corners CDP, Montana",1752,1591,161,30,28862,9.189497716894977
"West Yellowstone town, Montana",870,540,330,30,79525,37.93103448275862
"Jefferson City CDP, Montana",254,184,70,30,39400,27.559055118110237
"Lewistown Heights CDP, Montana",177,177,0,30,43400,0.0
"White Sulphur Springs city, Montana",569,419,150,30,80050,26.36203866432337
"Helena city, Montana",14908,13800,1108,30,35600,7.432251140327341
"Heart Butte CDP, Montana",137,109,28,30,35350,20.437956204379564
"Hays CDP, Montana",299,267,32,30,35275,10.702341137123746
"Hamilton city, Montana",2364,2205,159,30,33775,6.725888324873096
"Stevensville town, Montana",957,902,55,30,71200,5.747126436781609
"Coram CDP, Montana",255,195,60,30,17500,23.52941176470588
"Hungry Horse CDP, Montana",489,251,238,30,38125,48.670756646216766
"Gardiner CDP, Montana",656,529,127,30,29950,19.359756097560975
"Wilsall CDP, Montana",155,144,11,30,80875,7.096774193548387
"Jordan town, Montana",253,204,49,30,39925,19.367588932806324
"Anaconda-Deer Lodge County, Montana",5192,3855,1337,30,01675,25.751155624036983
"Baker city, Montana",897,772,125,30,03475,13.935340022296543
"Bozeman city, Montana",20325,18539,1786,30,08950,8.78720787207872
"Manhattan town, Montana",700,632,68,30,47575,9.714285714285714
"Sidney city, Montana",2923,2543,380,30,67900,13.000342114266164
"West Glendive CDP, Montana",897,815,82,30,79086,9.141583054626533
"Chinook city, Montana",656,537,119,30,14575,18.140243902439025
"Lodge Grass town, Montana",144,98,46,30,44275,31.944444444444443
"Pryor CDP, Montana",195,142,53,30,59950,27.17948717948718
"Park City CDP, Montana",336,326,10,30,56575,2.976190476190476
"Billings city, Montana",49814,46133,3681,30,06550,7.389488898703175
"Lockwood CDP, Montana",2887,2802,85,30,44200,2.944232767578802
"Basin CDP, Montana",129,102,27,30,04150,20.930232558139537
"Montana City CDP, Montana",1068,1027,41,30,51175,3.838951310861423
"Fort Smith CDP, Montana",160,63,97,30,28650,60.62499999999999
"Reed Point CDP, Montana",133,116,17,30,61900,12.781954887218044
"Shepherd CDP, Montana",181,181,0,30,67525,0.0
"Worden CDP, Montana",263,263,0,30,81925,0.0
"Fort Shaw CDP, Montana",67,51,16,30,28600,23.88059701492537
"Sunburst town, Montana",166,123,43,30,72175,25.903614457831324
"Evergreen CDP, Montana",3314,3026,288,30,25075,8.690404345202172
"Melstone town, Montana",93,54,39,30,49000,41.935483870967744
"Battle Mountain CDP, Nevada",1565,1276,289,32,04900,18.466453674121404
"Dayton CDP, Nevada",3850,3597,253,32,17500,6.571428571428571
"Yerington city, Nevada",1582,1392,190,32,85400,12.010113780025284
"Fallon city, Nevada",3913,3567,346,32,24100,8.842320470227447
"Kingsbury CDP, Nevada",1832,1045,787,32,38000,42.95851528384279
"Stateline CDP, Nevada",452,423,29,32,69200,6.415929203539823
"McDermitt CDP, Nevada",193,86,107,32,44000,55.44041450777202
"Carson City, Nevada",23821,22461,1360,32,09700,5.709248142395365
"Lovelock city, Nevada",1038,767,271,32,43000,26.107899807321772
"Littleton CDP, New Hampshire",2447,2145,302,33,42500,12.341642827952596
"Jaffrey CDP, New Hampshire",1329,1156,173,33,38420,13.017306245297217
"Conway CDP, New Hampshire",2250,1751,499,33,14580,22.177777777777777
"Wolfeboro CDP, New Hampshire",1935,1298,637,33,86340,32.91989664082687
"Exeter CDP, New Hampshire",4316,4122,194,33,25300,4.494902687673772
"West Swanzey CDP, New Hampshire",496,496,0,33,83700,0.0
"Winchester CDP, New Hampshire",835,788,47,33,85460,5.62874251497006
"Farmington CDP, New Hampshire",1843,1745,98,33,25940,5.317417254476397
"Rochester city, New Hampshire",13461,12709,752,33,65140,5.586509174652701
"Hillsborough CDP, New Hampshire",1081,757,324,33,36020,29.972247918593897
"Pittsfield CDP, New Hampshire",852,782,70,33,61860,8.215962441314554
"Antrim CDP, New Hampshire",542,476,66,33,01620,12.177121771217712
"Hinsdale CDP, New Hampshire",778,658,120,33,36580,15.424164524421593
"Marlborough CDP, New Hampshire",542,504,38,33,45380,7.011070110701106
"Hanover CDP, New Hampshire",2288,1933,355,33,33780,15.515734265734265
"Plymouth CDP, New Hampshire",925,662,263,33,62580,28.43243243243243
"Laconia city, New Hampshire",10072,6985,3087,33,40180,30.649324861000792
"Suncook CDP, New Hampshire",2303,2141,162,33,75140,7.034303082935302
"Gorham CDP, New Hampshire",879,731,148,33,30180,16.83731513083049
"Meredith CDP, New Hampshire",754,553,201,33,47060,26.657824933687003
"Newport CDP, New Hampshire",2107,2030,77,33,52500,3.6544850498338874
"Bristol CDP, New Hampshire",850,775,75,33,07620,8.823529411764707
"Enfield CDP, New Hampshire",772,696,76,33,24260,9.844559585492227
"North Conway CDP, New Hampshire",1846,1054,792,33,53860,42.903575297941494
"Dover city, New Hampshire",13989,13180,809,33,18820,5.783115304882407
"Greenville CDP, New Hampshire",528,411,117,33,31860,22.15909090909091
"Berlin city, New Hampshire",4765,3914,851,33,05140,17.859391395592862
"Keene city, New Hampshire",10089,9346,743,33,39300,7.36445633858658
"Wilton CDP, New Hampshire",642,549,93,33,85140,14.485981308411214
"Durham CDP, New Hampshire",2058,1708,350,33,19620,17.006802721088434
"Manchester city, New Hampshire",48969,45461,3508,33,45140,7.163715820212787
"South Hooksett CDP, New Hampshire",1820,1820,0,33,71220,0.0
"Somersworth city, New Hampshire",5356,4934,422,33,69940,7.879014189693802
"East Merrimack CDP, New Hampshire",2004,1887,117,33,21780,5.838323353293413
"Derry CDP, New Hampshire",9837,9106,731,33,17860,7.431127376232591
"Alton CDP, New Hampshire",134,94,40,33,00980,29.850746268656714
"Amherst CDP, New Hampshire",245,245,0,33,01220,0.0
"Ashland CDP, New Hampshire",673,569,104,33,01940,15.453194650817236
"Bartlett CDP, New Hampshire",183,81,102,33,03620,55.73770491803278
"Belmont CDP, New Hampshire",744,672,72,33,04660,9.67741935483871
"Bennington CDP, New Hampshire",172,155,17,33,04820,9.883720930232558
"Bethlehem CDP, New Hampshire",564,416,148,33,05380,26.24113475177305
"Blodgett Landing CDP, New Hampshire",165,33,132,33,06020,80.0
"Bradford CDP, New Hampshire",152,141,11,33,06900,7.236842105263158
"Canaan CDP, New Hampshire",191,137,54,33,08900,28.272251308900525
"Center Ossipee CDP, New Hampshire",252,215,37,33,10820,14.682539682539684
"Center Sandwich CDP, New Hampshire",72,53,19,33,10900,26.38888888888889
"Colebrook CDP, New Hampshire",807,545,262,33,13700,32.465923172242874
"Goffstown CDP, New Hampshire",1336,1336,0,33,29780,0.0
"Hampton Beach CDP, New Hampshire",3047,1402,1645,33,33140,53.9875287167706
"Hancock CDP, New Hampshire",145,137,8,33,33620,5.517241379310345
"Lincoln CDP, New Hampshire",1444,353,1091,33,41780,75.55401662049861
"Loudon CDP, New Hampshire",381,325,56,33,43300,14.698162729658792
"Melvin Village CDP, New Hampshire",315,100,215,33,46980,68.25396825396825
"Milton CDP, New Hampshire",265,237,28,33,48580,10.566037735849058
"Milton Mills CDP, New Hampshire",78,78,0,33,48740,0.0
"Mountain Lakes CDP, New Hampshire",547,225,322,33,49600,58.866544789762344
"Newfields CDP, New Hampshire",117,117,0,33,51300,0.0
"New Hampton CDP, New Hampshire",118,91,27,33,51460,22.88135593220339
"New London CDP, New Hampshire",292,226,66,33,52020,22.602739726027394
"North Walpole CDP, New Hampshire",350,263,87,33,56420,24.857142857142858
"North Woodstock CDP, New Hampshire",770,200,570,33,57220,74.02597402597402
"Plainfield CDP, New Hampshire",111,106,5,33,62260,4.504504504504505
"Sanbornville CDP, New Hampshire",394,285,109,33,67460,27.66497461928934
"Seabrook Beach CDP, New Hampshire",1118,466,652,33,68340,58.31842576028623
"Suissevale CDP, New Hampshire",592,148,444,33,74780,75.0
"Tilton Northfield CDP, New Hampshire",1321,1170,151,33,77100,11.430734292202876
"Troy CDP, New Hampshire",415,410,5,33,77300,1.2048192771084338
"Union CDP, New Hampshire",130,84,46,33,77780,35.38461538461539
"Walpole CDP, New Hampshire",358,315,43,33,78340,12.011173184357542
"Londonderry CDP, New Hampshire",4444,4254,190,33,43140,4.275427542754275
"Warner CDP, New Hampshire",220,207,13,33,78500,5.909090909090909
"West Stewartstown CDP, New Hampshire",161,109,52,33,83620,32.298136645962735
"North Haverhill CDP, New Hampshire",358,314,44,33,54740,12.290502793296088
"Portsmouth city, New Hampshire",10359,9998,361,33,62900,3.484892364127812
"Concord city, New Hampshire",18378,17242,1136,33,14200,6.181303732723909
"Contoocook CDP, New Hampshire",656,608,48,33,14340,7.317073170731707
"Hudson CDP, New Hampshire",3098,2962,136,33,37860,4.389928986442866
"Pinardville CDP, New Hampshire",2196,2071,125,33,61220,5.692167577413479
"Groveton CDP, New Hampshire",565,514,51,33,32260,9.026548672566372
"Lisbon CDP, New Hampshire",468,349,119,33,41940,25.427350427350426
"Claremont city, New Hampshire",6167,5467,700,33,12900,11.350737797956867
"Hampton CDP, New Hampshire",4314,3987,327,33,32980,7.579972183588317
"Newmarket CDP, New Hampshire",2683,2564,119,33,52260,4.435333581811405
"Henniker CDP, New Hampshire",596,534,62,33,35460,10.40268456375839
"Nashua city, New Hampshire",37922,36274,1648,33,50260,4.345762354306207
"Charlestown CDP, New Hampshire",468,438,30,33,11300,6.41025641025641
"Franklin city, New Hampshire",4309,3760,549,33,27380,12.740775121838013
"Milford CDP, New Hampshire",4194,3941,253,33,47940,6.03242727706247
"Peterborough CDP, New Hampshire",1683,1485,198,33,60500,11.76470588235294
"Lancaster CDP, New Hampshire",834,746,88,33,40340,10.551558752997602
"Whitefield CDP, New Hampshire",627,495,132,33,84340,21.052631578947366
"Epping CDP, New Hampshire",735,735,0,33,24580,0.0
"Raymond CDP, New Hampshire",1279,1246,33,33,63940,2.580140734949179
"Lebanon city, New Hampshire",6602,6175,427,33,41300,6.467737049378976
"Woodsville CDP, New Hampshire",444,334,110,33,87140,24.774774774774773
"Hooksett CDP, New Hampshire",2170,2140,30,33,37220,1.3824884792626728
"Oaklyn borough, New Jersey",1817,1669,148,34,53880,8.145294441386902
"Mountain Lakes borough, New Jersey",1397,1356,41,34,48480,2.934860415175376
"Brass Castle CDP, New Jersey",634,586,48,34,07360,7.570977917981073
"Villas CDP, New Jersey",6169,3943,2226,34,76010,36.08364402658454
"Seaside Park borough, New Jersey",2691,877,1814,34,66480,67.40988480118915
"Point Pleasant Beach borough, New Jersey",3104,2001,1103,34,59910,35.534793814432994
"Fort Dix CDP, New Jersey",988,878,110,34,24300,11.133603238866396
"Medford Lakes borough, New Jersey",1496,1468,28,34,45210,1.8716577540106951
"Boonton town, New Jersey",3452,3111,341,34,06610,9.878331402085747
"Stanhope borough, New Jersey",1424,1327,97,34,70380,6.811797752808989
"Glen Ridge borough, New Jersey",2502,2423,79,34,26610,3.1574740207833734
"Beverly city, New Jersey",1112,901,211,34,05740,18.974820143884894
"Burlington city, New Jersey",4603,3911,692,34,08920,15.033673691071039
"Allenwood CDP, New Jersey",297,297,0,34,00790,0.0
"Clinton town, New Jersey",1074,1059,15,34,13720,1.3966480446927374
"Flemington borough, New Jersey",2109,1850,259,34,23700,12.280701754385964
"Somerset CDP, New Jersey",9586,8946,640,34,68370,6.676403087836428
"Sayreville borough, New Jersey",17235,16461,774,34,65790,4.490861618798955
"Port Reading CDP, New Jersey",1462,1339,123,34,60540,8.41313269493844
"Heathcote CDP, New Jersey",2635,2597,38,34,30738,1.4421252371916509
"Laurence Harbor CDP, New Jersey",2747,2430,317,34,39360,11.539861667273389
"Collings Lakes CDP, New Jersey",578,531,47,34,14230,8.131487889273355
"Clementon borough, New Jersey",1962,1834,128,34,13420,6.523955147808359
"Elmwood Park borough, New Jersey",7281,6890,391,34,21300,5.370141464084604
"Hackensack city, New Jersey",20236,18732,1504,34,28680,7.432298873295117
"Beckett CDP, New Jersey",1704,1640,64,34,04400,3.755868544600939
"Wrightstown borough, New Jersey",334,282,52,34,82960,15.568862275449103
"Spring Lake borough, New Jersey",2091,1211,880,34,70110,42.08512673362028
"Rossmoor CDP, New Jersey",2151,2024,127,34,64865,5.904230590423059
"Garwood borough, New Jersey",1835,1773,62,34,25800,3.3787465940054497
"Mays Landing CDP, New Jersey",1135,1008,127,34,44820,11.189427312775331
"Interlaken borough, New Jersey",395,343,52,34,34200,13.164556962025317
"Williamstown CDP, New Jersey",6207,5693,514,34,81380,8.280973094892863
"Mount Ephraim borough, New Jersey",1988,1775,213,34,48750,10.714285714285714
"Hopewell borough, New Jersey",760,747,13,34,33150,1.710526315789474
"Roselle borough, New Jersey",8345,7528,817,34,64620,9.790293588975436
"Marlton CDP, New Jersey",4457,4166,291,34,44100,6.529055418442899
"Sewaren CDP, New Jersey",1007,923,84,34,66720,8.341608738828203
"Kingston CDP, New Jersey",601,553,48,34,36930,7.9866888519134775
"Union Beach borough, New Jersey",2208,1893,315,34,74540,14.266304347826086
"Franklin borough, New Jersey",2210,1913,297,34,24930,13.438914027149321
"Madison Park CDP, New Jersey",2903,2709,194,34,42540,6.6827419910437476
"Holiday City South CDP, New Jersey",2561,2342,219,34,32418,8.551347130027333
"Leisure Village East CDP, New Jersey",2856,2498,358,34,39910,12.53501400560224
"Pleasantville city, New Jersey",7766,6763,1003,34,59640,12.915271697141387
"South Amboy city, New Jersey",3698,3395,303,34,68550,8.193618171984857
"Hammonton town, New Jersey",5637,5127,510,34,29430,9.047365620010645
"Northfield city, New Jersey",3104,2832,272,34,52950,8.762886597938143
"Milford borough, New Jersey",608,536,72,34,46260,11.842105263157894
"White House Station CDP, New Jersey",1123,1077,46,34,80720,4.096170970614425
"Deal borough, New Jersey",886,236,650,34,16660,73.36343115124153
"Kendall Park CDP, New Jersey",3311,3179,132,34,36660,3.9867109634551494
"Old Bridge CDP, New Jersey",8265,7919,346,34,54690,4.186327888687235
"Perth Amboy city, New Jersey",16966,15946,1020,34,58200,6.012024048096192
"Plainsboro Center CDP, New Jersey",1402,1189,213,34,59285,15.192582025677604
"Buena borough, New Jersey",1846,1738,108,34,08680,5.850487540628386
"Island Heights borough, New Jersey",772,628,144,34,34530,18.65284974093264
"Dover Beaches South CDP, New Jersey",2394,680,1714,34,18151,71.59565580618212
"Holiday Heights CDP, New Jersey",1326,1186,140,34,32424,10.558069381598793
"Mystic Island CDP, New Jersey",5480,3773,1707,34,49560,31.14963503649635
"Tuckerton borough, New Jersey",1964,1447,517,34,74210,26.323828920570264
"Pompton Lakes borough, New Jersey",4124,3952,172,34,60090,4.1707080504364695
"Holiday City-Berkeley CDP, New Jersey",8804,7522,1282,34,32415,14.561562925942754
"Mantoloking borough, New Jersey",448,166,282,34,43380,62.94642857142857
"North Beach Haven CDP, New Jersey",6091,1161,4930,34,52410,80.93909046133639
"Pine Ridge at Crestwood CDP, New Jersey",1777,1483,294,34,58852,16.54473832301632
"Brooklawn borough, New Jersey",810,698,112,34,08170,13.82716049382716
"Chesilhurst borough, New Jersey",615,565,50,34,12550,8.130081300813007
"Echelon CDP, New Jersey",5524,4924,600,34,19900,10.861694424330196
"Morganville CDP, New Jersey",1859,1671,188,34,48030,10.112963959117806
"Egg Harbor City city, New Jersey",1609,1388,221,34,20350,13.735239279055314
"Estell Manor city, New Jersey",757,606,151,34,21870,19.947159841479525
"Folsom borough, New Jersey",641,619,22,34,23940,3.43213728549142
"Longport borough, New Jersey",1529,419,1110,34,41370,72.59646827992152
"Port Republic city, New Jersey",438,404,34,34,60600,7.76255707762557
"Ventnor City city, New Jersey",7586,4196,3390,34,75620,44.6875823886106
"Frenchtown borough, New Jersey",611,580,31,34,25350,5.073649754500818
"Bound Brook borough, New Jersey",4289,3527,762,34,06790,17.766379109349497
"Manville borough, New Jersey",4305,3785,520,34,43620,12.07897793263647
"Belmar borough, New Jersey",3722,2560,1162,34,04930,31.219774314884468
"Bradley Beach borough, New Jersey",3049,2120,929,34,06970,30.469006231551326
"Cliffwood Beach CDP, New Jersey",1228,1145,83,34,13630,6.758957654723127
"Fair Haven borough, New Jersey",1928,1864,64,34,22440,3.319502074688797
"Lakewood CDP, New Jersey",11063,10384,679,34,38580,6.137575702793094
"Little Silver borough, New Jersey",2200,2099,101,34,40770,4.590909090909091
"Pine Beach borough, New Jersey",922,825,97,34,58590,10.52060737527115
"Barnegat CDP, New Jersey",1189,1046,143,34,03040,12.026913372582001
"Ocean Gate borough, New Jersey",1204,748,456,34,54450,37.87375415282392
"South Toms River borough, New Jersey",1105,993,112,34,69510,10.135746606334841
"Cedar Glen West CDP, New Jersey",911,839,72,34,11155,7.903402854006586
"Lavallette borough, New Jersey",3039,1100,1939,34,39390,63.8038828562027
"Leisure Village CDP, New Jersey",2773,2436,337,34,39900,12.152902993148215
"Waretown CDP, New Jersey",1018,900,118,34,76820,11.591355599214145
"Kinnelon borough, New Jersey",3546,3376,170,34,37110,4.794134235758602
"Mount Arlington borough, New Jersey",2822,2368,454,34,48690,16.087880935506732
"Whittingham CDP, New Jersey",1557,1501,56,34,81042,3.5966602440590876
"Margate City city, New Jersey",7178,3053,4125,34,43890,57.4672610755085
"Stone Harbor borough, New Jersey",3121,454,2667,34,71010,85.45338032681833
"Florham Park borough, New Jersey",4316,4021,295,34,23910,6.835032437442076
"Lincoln Park borough, New Jersey",3735,3587,148,34,40290,3.962516733601071
"Victory Gardens borough, New Jersey",637,573,64,34,75890,10.047095761381476
"Wildwood Crest borough, New Jersey",5594,1435,4159,34,81200,74.34751519485164
"Carneys Point CDP, New Jersey",3082,2725,357,34,10600,11.583387410772227
"Allentown borough, New Jersey",725,715,10,34,00760,1.3793103448275863
"Glen Gardner borough, New Jersey",871,782,89,34,26550,10.218140068886337
"Peapack and Gladstone borough, New Jersey",895,839,56,34,57300,6.256983240223464
"South Bound Brook borough, New Jersey",1877,1578,299,34,68730,15.929675013319125
"Belford CDP, New Jersey",631,602,29,34,04600,4.595879556259905
"Eatontown borough, New Jersey",5859,5406,453,34,19840,7.731694828469022
"Freehold borough, New Jersey",4469,4108,361,34,25200,8.077869769523383
"Keyport borough, New Jersey",3219,3026,193,34,36810,5.99565082323703
"Matawan borough, New Jersey",3535,3425,110,34,44520,3.1117397454031117
"Ocean Grove CDP, New Jersey",3032,1967,1065,34,54480,35.12532981530343
"Port Monmouth CDP, New Jersey",1288,1150,138,34,60360,10.714285714285714
"Rumson borough, New Jersey",2431,2182,249,34,65130,10.242698477992596
"Sea Girt borough, New Jersey",1267,772,495,34,66330,39.06866614048934
"Wanamassa CDP, New Jersey",1739,1577,162,34,76700,9.315698677400805
"West Freehold CDP, New Jersey",5331,5030,301,34,79100,5.646220221346839
"Park Ridge borough, New Jersey",3462,3299,163,34,56130,4.708261120739457
"Waldwick borough, New Jersey",3632,3574,58,34,76400,1.5969162995594712
"Wallington borough, New Jersey",5119,4676,443,34,76490,8.65403399101387
"Wood-Ridge borough, New Jersey",3309,3252,57,34,82570,1.7225747960108795
"Harrison town, New Jersey",6189,5873,316,34,30210,5.105832929390855
"Concordia CDP, New Jersey",2307,2234,73,34,14758,3.1642826181187687
"Fords CDP, New Jersey",5445,5101,344,34,24030,6.317722681359045
"Helmetta borough, New Jersey",986,887,99,34,30840,10.04056795131846
"Jamesburg borough, New Jersey",2416,2228,188,34,34890,7.781456953642383
"Milltown borough, New Jersey",2694,2448,246,34,46620,9.131403118040089
"Monmouth Junction CDP, New Jersey",1005,1005,0,34,47190,0.0
"Brigantine city, New Jersey",9569,4127,5442,34,07810,56.8711464102832
"Harrington Park borough, New Jersey",1625,1625,0,34,30150,0.0
"Little Ferry borough, New Jersey",4702,4308,394,34,40680,8.379413015737985
"Midland Park borough, New Jersey",2741,2604,137,34,46110,4.998175848230573
"Northvale borough, New Jersey",1793,1730,63,34,53430,3.5136642498605686
"Oradell borough, New Jersey",2763,2719,44,34,54990,1.5924719507781397
"Paramus borough, New Jersey",8767,8310,457,34,55950,5.212729554009353
"Cedarville CDP, New Jersey",302,244,58,34,11410,19.205298013245034
"Laurel Lake CDP, New Jersey",1431,1253,178,34,39120,12.43885394828791
"Turnersville CDP, New Jersey",1215,1133,82,34,74270,6.748971193415638
"Rosenhayn CDP, New Jersey",512,484,28,34,64740,5.46875
"Shiloh borough, New Jersey",163,148,15,34,67020,9.202453987730062
"Gibbstown CDP, New Jersey",1647,1496,151,34,26100,9.168184578020643
"Victory Lakes CDP, New Jersey",789,756,33,34,75920,4.182509505703422
"Cherry Hill Mall CDP, New Jersey",5703,5175,528,34,12385,9.258285113098369
"Collingswood borough, New Jersey",6730,5966,764,34,14260,11.352154531946509
"Laurel Springs borough, New Jersey",773,715,58,34,39210,7.503234152652006
"Magnolia borough, New Jersey",1741,1656,85,34,42630,4.882251579551982
"Stratford borough, New Jersey",2854,2608,246,34,71220,8.61948142957253
"Closter borough, New Jersey",2878,2764,114,34,13810,3.9610840861709518
"Strathmere CDP, New Jersey",482,97,385,34,71250,79.87551867219918
"Riverdale borough, New Jersey",1878,1829,49,34,63300,2.6091586794462196
"White Meadow Lake CDP, New Jersey",3341,3255,86,34,80750,2.574079616881173
"Sea Isle City city, New Jersey",6886,1020,5866,34,66390,85.18733662503631
"Woodbine borough, New Jersey",1159,802,357,34,81890,30.802415875754964
"Elmer borough, New Jersey",525,486,39,34,21240,7.428571428571429
"Pennsville CDP, New Jersey",5205,4440,765,34,57840,14.697406340057636
"Alpha borough, New Jersey",1046,915,131,34,01030,12.523900573613766
"Belvidere town, New Jersey",1156,981,175,34,04990,15.138408304498268
"Washington borough, New Jersey",2844,2632,212,34,77270,7.454289732770746
"Ringwood borough, New Jersey",4320,3990,330,34,63150,7.638888888888889
"Crestwood Village CDP, New Jersey",6573,5726,847,34,15910,12.88604898828541
"Manahawkin CDP, New Jersey",1006,926,80,34,42930,7.952286282306163
"Seaside Heights borough, New Jersey",2771,1132,1639,34,66450,59.14832190544929
"Toms River CDP, New Jersey",36950,33591,3359,34,73110,9.090663058186738
"Vista Center CDP, New Jersey",921,892,29,34,76107,3.1487513572204127
"Bay Head borough, New Jersey",1004,457,547,34,03520,54.482071713147405
"Beach Haven borough, New Jersey",2669,544,2125,34,03940,79.61783439490446
"Beach Haven West CDP, New Jersey",4371,1726,2645,34,04120,60.512468542667584
"Forked River CDP, New Jersey",2685,2037,648,34,24180,24.134078212290504
"Harvey Cedars borough, New Jersey",1237,236,1001,34,30390,80.9215844785772
"Lakehurst borough, New Jersey",1008,937,71,34,37770,7.0436507936507935
"Leisure Knoll CDP, New Jersey",1627,1502,125,34,39883,7.682851874615857
"Ship Bottom borough, New Jersey",2074,461,1613,34,67110,77.77242044358728
"Silver Ridge CDP, New Jersey",804,698,106,34,67665,13.184079601990051
"New Egypt CDP, New Jersey",987,987,0,34,51360,0.0
"Point Pleasant borough, New Jersey",8493,7416,1077,34,59880,12.68103143765454
"Surf City borough, New Jersey",2438,606,1832,34,71640,75.14356029532404
"Leonia borough, New Jersey",3499,3338,161,34,40020,4.601314661331809
"Glen Rock borough, New Jersey",3927,3781,146,34,26640,3.7178507766743056
"Haworth borough, New Jersey",1140,1112,28,34,30540,2.456140350877193
"Ho-Ho-Kus borough, New Jersey",1498,1415,83,34,32310,5.540720961281709
"Old Tappan borough, New Jersey",2084,2028,56,34,54870,2.6871401151631478
"Moonachie borough, New Jersey",1061,977,84,34,47700,7.917059377945335
"Golden Triangle CDP, New Jersey",1758,1522,236,34,26902,13.42434584755404
"Springdale CDP, New Jersey",5321,5071,250,34,69900,4.698364968990791
"Bogota borough, New Jersey",2980,2866,114,34,06490,3.825503355704698
"Rutherford borough, New Jersey",7372,7101,271,34,65280,3.676071622354856
"Saddle River borough, New Jersey",1360,1262,98,34,65400,7.205882352941176
"Woodcliff Lake borough, New Jersey",2054,2009,45,34,82300,2.190847127555988
"Bayonne city, New Jersey",27272,24975,2297,34,03580,8.422557934878263
"Jersey City city, New Jersey",112480,101007,11473,34,36000,10.200035561877668
"Brownville CDP, New Jersey",1231,1114,117,34,08492,9.504467912266449
"Carteret borough, New Jersey",8500,7950,550,34,10750,6.470588235294119
"Glassboro borough, New Jersey",6825,5934,891,34,26340,13.054945054945055
"Dunellen borough, New Jersey",2700,2540,160,34,18490,5.9259259259259265
"Iselin CDP, New Jersey",6605,6374,231,34,34470,3.4973504920514764
"Fairton CDP, New Jersey",498,410,88,34,22530,17.670682730923694
"Pitman borough, New Jersey",3620,3359,261,34,59070,7.209944751381216
"Bellmawr borough, New Jersey",4729,4379,350,34,04750,7.401141890463101
"Glendora CDP, New Jersey",2030,1874,156,34,26520,7.684729064039408
"Haddonfield borough, New Jersey",4433,4200,233,34,28770,5.256034288292353
"Merchantville borough, New Jersey",1634,1479,155,34,45510,9.4859241126071
"Cresskill borough, New Jersey",3053,2890,163,34,15820,5.339010809040288
"Demarest borough, New Jersey",1785,1686,99,34,17530,5.546218487394958
"Emerson borough, New Jersey",2634,2509,125,34,21450,4.745634016704632
"Hillsdale borough, New Jersey",3665,3602,63,34,31920,1.7189631650750339
"Lodi borough, New Jersey",9383,8927,456,34,41100,4.85985292550357
"Montvale borough, New Jersey",2879,2858,21,34,47610,0.729419937478291
"Ridgefield borough, New Jersey",4074,3900,174,34,62910,4.270986745213549
"Upper Saddle River borough, New Jersey",2591,2452,139,34,75140,5.364724044770359
"Hoboken city, New Jersey",27308,25132,2176,34,32250,7.968360919876958
"Kearny town, New Jersey",14560,13581,979,34,36510,6.7239010989010985
"Cranbury CDP, New Jersey",793,768,25,34,15520,3.1525851197982346
"Port Norris CDP, New Jersey",494,429,65,34,60510,13.157894736842104
"Vineland city, New Jersey",22526,20811,1715,34,76070,7.6134244872591665
"Clayton borough, New Jersey",3518,3135,383,34,13360,10.886867538374077
"Oak Valley CDP, New Jersey",1212,1194,18,34,54060,1.4851485148514851
"Camden city, New Jersey",29938,24727,5211,34,10000,17.405972342841874
"Gloucester City city, New Jersey",4336,3981,355,34,26820,8.187269372693727
"Hi-Nella borough, New Jersey",407,399,8,34,32220,1.9656019656019657
"Tavistock borough, New Jersey",3,2,1,34,72240,33.33333333333333
"Alpine borough, New Jersey",599,525,74,34,01090,12.353923205342237
"East Rutherford borough, New Jersey",4129,3800,329,34,19510,7.96803100024219
"Englewood city, New Jersey",11752,10648,1104,34,21480,9.394145677331519
"Oakland borough, New Jersey",4554,4311,243,34,53850,5.33596837944664
"Fairview borough, New Jersey",5690,5393,297,34,22560,5.219683655536028
"Garfield city, New Jersey",12117,11293,824,34,25770,6.80036312618635
"New Milford borough, New Jersey",6013,5806,207,34,51660,3.442541160818227
"Palisades Park borough, New Jersey",7849,7525,324,34,55770,4.127914383997962
"Bridgeton city, New Jersey",7154,6346,808,34,07600,11.294380766005032
"Princeton Meadows CDP, New Jersey",6344,5576,768,34,60975,12.105926860025221
"Fair Lawn borough, New Jersey",11904,11463,441,34,22470,3.704637096774194
"Fort Lee borough, New Jersey",18529,17004,1525,34,24420,8.230341626639321
"Franklin Lakes borough, New Jersey",3936,3758,178,34,24990,4.522357723577236
"Avenel CDP, New Jersey",5455,5133,322,34,02350,5.902841429880843
"Corbin City city, New Jersey",176,156,20,34,15160,11.363636363636363
"Rockleigh borough, New Jersey",69,65,4,34,64170,5.797101449275362
"Secaucus town, New Jersey",7781,7285,496,34,66570,6.374501992031872
"Colonia CDP, New Jersey",6160,5964,196,34,14380,3.1818181818181817
"South Plainfield borough, New Jersey",8137,7855,282,34,69390,3.4656507312277247
"Annandale CDP, New Jersey",535,526,9,34,01480,1.6822429906542056
"Bloomsbury borough, New Jersey",348,304,44,34,06370,12.643678160919542
"Stockton borough, New Jersey",286,265,21,34,70980,7.3426573426573425
"Raritan borough, New Jersey",3314,2938,376,34,61980,11.345805672902836
"Somerville borough, New Jersey",5363,4363,1000,34,68460,18.646280067126607
"Avon-by-the-Sea borough, New Jersey",1322,895,427,34,02440,32.299546142208776
"Englishtown borough, New Jersey",807,738,69,34,21570,8.550185873605948
"Highlands borough, New Jersey",3597,2787,810,34,31500,22.51876563803169
"Roosevelt borough, New Jersey",287,272,15,34,64410,5.2264808362369335
"Keansburg borough, New Jersey",5023,4029,994,34,36480,19.788970734620744
"Long Branch city, New Jersey",14599,11896,2703,34,41310,18.514966778546476
"Oakhurst CDP, New Jersey",1381,1301,80,34,53790,5.792903692976104
"Tinton Falls borough, New Jersey",8659,8092,567,34,73020,6.548100242522231
"Andover borough, New Jersey",277,250,27,34,01330,9.747292418772563
"Mountainside borough, New Jersey",2464,2409,55,34,48510,2.232142857142857
"Ramsey borough, New Jersey",5884,5522,362,34,61680,6.152277362338545
"Tenafly borough, New Jersey",4783,4600,183,34,72420,3.8260505958603384
"Westwood borough, New Jersey",4580,4387,193,34,80270,4.213973799126638
"West New York town, New Jersey",21088,19646,1442,34,79610,6.838012139605462
"Clearbrook Park CDP, New Jersey",1959,1909,50,34,13399,2.5523226135783563
"Guttenberg town, New Jersey",4915,4673,242,34,28650,4.923702950152594
"River Edge borough, New Jersey",4111,3942,169,34,63360,4.110921916808563
"East Newark borough, New Jersey",803,749,54,34,19360,6.724782067247821
"Highland Park borough, New Jersey",6066,5608,458,34,31470,7.550280250576987
"Metuchen borough, New Jersey",5392,5203,189,34,45690,3.505192878338279
"National Park borough, New Jersey",1117,1033,84,34,49680,7.520143240823635
"Newfield borough, New Jersey",619,577,42,34,51390,6.78513731825525
"Wenonah borough, New Jersey",828,765,63,34,78110,7.608695652173914
"Berlin borough, New Jersey",2850,2783,67,34,05440,2.3508771929824563
"Lawnside borough, New Jersey",1210,1087,123,34,39420,10.165289256198347
"Pine Hill borough, New Jersey",4827,4410,417,34,58770,8.638906152889994
"Pine Valley borough, New Jersey",15,2,13,34,58920,86.66666666666667
"Allendale borough, New Jersey",2403,2254,149,34,00700,6.200582605076987
"Englewood Cliffs borough, New Jersey",1977,1779,198,34,21510,10.015174506828528
"Maywood borough, New Jersey",3656,3499,157,34,44880,4.294310722100656
"North Arlington borough, New Jersey",6435,6248,187,34,52320,2.905982905982906
"Teterboro borough, New Jersey",41,41,0,34,72480,0.0
"Middlesex borough, New Jersey",5156,4943,213,34,45900,4.1311093871218
"New Brunswick city, New Jersey",16354,14893,1461,34,51210,8.933594227711875
"Netcong borough, New Jersey",1482,1393,89,34,50130,6.005398110661268
"Avalon borough, New Jersey",5366,721,4645,34,02320,86.56354826686545
"Barrington borough, New Jersey",2916,2775,141,34,03250,4.8353909465020575
"Dayton CDP, New Jersey",2471,2326,145,34,16630,5.868069607446378
"Edgewater borough, New Jersey",6328,5746,582,34,20020,9.197218710493047
"Ridgewood village, New Jersey",8589,8337,252,34,63000,2.93398533007335
"Union City city, New Jersey",26712,24147,2565,34,74630,9.60242587601078
"Runnemede borough, New Jersey",3368,3190,178,34,65160,5.285035629453682
"Ridgefield Park village, New Jersey",5104,4761,343,34,62940,6.720219435736677
"Atlantic City city, New Jersey",20100,15272,4828,34,02080,24.019900497512438
"Bloomingdale borough, New Jersey",3044,2916,128,34,06340,4.204993429697766
"Navesink CDP, New Jersey",672,522,150,34,49740,22.321428571428573
"Woodbury Heights borough, New Jersey",1125,1095,30,34,82180,2.666666666666667
"Greentree CDP, New Jersey",4291,4117,174,34,27995,4.0549988347704495
"Dumont borough, New Jersey",6662,6373,289,34,18400,4.338036625637947
"Norwood borough, New Jersey",2193,2133,60,34,53610,2.7359781121751023
"Millville city, New Jersey",12419,10959,1460,34,46680,11.756180046702633
"Hasbrouck Heights borough, New Jersey",4403,4239,164,34,30420,3.7247331364978424
"Cape May Court House CDP, New Jersey",2685,2080,605,34,10300,22.532588454376164
"Hightstown borough, New Jersey",2118,1951,167,34,31620,7.884796978281397
"Princeton Junction CDP, New Jersey",1076,976,100,34,60960,9.293680297397769
"Twin Rivers CDP, New Jersey",2575,2271,304,34,74330,11.805825242718447
"Clifton city, New Jersey",31766,29169,2597,34,13690,8.175407668576465
"Hawthorne borough, New Jersey",7159,6963,196,34,30570,2.737812543651348
"Cedar Glen Lakes CDP, New Jersey",1270,1119,151,34,11140,11.88976377952756
"North Haledon borough, New Jersey",3307,3221,86,34,53040,2.6005442999697608
"Passaic city, New Jersey",21548,19646,1902,34,56550,8.826805271950994
"Barnegat Light borough, New Jersey",1286,237,1049,34,03130,81.57076205287714
"Dover Beaches North CDP, New Jersey",3841,915,2926,34,18148,76.17807862535798
"White Horse CDP, New Jersey",3755,3504,251,34,80630,6.6844207723035955
"Haledon borough, New Jersey",2789,2722,67,34,29070,2.4022947292936534
"Wanaque borough, New Jersey",4404,4085,319,34,76730,7.243415077202544
"Loch Arbour village, New Jersey",159,73,86,34,41010,54.088050314465406
"Manasquan borough, New Jersey",3471,2330,1141,34,43050,32.872371074618265
"Shark River Hills CDP, New Jersey",1465,1390,75,34,66840,5.1194539249146755
"Spring Lake Heights borough, New Jersey",2595,2296,299,34,70140,11.522157996146436
"Hampton borough, New Jersey",582,532,50,34,29460,8.59106529209622
"South River borough, New Jersey",6028,5590,438,34,69420,7.266091572660915
"Spotswood borough, New Jersey",3459,3339,120,34,69810,3.469210754553339
"Woodbridge CDP, New Jersey",7574,7111,463,34,81950,6.113018220227093
"Absecon city, New Jersey",3507,3092,415,34,00100,11.833475905332193
"Linwood city, New Jersey",2686,2491,195,34,40530,7.259865971705137
"High Bridge borough, New Jersey",1536,1453,83,34,31320,5.403645833333334
"Lambertville city, New Jersey",2191,2003,188,34,38610,8.580556823368326
"Millstone borough, New Jersey",167,154,13,34,46590,7.784431137724551
"Rocky Hill borough, New Jersey",281,229,52,34,64320,18.505338078291814
"Watchung borough, New Jersey",2213,1899,314,34,77600,14.188883868052418
"Allenhurst borough, New Jersey",352,205,147,34,00730,41.76136363636363
"North Middletown CDP, New Jersey",1233,1145,88,34,53205,7.1370640713706415
"Oceanport borough, New Jersey",2434,2118,316,34,54570,12.982744453574362
"Sea Bright borough, New Jersey",1084,752,332,34,66240,30.627306273062732
"Shrewsbury borough, New Jersey",1488,1454,34,34,67350,2.28494623655914
"Strathmore CDP, New Jersey",2754,2691,63,34,71280,2.287581699346405
"West Belmar CDP, New Jersey",1040,877,163,34,78350,15.673076923076923
"West Long Branch borough, New Jersey",2689,2459,230,34,79310,8.553365563406471
"Somers Point city, New Jersey",5531,4457,1074,34,68430,19.417826794431388
"Califon borough, New Jersey",441,432,9,34,09280,2.0408163265306123
"Lebanon borough, New Jersey",854,812,42,34,39630,4.918032786885246
"Bernardsville borough, New Jersey",2768,2671,97,34,05590,3.504335260115607
"Far Hills borough, New Jersey",371,327,44,34,22890,11.859838274932615
"North Plainfield borough, New Jersey",7829,7424,405,34,53280,5.173074466726274
"Brielle borough, New Jersey",2142,1780,362,34,07750,16.900093370681606
"East Freehold CDP, New Jersey",1661,1611,50,34,19150,3.0102347983142685
"Farmingdale borough, New Jersey",590,566,24,34,22950,4.067796610169491
"Lincroft CDP, New Jersey",2204,2089,115,34,40320,5.217785843920145
"Red Bank borough, New Jersey",5619,5138,481,34,62430,8.560242035949457
"Ogdensburg borough, New Jersey",926,816,110,34,54660,11.879049676025918
"New Providence borough, New Jersey",4592,4417,175,34,51810,3.8109756097560976
"Roselle Park borough, New Jersey",5285,5087,198,34,64650,3.746452223273415
"Summit city, New Jersey",8038,7657,381,34,71430,4.739985070913162
"Bordentown city, New Jersey",2017,1710,307,34,06670,15.220624690133864
"Palmyra borough, New Jersey",3364,2950,414,34,55800,12.30677764565993
"Chester borough, New Jersey",651,593,58,34,12580,8.90937019969278
"Lake Telemark CDP, New Jersey",453,432,21,34,38430,4.635761589403973
"Pemberton borough, New Jersey",650,575,75,34,57480,11.538461538461538
"Riverton borough, New Jersey",1064,993,71,34,63660,6.672932330827068
"Olivet CDP, New Jersey",547,527,20,34,54960,3.656307129798903
"Hackettstown town, New Jersey",3566,3432,134,34,28710,3.757711721817162
"Oxford CDP, New Jersey",491,472,19,34,55500,3.8696537678207736
"Chatham borough, New Jersey",3147,2906,241,34,12100,7.658087067047982
"Pennington borough, New Jersey",1035,970,65,34,57600,6.280193236714976
"Leisuretowne CDP, New Jersey",2300,2101,199,34,39885,8.652173913043478
"Pemberton Heights CDP, New Jersey",1198,1148,50,34,57540,4.173622704507513
"Mullica Hill CDP, New Jersey",1629,1565,64,34,49440,3.9287906691221606
"Paulsboro borough, New Jersey",3137,2552,585,34,57150,18.64839018170226
"Westville borough, New Jersey",1793,1636,157,34,80120,8.756274400446179
"Gibbsboro borough, New Jersey",805,769,36,34,26070,4.472049689440994
"Haddon Heights borough, New Jersey",3124,2969,155,34,28800,4.961587708066581
"McCook city, Nebraska",3806,3239,567,31,29925,14.89753021544929
"Stella village, Nebraska",121,95,26,31,47115,21.487603305785125
"Verdon village, Nebraska",107,94,13,31,50510,12.149532710280374
"Nelson city, Nebraska",324,240,84,31,33880,25.925925925925924
"Atlanta village, Nebraska",73,45,28,31,02620,38.35616438356164
"Huntley village, Nebraska",14,14,0,31,23550,0.0
"Ong village, Nebraska",42,30,12,31,37140,28.57142857142857
"Sidney city, Nebraska",3377,3100,277,31,45295,8.202546639028723
"Alma city, Nebraska",753,627,126,31,00975,16.733067729083665
"Orleans village, Nebraska",285,232,53,31,37420,18.596491228070175
"Stamford village, Nebraska",108,63,45,31,46695,41.66666666666667
"Dix village, Nebraska",161,145,16,31,13190,9.937888198757763
"Bennet village, Nebraska",375,353,22,31,04300,5.866666666666666
"Crawford city, Nebraska",632,477,155,31,11195,24.525316455696203
"Dodge village, Nebraska",293,249,44,31,13295,15.017064846416384
"Hooper city, Nebraska",403,364,39,31,23025,9.67741935483871
"Snyder village, Nebraska",177,158,19,31,45610,10.734463276836157
"Spalding village, Nebraska",252,202,50,31,46135,19.841269841269842
"Phillips village, Nebraska",135,122,13,31,39030,9.62962962962963
"Wausa village, Nebraska",322,262,60,31,51735,18.633540372670808
"Hazard village, Nebraska",40,38,2,31,21765,5.0
"Loup City city, Nebraska",597,497,100,31,29470,16.750418760469014
"Colon village, Nebraska",60,48,12,31,10005,20.0
"Clay Center city, Nebraska",422,355,67,31,09375,15.876777251184834
"Oxford village, Nebraska",410,335,75,31,37910,18.29268292682927
"Stratton village, Nebraska",217,171,46,31,47395,21.19815668202765
"Cotesfield village, Nebraska",26,22,4,31,10740,15.384615384615385
"Elba village, Nebraska",162,141,21,31,14555,12.962962962962962
"York city, Nebraska",3600,3357,243,31,54045,6.75
"Eustis village, Nebraska",239,211,28,31,16165,11.715481171548117
"Stockville village, Nebraska",11,6,5,31,47290,45.45454545454545
"Newman Grove city, Nebraska",425,336,89,31,34230,20.941176470588236
"Washington village, Nebraska",40,40,0,31,51595,0.0
"Bruning village, Nebraska",176,150,26,31,06820,14.772727272727273
"Arlington village, Nebraska",545,523,22,31,01990,4.036697247706423
"Gilead village, Nebraska",27,20,7,31,18720,25.925925925925924
"Newport village, Nebraska",54,43,11,31,34265,20.37037037037037
"Lynch village, Nebraska",212,133,79,31,29750,37.264150943396224
"Coleridge village, Nebraska",284,225,59,31,09865,20.774647887323944
"Naponee village, Nebraska",87,54,33,31,33565,37.93103448275862
"Mullen village, Nebraska",304,210,94,31,33250,30.92105263157895
"Beaver Crossing village, Nebraska",185,161,24,31,03530,12.972972972972974
"Curtis city, Nebraska",405,327,78,31,11825,19.25925925925926
"Liberty village, Nebraska",37,27,10,31,26980,27.027027027027028
"Crete city, Nebraska",2453,2171,282,31,11370,11.496127191194455
"Milford city, Nebraska",931,856,75,31,32060,8.055853920515576
"Pleasant Dale village, Nebraska",127,101,26,31,39380,20.47244094488189
"Cedar Bluffs village, Nebraska",255,231,24,31,08150,9.411764705882353
"Petersburg village, Nebraska",179,166,13,31,38995,7.262569832402235
"St. Edward city, Nebraska",359,314,45,31,43055,12.534818941504177
"Saronville village, Nebraska",28,23,5,31,43755,17.857142857142858
"Bazile Mills village, Nebraska",15,11,4,31,03355,26.666666666666668
"Niobrara village, Nebraska",247,173,74,31,34370,29.959514170040485
"Ashton village, Nebraska",130,101,29,31,02375,22.30769230769231
"Ithaca village, Nebraska",75,63,12,31,24285,16.0
"Mead village, Nebraska",266,235,31,31,31395,11.654135338345863
"Cozad city, Nebraska",1768,1627,141,31,11020,7.975113122171945
"Farnam village, Nebraska",105,98,7,31,16725,6.666666666666667
"Gothenburg city, Nebraska",1553,1318,235,31,19385,15.132002575660014
"Sumner village, Nebraska",106,93,13,31,47675,12.264150943396226
"Arapahoe city, Nebraska",555,471,84,31,01780,15.135135135135137
"Hendley village, Nebraska",20,10,10,31,22115,50.0
"Macy CDP, Nebraska",245,221,24,31,30170,9.795918367346939
"Pender village, Nebraska",519,492,27,31,38750,5.202312138728324
"Walthill village, Nebraska",225,194,31,31,51245,13.777777777777779
"Burton village, Nebraska",2,0,2,31,07310,100.0
"Mitchell city, Nebraska",825,739,86,31,32410,10.424242424242426
"Winside village, Nebraska",259,225,34,31,53380,13.127413127413126
"Exeter village, Nebraska",298,270,28,31,16340,9.395973154362416
"Ohiowa village, Nebraska",102,72,30,31,36015,29.411764705882355
"Cowles village, Nebraska",6,6,0,31,10985,0.0
"Schuyler city, Nebraska",1932,1839,93,31,44035,4.813664596273292
"Hubbard village, Nebraska",100,87,13,31,23375,13.0
"South Sioux City city, Nebraska",4934,4744,190,31,46030,3.8508309687880016
"Big Springs village, Nebraska",256,226,30,31,04895,11.71875
"Overton village, Nebraska",271,227,44,31,37770,16.236162361623617
"Nemaha village, Nebraska",90,69,21,31,33950,23.333333333333332
"Thurston village, Nebraska",58,54,4,31,48900,6.896551724137931
"North Platte city, Nebraska",11467,10482,985,31,35000,8.589866573646116
"Neligh city, Nebraska",846,653,193,31,33775,22.81323877068558
"Bradshaw village, Nebraska",154,139,15,31,06050,9.740259740259742
"Lodgepole village, Nebraska",206,172,34,31,28420,16.50485436893204
"Republican City village, Nebraska",234,76,158,31,41130,67.52136752136752
"Palisade village, Nebraska",185,161,24,31,38130,12.972972972972974
"Thayer village, Nebraska",29,19,10,31,48690,34.48275862068966
"Ravenna city, Nebraska",699,600,99,31,40710,14.163090128755366
"Shelton village, Nebraska",505,464,41,31,44700,8.118811881188119
"Bertrand village, Nebraska",405,357,48,31,04615,11.851851851851853
"Madison city, Nebraska",823,733,90,31,30240,10.935601458080194
"Tilden city, Nebraska",472,448,24,31,48935,5.084745762711865
"Arcadia village, Nebraska",193,151,42,31,01850,21.761658031088082
"Bartlett village, Nebraska",77,73,4,31,03145,5.194805194805195
"Foster village, Nebraska",28,23,5,31,17320,17.857142857142858
"Blair city, Nebraska",3362,3204,158,31,05350,4.699583581201665
"Fort Calhoun city, Nebraska",414,405,9,31,17145,2.1739130434782608
"Butte village, Nebraska",190,148,42,31,07485,22.105263157894736
"Naper village, Nebraska",69,61,8,31,33530,11.594202898550725
"Belden village, Nebraska",71,49,22,31,03775,30.985915492957744
"Bloomington village, Nebraska",81,55,26,31,05490,32.098765432098766
"Franklin city, Nebraska",570,443,127,31,17530,22.280701754385966
"Riverton village, Nebraska",76,36,40,31,41760,52.63157894736842
"Halsey village, Nebraska",39,33,6,31,20680,15.384615384615385
"Duncan village, Nebraska",234,202,32,31,13890,13.675213675213676
"Monroe village, Nebraska",181,176,5,31,32585,2.7624309392265194
"Bassett city, Nebraska",414,343,71,31,03215,17.14975845410628
"Falls City city, Nebraska",2165,1947,218,31,16655,10.069284064665126
"Hardy village, Nebraska",73,69,4,31,20995,5.47945205479452
"Nora village, Nebraska",5,5,0,31,34545,0.0
"Belvidere village, Nebraska",34,17,17,31,04160,50.0
"Long Pine city, Nebraska",179,128,51,31,29050,28.49162011173184
"Melbeta village, Nebraska",54,49,5,31,31570,9.25925925925926
"Morrill village, Nebraska",461,384,77,31,32830,16.702819956616054
"Sholes village, Nebraska",16,12,4,31,45190,25.0
"Blue Hill city, Nebraska",439,401,38,31,05560,8.656036446469248
"Chambers village, Nebraska",177,153,24,31,08675,13.559322033898304
"Hordville village, Nebraska",67,57,10,31,23200,14.925373134328357
"Tecumseh city, Nebraska",910,761,149,31,48480,16.373626373626372
"Chalco CDP, Nebraska",4435,4337,98,31,08640,2.209695603156708
"Greenwood village, Nebraska",240,226,14,31,20190,5.833333333333333
"Manley village, Nebraska",60,55,5,31,30415,8.333333333333332
"Daykin village, Nebraska",93,92,1,31,12455,1.0752688172043012
"Burr village, Nebraska",41,20,21,31,07205,51.21951219512195
"Lorton village, Nebraska",19,9,10,31,29175,52.63157894736842
"Talmage village, Nebraska",99,88,11,31,48305,11.11111111111111
"Norfolk city, Nebraska",10821,10235,586,31,34615,5.415395989280103
"North Loup village, Nebraska",212,177,35,31,34825,16.50943396226415
"Gross village, Nebraska",0,0,0,31,20295,
"Randolph city, Nebraska",447,379,68,31,40675,15.212527964205815
"Howard City village, Nebraska",110,89,21,31,23270,19.090909090909093
"Potter village, Nebraska",178,157,21,31,39870,11.797752808988763
"Trenton village, Nebraska",381,237,144,31,49145,37.79527559055118
"Dannebrog village, Nebraska",165,142,23,31,12140,13.939393939393941
"Gresham village, Nebraska",130,99,31,31,20225,23.846153846153847
"McCool Junction village, Nebraska",180,151,29,31,29960,16.11111111111111
"Gibbon city, Nebraska",759,723,36,31,18615,4.743083003952568
"Anselmo village, Nebraska",95,81,14,31,01500,14.736842105263156
"Broken Bow city, Nebraska",1799,1626,173,31,06610,9.616453585325182
"Concord village, Nebraska",67,64,3,31,10250,4.477611940298507
"Alliance city, Nebraska",4040,3581,459,31,00905,11.361386138613861
"Eagle village, Nebraska",383,362,21,31,14100,5.483028720626632
"Beemer village, Nebraska",352,297,55,31,03635,15.625
"Davey village, Nebraska",68,68,0,31,12280,0.0
"Malcolm village, Nebraska",175,160,15,31,30345,8.571428571428571
"Panama village, Nebraska",95,95,0,31,38225,0.0
"Barneston village, Nebraska",57,53,4,31,03075,7.017543859649122
"Doniphan village, Nebraska",400,355,45,31,13365,11.25
"Red Cloud city, Nebraska",651,500,151,31,40920,23.195084485407065
"Alda village, Nebraska",296,274,22,31,00625,7.4324324324324325
"Cairo village, Nebraska",391,345,46,31,07625,11.76470588235294
"McGrew village, Nebraska",46,29,17,31,30030,36.95652173913043
"Minatare city, Nebraska",393,351,42,31,32305,10.687022900763358
"Leigh village, Nebraska",273,213,60,31,26560,21.978021978021978
"Chadron city, Nebraska",2589,2269,320,31,08605,12.359984550019313
"Aurora city, Nebraska",2044,1865,179,31,02690,8.7573385518591
"Bloomfield city, Nebraska",575,508,67,31,05455,11.652173913043478
"Wolbach village, Nebraska",158,118,40,31,53520,25.31645569620253
"Carleton village, Nebraska",49,42,7,31,07975,14.285714285714285
"Beatrice city, Nebraska",6269,5507,762,31,03390,12.155048652097623
"Tobias village, Nebraska",79,52,27,31,49005,34.177215189873415
"Staplehurst village, Nebraska",129,114,15,31,46835,11.627906976744185
"Chappell city, Nebraska",464,385,79,31,08885,17.025862068965516
"Center village, Nebraska",68,29,39,31,08360,57.35294117647059
"Hampton village, Nebraska",198,192,6,31,20785,3.0303030303030303
"Stockham village, Nebraska",15,15,0,31,47220,0.0
"Sterling village, Nebraska",264,214,50,31,47150,18.939393939393938
"Crofton city, Nebraska",398,371,27,31,11440,6.78391959798995
"Winnetoon village, Nebraska",54,28,26,31,53345,48.148148148148145
"Edgar city, Nebraska",244,177,67,31,14450,27.459016393442624
"Fairfield city, Nebraska",218,184,34,31,16445,15.59633027522936
"Gurley village, Nebraska",119,95,24,31,20435,20.168067226890756
"Wilber city, Nebraska",787,711,76,31,52960,9.6569250317662
"Pickrell village, Nebraska",94,90,4,31,39065,4.25531914893617
"Belgrade village, Nebraska",82,64,18,31,03810,21.951219512195124
"De Witt village, Nebraska",239,213,26,31,13015,10.87866108786611
"Seward city, Nebraska",2820,2628,192,31,44420,6.808510638297872
"Utica village, Nebraska",387,358,29,31,49915,7.493540051679587
"Central City city, Nebraska",1342,1205,137,31,08535,10.208643815201192
"Harrison village, Nebraska",184,144,40,31,21240,21.73913043478261
"Amherst village, Nebraska",101,84,17,31,01290,16.831683168316832
"Taylor village, Nebraska",115,88,27,31,48445,23.47826086956522
"Hallam village, Nebraska",88,88,0,31,20610,0.0
"Raymond village, Nebraska",76,76,0,31,40780,0.0
"Waverly city, Nebraska",1329,1259,70,31,51770,5.2671181339352895
"Howells village, Nebraska",303,282,21,31,23340,6.9306930693069315
"Fremont city, Nebraska",11714,10963,751,31,17670,6.4111319788287515
"Homer village, Nebraska",223,213,10,31,22920,4.484304932735426
"Winslow village, Nebraska",51,40,11,31,53415,21.568627450980394
"Giltner village, Nebraska",133,124,9,31,18825,6.7669172932330826
"Cook village, Nebraska",185,160,25,31,10390,13.513513513513514
"Verdel village, Nebraska",41,15,26,31,50335,63.41463414634146
"Venango village, Nebraska",103,88,15,31,50230,14.563106796116504
"Heartwell village, Nebraska",35,33,2,31,21835,5.714285714285714
"Fairbury city, Nebraska",1961,1673,288,31,16410,14.686384497705252
"Reynolds village, Nebraska",65,41,24,31,41235,36.92307692307693
"Craig village, Nebraska",91,77,14,31,11090,15.384615384615385
"Comstock village, Nebraska",95,58,37,31,10180,38.94736842105263
"Oconto village, Nebraska",82,76,6,31,35665,7.317073170731707
"Sargent city, Nebraska",373,281,92,31,43685,24.664879356568363
"Allen village, Nebraska",169,154,15,31,00870,8.875739644970414
"Syracuse city, Nebraska",1004,937,67,31,48235,6.673306772908366
"Octavia village, Nebraska",77,62,15,31,35700,19.480519480519483
"Kilgore village, Nebraska",41,28,13,31,25405,31.70731707317073
"Hildreth village, Nebraska",211,199,12,31,22430,5.687203791469194
"Lindsay village, Nebraska",140,137,3,31,28105,2.142857142857143
"Lebanon village, Nebraska",64,31,33,31,26455,51.5625
"Humboldt city, Nebraska",532,423,109,31,23445,20.48872180451128
"Preston village, Nebraska",17,14,3,31,40325,17.647058823529413
"Salem village, Nebraska",85,54,31,31,43370,36.470588235294116
"Funk village, Nebraska",96,96,0,31,17880,0.0
"Hastings city, Nebraska",11080,10149,931,31,21415,8.402527075812275
"Juniata village, Nebraska",319,293,26,31,24950,8.150470219435736
"Wymore city, Nebraska",730,592,138,31,53835,18.904109589041095
"Fullerton city, Nebraska",752,614,138,31,17810,18.351063829787233
"Elmwood village, Nebraska",289,281,8,31,15430,2.768166089965398
"Nehawka village, Nebraska",94,84,10,31,33740,10.638297872340425
"Union village, Nebraska",86,62,24,31,49635,27.906976744186046
"La Vista city, Nebraska",7186,6913,273,31,26385,3.7990537155580295
"Papillion city, Nebraska",7883,7671,212,31,38295,2.689331472789547
"Dixon village, Nebraska",67,60,7,31,13225,10.44776119402985
"Springfield city, Nebraska",599,587,12,31,46520,2.003338898163606
"Lyons city, Nebraska",503,427,76,31,29855,15.109343936381709
"Berwyn village, Nebraska",45,40,5,31,04650,11.11111111111111
"Rushville city, Nebraska",566,400,166,31,42775,29.328621908127207
"Crookston village, Nebraska",39,23,16,31,11475,41.02564102564102
"Axtell village, Nebraska",327,296,31,31,02830,9.480122324159021
"Wilcox village, Nebraska",162,152,10,31,52995,6.172839506172839
"Herman village, Nebraska",154,126,28,31,22185,18.181818181818183
"Deshler city, Nebraska",355,288,67,31,12840,18.87323943661972
"Ragan village, Nebraska",27,20,7,31,40570,25.925925925925924
"Benedict village, Nebraska",121,104,17,31,04195,14.049586776859504
"Henderson city, Nebraska",461,411,50,31,22080,10.84598698481562
"Battle Creek city, Nebraska",517,498,19,31,03250,3.67504835589942
"Elyria village, Nebraska",37,27,10,31,15605,27.027027027027028
"Primrose village, Nebraska",39,35,4,31,40360,10.256410256410255
"Maskell village, Nebraska",42,33,9,31,31045,21.428571428571427
"Avoca village, Nebraska",107,78,29,31,02795,27.102803738317753
"Murray village, Nebraska",240,216,24,31,33425,10.0
"South Bend village, Nebraska",53,45,8,31,45680,15.09433962264151
"Jansen village, Nebraska",75,57,18,31,24530,24.0
"Gretna city, Nebraska",1996,1865,131,31,20260,6.563126252505009
"Dunbar village, Nebraska",76,71,5,31,13855,6.578947368421052
"Bristow village, Nebraska",60,36,24,31,06400,40.0
"Spencer village, Nebraska",238,182,56,31,46275,23.52941176470588
"Upland village, Nebraska",89,73,16,31,49880,17.97752808988764
"Ord city, Nebraska",1238,1015,223,31,37280,18.012924071082388
"Lawrence village, Nebraska",189,169,20,31,26420,10.582010582010582
"Loomis village, Nebraska",180,175,5,31,29085,2.7777777777777777
"Kennard village, Nebraska",177,172,5,31,25230,2.824858757062147
"Rulo village, Nebraska",103,80,23,31,42670,22.330097087378643
"Holstein village, Nebraska",118,113,5,31,22815,4.23728813559322
"Culbertson village, Nebraska",278,229,49,31,11615,17.62589928057554
"Polk village, Nebraska",208,144,64,31,39660,30.76923076923077
"Maywood village, Nebraska",169,145,24,31,31325,14.201183431952662
"Adams village, Nebraska",218,209,9,31,00240,4.128440366972478
"Cortland village, Nebraska",225,183,42,31,10635,18.666666666666668
"Filley village, Nebraska",70,62,8,31,16830,11.428571428571429
"Bee village, Nebraska",123,113,10,31,03600,8.130081300813007
"Hemingford village, Nebraska",451,356,95,31,22045,21.06430155210643
"Weeping Water city, Nebraska",505,452,53,31,52015,10.495049504950495
"Elwood village, Nebraska",361,333,28,31,15570,7.756232686980609
"Decatur village, Nebraska",260,199,61,31,12525,23.46153846153846
"Callaway village, Nebraska",334,296,38,31,07660,11.377245508982035
"Mason City village, Nebraska",108,96,12,31,31115,11.11111111111111
"Ponca city, Nebraska",468,447,21,31,39695,4.487179487179487
"Bruno village, Nebraska",64,45,19,31,06855,29.6875
"Chapman village, Nebraska",142,120,22,31,08780,15.492957746478872
"Cody village, Nebraska",92,88,4,31,09760,4.3478260869565215
"Gandy village, Nebraska",27,22,5,31,17950,18.51851851851852
"Genoa city, Nebraska",518,482,36,31,18475,6.94980694980695
"Garland village, Nebraska",107,94,13,31,18230,12.149532710280374
"Goehner village, Nebraska",62,53,9,31,19245,14.516129032258066
"Alvo village, Nebraska",56,52,4,31,01150,7.142857142857142
"Plattsmouth city, Nebraska",2865,2633,232,31,39345,8.097731239092495
"Grant city, Nebraska",658,573,85,31,19910,12.917933130699089
"Douglas village, Nebraska",110,71,39,31,13505,35.45454545454545
"Richland village, Nebraska",60,48,12,31,41375,20.0
"Nebraska City city, Nebraska",3281,2982,299,31,33705,9.113075281926243
"Palmyra village, Nebraska",270,244,26,31,38190,9.62962962962963
"Unadilla village, Nebraska",129,122,7,31,49530,5.426356589147287
"Brunswick village, Nebraska",87,85,2,31,06890,2.2988505747126435
"Geneva city, Nebraska",1026,893,133,31,18405,12.962962962962962
"Page village, Nebraska",109,86,23,31,38085,21.100917431192663
"Rogers village, Nebraska",56,44,12,31,42145,21.428571428571427
"Brewster village, Nebraska",19,5,14,31,06260,73.68421052631578
"Brule village, Nebraska",212,185,27,31,06785,12.735849056603774
"Ogallala city, Nebraska",2381,2278,103,31,35980,4.325913481730366
"Paxton village, Nebraska",249,219,30,31,38610,12.048192771084338
"Stapleton village, Nebraska",155,138,17,31,46870,10.967741935483872
"Scribner city, Nebraska",410,367,43,31,44280,10.487804878048781
"Uehling village, Nebraska",148,108,40,31,49425,27.027027027027028
"Crab Orchard village, Nebraska",29,29,0,31,11055,0.0
"Creighton city, Nebraska",640,554,86,31,11230,13.4375
"Rockville village, Nebraska",64,48,16,31,42075,25.0
"Ashland city, Nebraska",1091,982,109,31,02305,9.99083409715857
"Ceresco village, Nebraska",438,413,25,31,08570,5.707762557077626
"Weston village, Nebraska",147,121,26,31,52540,17.687074829931973
"Sutton city, Nebraska",705,652,53,31,47955,7.5177304964539005
"St. Paul city, Nebraska",1178,1063,115,31,43265,9.762308998302208
"Nickerson village, Nebraska",152,123,29,31,34300,19.078947368421055
"Blue Springs city, Nebraska",165,113,52,31,05630,31.515151515151512
"Swanton village, Nebraska",50,31,19,31,48060,38.0
"Dakota City city, Nebraska",727,704,23,31,12000,3.1636863823933976
"Greeley Center village, Nebraska",230,184,46,31,20050,20.0
"Scotia village, Nebraska",165,133,32,31,44070,19.393939393939394
"Alexandria village, Nebraska",106,76,30,31,00730,28.30188679245283
"Smithfield village, Nebraska",36,18,18,31,45575,50.0
"Otoe village, Nebraska",141,97,44,31,37630,31.20567375886525
"Fordyce village, Nebraska",56,53,3,31,17110,5.357142857142857
"Bancroft village, Nebraska",244,212,32,31,03005,13.114754098360656
"Dorchester village, Nebraska",322,266,56,31,13435,17.391304347826086
"Tekamah city, Nebraska",932,820,112,31,48515,12.017167381974248
"David City city, Nebraska",1407,1256,151,31,12315,10.732054015636106
"Cordova village, Nebraska",69,43,26,31,10495,37.68115942028986
"Offutt AFB CDP, Nebraska",1942,1745,197,31,35875,10.144181256436664
"Virginia village, Nebraska",33,29,4,31,50790,12.121212121212121
"Shelby village, Nebraska",314,294,20,31,44595,6.369426751592357
"Wisner city, Nebraska",576,527,49,31,53450,8.506944444444445
"Western village, Nebraska",146,126,20,31,52295,13.698630136986301
"Elsie village, Nebraska",64,53,11,31,15500,17.1875
"Roca village, Nebraska",90,85,5,31,41830,5.555555555555555
"Inglewood village, Nebraska",142,139,3,31,23970,2.112676056338028
"Morse Bluff village, Nebraska",58,56,2,31,32865,3.4482758620689653
"Oak village, Nebraska",58,28,30,31,35245,51.724137931034484
"Magnet village, Nebraska",36,26,10,31,30310,27.77777777777778
"Barada village, Nebraska",10,4,6,31,03040,60.0
"Burwell city, Nebraska",718,563,155,31,07345,21.58774373259053
"Jackson village, Nebraska",86,80,6,31,24355,6.976744186046512
"Bladen village, Nebraska",92,72,20,31,05140,21.73913043478261
"West Point city, Nebraska",1576,1377,199,31,52575,12.626903553299492
"Friend city, Nebraska",450,395,55,31,17775,12.222222222222221
"Verdigre village, Nebraska",294,268,26,31,50370,8.843537414965986
"Pawnee City city, Nebraska",578,469,109,31,38575,18.858131487889274
"Elk Creek village, Nebraska",81,71,10,31,14975,12.345679012345679
"Guide Rock village, Nebraska",122,90,32,31,20365,26.229508196721312
"Hayes Center village, Nebraska",167,137,30,31,21660,17.964071856287426
"Fairmont village, Nebraska",331,266,65,31,16550,19.637462235649547
"Strang village, Nebraska",13,11,2,31,47360,15.384615384615385
"Waterloo village, Nebraska",387,369,18,31,51665,4.651162790697675
"Stanton city, Nebraska",735,640,95,31,46800,12.925170068027212
"Wood Lake village, Nebraska",53,29,24,31,53555,45.28301886792453
"Endicott village, Nebraska",64,64,0,31,15920,0.0
"Anoka village, Nebraska",4,4,0,31,01465,0.0
"Creston village, Nebraska",97,82,15,31,11300,15.463917525773196
"Meadow Grove village, Nebraska",156,139,17,31,31465,10.897435897435898
"Wahoo city, Nebraska",1905,1781,124,31,50965,6.509186351706036
"Litchfield village, Nebraska",161,135,26,31,28350,16.149068322981368
"Trumbull village, Nebraska",98,83,15,31,49285,15.306122448979592
"Ericson village, Nebraska",87,71,16,31,16025,18.39080459770115
"Julian village, Nebraska",43,26,17,31,24915,39.53488372093023
"Grand Island city, Nebraska",20362,19049,1313,31,19595,6.44828602298399
"Steinauer village, Nebraska",44,37,7,31,47080,15.909090909090908
"Lushton village, Nebraska",20,17,3,31,29645,15.0
"Stuart village, Nebraska",363,311,52,31,47500,14.325068870523417
"Hershey village, Nebraska",288,243,45,31,22290,15.625
"Hyannis village, Nebraska",142,105,37,31,23655,26.056338028169012
"Surprise village, Nebraska",48,38,10,31,47850,20.833333333333336
"Grafton village, Nebraska",72,64,8,31,19455,11.11111111111111
"Lyman village, Nebraska",157,135,22,31,29715,14.012738853503185
"Scottsbluff city, Nebraska",6675,6080,595,31,44245,8.913857677902621
"Shickley village, Nebraska",173,147,26,31,45085,15.028901734104046
"Atkinson city, Nebraska",685,597,88,31,02550,12.846715328467154
"O'Neill city, Nebraska",1733,1564,169,31,37105,9.751875360646277
"Cambridge city, Nebraska",675,599,76,31,07730,11.25925925925926
"Wilsonville village, Nebraska",77,36,41,31,53240,53.246753246753244
"Broadwater village, Nebraska",111,66,45,31,06470,40.54054054054054
"Brock village, Nebraska",73,62,11,31,06505,15.068493150684931
"Johnson village, Nebraska",172,147,25,31,24670,14.534883720930234
"Peru city, Nebraska",276,240,36,31,38960,13.043478260869565
"Winnebago village, Nebraska",247,207,40,31,53275,16.194331983805668
"Valley city, Nebraska",1342,1228,114,31,50020,8.49478390461997
"Sutherland village, Nebraska",676,622,54,31,47920,7.988165680473373
"Bunkerville CDP, Nevada",351,329,22,32,08100,6.267806267806268
"Mount Charleston CDP, Nevada",365,195,170,32,49310,46.57534246575342
"Beatty CDP, Nevada",664,417,247,32,05100,37.1987951807229
"Gardnerville CDP, Nevada",2842,2738,104,32,26300,3.6593947923997185
"Cold Springs CDP, Nevada",3344,3192,152,32,14090,4.545454545454546
"Boulder City city, Nevada",7787,6481,1306,32,06500,16.771542314113265
"Goodsprings CDP, Nevada",43,43,0,32,29500,0.0
"Henderson city, Nevada",127559,113901,13658,32,31900,10.70720215743303
"Laughlin CDP, Nevada",5624,3837,1787,32,41000,31.774537695590325
"Mesquite city, Nevada",9856,7889,1967,32,46000,19.957386363636363
"Carlin city, Nevada",1012,689,323,32,08900,31.91699604743083
"Spring Creek CDP, Nevada",5037,4572,465,32,68550,9.231685527099463
"Wells city, Nevada",692,482,210,32,83000,30.346820809248555
"Pahrump CDP, Nevada",17776,15345,2431,32,53800,13.675742574257427
"Spanish Springs CDP, Nevada",6033,5845,188,32,68350,3.116194264876513
"Blue Diamond CDP, Nevada",158,120,38,32,05700,24.050632911392405
"Nellis AFB CDP, Nevada",1028,907,121,32,50400,11.770428015564201
"McGill CDP, Nevada",673,491,182,32,44200,27.043090638930163
"Wadsworth CDP, Nevada",333,303,30,32,81000,9.00900900900901
"West Wendover city, Nevada",1588,1307,281,32,83730,17.69521410579345
"Winchester CDP, Nevada",14992,11526,3466,32,84600,23.118996798292425
"Sutcliffe CDP, Nevada",114,95,19,32,71800,16.666666666666664
"Moapa Valley CDP, Nevada",2944,2299,645,32,47880,21.908967391304348
"Ely city, Nevada",2100,1736,364,32,23500,17.333333333333336
"Elko city, Nevada",7992,6932,1060,32,22500,13.263263263263264
"Las Vegas city, Nevada",255611,226396,29215,32,40000,11.429476822202487
"Fallon Station CDP, Nevada",261,217,44,32,24500,16.85823754789272
"Nixon CDP, Nevada",142,118,24,32,51200,16.901408450704224
"Sparks city, Nevada",40441,38056,2385,32,68400,5.897480279913949
"Paradise CDP, Nevada",113716,90360,23356,32,54600,20.538886348447008
"Sunrise Manor CDP, Nevada",71084,62620,8464,32,71400,11.907039558831805
"Smith Valley CDP, Nevada",800,672,128,32,68050,16.0
"Schurz CDP, Nevada",455,396,59,32,65400,12.967032967032969
"Reno city, Nevada",106663,98844,7819,32,60600,7.33056448815428
"Sun Valley CDP, Nevada",6938,6524,414,32,71600,5.967137503603344
"Cal-Nev-Ari CDP, Nevada",142,85,57,32,08600,40.140845070422536
"North Las Vegas city, Nevada",79551,72532,7019,32,51800,8.823270606277733
"Johnson Lane CDP, Nevada",2654,2616,38,32,37190,1.4318010550113038
"Searchlight CDP, Nevada",368,177,191,32,65600,51.902173913043484
"Moapa Town CDP, Nevada",331,213,118,32,47840,35.64954682779456
"Gardnerville Ranchos CDP, Nevada",4739,4604,135,32,26500,2.848702257860308
"Sandy Valley CDP, Nevada",1023,642,381,32,64600,37.24340175953079
"Enterprise CDP, Nevada",64430,55100,9330,32,23770,14.480831910600653
"Fernley city, Nevada",7838,7165,673,32,24900,8.586374075019137
"Alamo CDP, Nevada",549,419,130,32,00500,23.67941712204007
"Austin CDP, Nevada",211,105,106,32,03700,50.23696682464455
"Baker CDP, Nevada",29,29,0,32,04100,0.0
"Beaverdam CDP, Nevada",22,22,0,32,05125,0.0
"Bennett Springs CDP, Nevada",117,101,16,32,05275,13.675213675213676
"Carter Springs CDP, Nevada",271,231,40,32,10200,14.760147601476014
"Crescent Valley CDP, Nevada",292,214,78,32,16300,26.71232876712329
"Crystal Bay CDP, Nevada",223,69,154,32,16700,69.05829596412556
"Denio CDP, Nevada",15,15,0,32,18500,0.0
"Double Spring CDP, Nevada",95,95,0,32,19150,0.0
"Dry Valley CDP, Nevada",15,15,0,32,19800,0.0
"Dyer CDP, Nevada",208,116,92,32,20700,44.230769230769226
"East Valley CDP, Nevada",671,628,43,32,21520,6.4083457526080485
"Empire CDP, Nevada",108,55,53,32,23700,49.074074074074076
"Eureka CDP, Nevada",413,266,147,32,23900,35.59322033898305
"Fish Springs CDP, Nevada",224,213,11,32,25000,4.910714285714286
"Fort McDermitt CDP, Nevada",153,110,43,32,25490,28.104575163398692
"Gabbs CDP, Nevada",111,111,0,32,25900,0.0
"Genoa CDP, Nevada",461,285,176,32,27100,38.17787418655097
"Gerlach CDP, Nevada",104,74,30,32,27300,28.846153846153843
"Glenbrook CDP, Nevada",387,80,307,32,27900,79.32816537467701
"Golconda CDP, Nevada",84,61,23,32,28500,27.380952380952383
"Golden Valley CDP, Nevada",536,536,0,32,28860,0.0
"Goldfield CDP, Nevada",308,165,143,32,28900,46.42857142857143
"Grass Valley CDP, Nevada",431,310,121,32,30220,28.074245939675173
"Hiko CDP, Nevada",42,42,0,32,32900,0.0
"Humboldt River Ranch CDP, Nevada",153,108,45,32,34100,29.411764705882355
"Imlay CDP, Nevada",45,45,0,32,34700,0.0
"Incline Village CDP, Nevada",7708,3736,3972,32,35100,51.53087701089777
"Jackpot CDP, Nevada",667,521,146,32,36500,21.88905547226387
"Kingston CDP, Nevada",49,49,0,32,38100,0.0
"Lakeridge CDP, Nevada",365,158,207,32,39100,56.71232876712329
"Lund CDP, Nevada",75,32,43,32,43400,57.333333333333336
"Lamoille CDP, Nevada",155,96,59,32,39300,38.064516129032256
"Lemmon Valley CDP, Nevada",2072,2010,62,32,41800,2.9922779922779923
"Logan Creek CDP, Nevada",50,31,19,32,42350,38.0
"Mina CDP, Nevada",99,56,43,32,46800,43.43434343434344
"Mogul CDP, Nevada",799,758,41,32,48000,5.131414267834793
"Montello CDP, Nevada",67,40,27,32,48400,40.298507462686565
"Mount Wilson CDP, Nevada",59,0,59,32,49425,100.0
"Nelson CDP, Nevada",20,20,0,32,50600,0.0
"Oasis CDP, Nevada",29,16,13,32,52200,44.827586206896555
"Orovada CDP, Nevada",49,28,21,32,53000,42.857142857142854
"Osino CDP, Nevada",283,224,59,32,53200,20.848056537102476
"Panaca CDP, Nevada",533,427,106,32,54200,19.887429643527206
"Paradise Valley CDP, Nevada",141,38,103,32,55400,73.04964539007092
"Pioche CDP, Nevada",618,413,205,32,57400,33.17152103559871
"Preston CDP, Nevada",17,17,0,32,58000,0.0
"Rachel CDP, Nevada",32,32,0,32,58820,0.0
"Round Hill Village CDP, Nevada",821,373,448,32,62170,54.56760048721072
"Ruhenstroth CDP, Nevada",590,581,9,32,63450,1.5254237288135595
"Ruth CDP, Nevada",184,78,106,32,63800,57.608695652173914
"Silver Peak CDP, Nevada",135,74,61,32,67000,45.18518518518518
"Skyland CDP, Nevada",197,113,84,32,67600,42.63959390862944
"Stagecoach CDP, Nevada",906,729,177,32,68800,19.5364238410596
"Topaz Lake CDP, Nevada",135,107,28,32,74200,20.74074074074074
"Topaz Ranch Estates CDP, Nevada",847,732,115,32,74400,13.57733175914994
"Ursine CDP, Nevada",39,7,32,32,77200,82.05128205128204
"Valmy CDP, Nevada",64,49,15,32,78200,23.4375
"Verdi CDP, Nevada",644,608,36,32,79400,5.590062111801243
"Virginia City CDP, Nevada",388,259,129,32,80000,33.24742268041237
"Washoe Valley CDP, Nevada",1342,1342,0,32,82250,0.0
"Zephyr Cove CDP, Nevada",671,261,410,32,86200,61.10283159463488
"Walker Lake CDP, Nevada",257,167,90,32,81100,35.019455252918284
"Silver City CDP, Nevada",75,75,0,32,66800,0.0
"Unionville CDP, Nevada",16,0,16,32,76400,100.0
"Tonopah CDP, Nevada",1567,1118,449,32,73600,28.65347798340779
"Owyhee CDP, Nevada",510,418,92,32,53600,18.03921568627451
"Hawthorne CDP, Nevada",1851,1202,649,32,31300,35.0621285791464
"Caliente city, Nevada",553,449,104,32,08500,18.806509945750452
"Indian Hills CDP, Nevada",2418,2378,40,32,35275,1.6542597187758479
"Winnemucca city, Nevada",3323,2981,342,32,84800,10.29190490520614
"Indian Springs CDP, Nevada",423,338,85,32,35300,20.094562647754138
"Spring Valley CDP, Nevada",87715,74521,13194,32,68585,15.041897052955594
"Summerlin South CDP, Nevada",13126,11494,1632,32,70900,12.433338412311443
"Whitney CDP, Nevada",17448,14861,2587,32,83800,14.826914259513984
"Silver Springs CDP, Nevada",2397,1906,491,32,67200,20.483938256153525
"Minden CDP, Nevada",1662,1466,196,32,47000,11.793020457280386
"Red River town, New Mexico",785,170,615,35,62200,78.343949044586
"Taos town, New Mexico",3679,2577,1102,35,76200,29.953791791247617
"Santa Clara village, New Mexico",756,609,147,35,70270,19.444444444444446
"Lake Arthur town, New Mexico",162,133,29,35,37840,17.901234567901234
"Boles Acres CDP, New Mexico",1001,777,224,35,08440,22.377622377622377
"House village, New Mexico",43,21,22,35,33710,51.162790697674424
"Cundiyo CDP, New Mexico",26,26,0,35,19500,0.0
"Glorieta CDP, New Mexico",288,202,86,35,29860,29.86111111111111
"South Valley CDP, New Mexico",15905,14031,1874,35,74520,11.78245834643194
"Aztec city, New Mexico",2819,2432,387,35,05780,13.72827243703441
"Beclabito CDP, New Mexico",116,86,30,35,06425,25.862068965517242
"Newcomb CDP, New Mexico",176,123,53,35,51770,30.113636363636363
"Cochiti CDP, New Mexico",160,128,32,35,16560,20.0
"Upper Fruitland CDP, New Mexico",553,463,90,35,81177,16.2748643761302
"Encino village, New Mexico",109,43,66,35,24610,60.550458715596335
"Algodones CDP, New Mexico",345,326,19,35,02210,5.507246376811594
"Corrales village, New Mexico",4044,3699,345,35,17960,8.531157270029674
"Truth or Consequences city, New Mexico",3961,2893,1068,35,79840,26.96288815955567
"Bayard city, New Mexico",1215,947,268,35,06270,22.05761316872428
"Columbus village, New Mexico",738,454,284,35,17050,38.482384823848236
"Timberon CDP, New Mexico",658,221,437,35,77950,66.41337386018236
"San Jon village, New Mexico",88,61,27,35,68150,30.681818181818183
"Ramah CDP, New Mexico",186,108,78,35,61220,41.935483870967744
"Twin Lakes CDP, New Mexico",320,247,73,35,80540,22.8125
"Carrizozo town, New Mexico",545,328,217,35,12500,39.816513761467895
"Eunice city, New Mexico",1243,984,259,35,25450,20.836685438455348
"Cuba village, New Mexico",347,279,68,35,19150,19.596541786743515
"Jemez Pueblo CDP, New Mexico",474,426,48,35,35250,10.126582278481013
"Pueblo of Sandia Village CDP, New Mexico",146,136,10,35,59950,6.8493150684931505
"Regina CDP, New Mexico",111,15,96,35,62340,86.48648648648648
"San Felipe Pueblo CDP, New Mexico",496,425,71,35,67450,14.31451612903226
"Torreon CDP (Sandoval County), New Mexico",76,52,24,35,79070,31.57894736842105
"Manzano CDP, New Mexico",15,0,15,35,46730,100.0
"Tajique CDP, New Mexico",48,48,0,35,76060,0.0
"Des Moines village, New Mexico",84,38,46,35,20480,54.761904761904766
"Folsom village, New Mexico",42,11,31,35,26780,73.80952380952381
"Bosque Farms village, New Mexico",1559,1470,89,35,08580,5.708787684413085
"Jarales CDP, New Mexico",1006,784,222,35,35110,22.067594433399602
"Cloudcroft village, New Mexico",1064,259,805,35,16280,75.6578947368421
"Nakaibito CDP, New Mexico",134,104,30,35,50860,22.388059701492537
"Santa Clara Pueblo CDP, New Mexico",417,220,197,35,70390,47.24220623501199
"Deming city, New Mexico",6380,5402,978,35,20270,15.329153605015675
"La Luz CDP, New Mexico",688,657,31,35,38330,4.505813953488372
"Navajo CDP, New Mexico",537,369,168,35,51420,31.28491620111732
"Alcalde CDP, New Mexico",150,69,81,35,02070,54.0
"Pecos village, New Mexico",872,725,147,35,55620,16.857798165137613
"Ojo Amarillo CDP, New Mexico",191,179,12,35,53485,6.282722513089005
"Ruidoso village, New Mexico",8707,3239,5468,35,65210,62.800045940048236
"Los Lunas village, New Mexico",6285,5618,667,35,43370,10.612569610182977
"White Rock CDP, New Mexico",2299,2154,145,35,84740,6.307090039147456
"Galisteo CDP, New Mexico",179,148,31,35,27970,17.318435754189945
"Santa Cruz CDP, New Mexico",159,120,39,35,70460,24.528301886792452
"Cimarron village, New Mexico",556,450,106,35,15440,19.06474820143885
"Radium Springs CDP, New Mexico",718,627,91,35,61010,12.674094707520892
"Capitan village, New Mexico",785,521,264,35,11800,33.63057324840764
"Sombrillo CDP, New Mexico",134,95,39,35,73890,29.1044776119403
"Eagle Nest village, New Mexico",348,143,205,35,22020,58.90804597701149
"La Cienega CDP, New Mexico",1258,1202,56,35,36720,4.451510333863275
"Rock Springs CDP, New Mexico",140,105,35,35,64230,25.0
"Yah-ta-hey CDP, New Mexico",180,166,14,35,85860,7.777777777777778
"Lindenwold borough, New Jersey",8449,7475,974,34,40440,11.527991478281454
"Somerdale borough, New Jersey",2384,2146,238,34,68340,9.983221476510067
"Woodlynne borough, New Jersey",901,790,111,34,82450,12.319644839067703
"Bergenfield borough, New Jersey",9011,8760,251,34,05170,2.785484407945844
"Carlstadt borough, New Jersey",2539,2321,218,34,10480,8.586057502953919
"Cliffside Park borough, New Jersey",11300,10535,765,34,13570,6.769911504424779
"Trenton city, New Jersey",34529,27401,7128,34,74000,20.643517043644472
"Leonardo CDP, New Jersey",1037,1009,28,34,39990,2.700096432015429
"Asbury Park city, New Jersey",8231,6721,1510,34,01960,18.345280038877416
"Atlantic Highlands borough, New Jersey",1942,1719,223,34,02110,11.483007209062821
"Fairview CDP, New Jersey",1299,1254,45,34,22740,3.4642032332563506
"Monmouth Beach borough, New Jersey",1957,1419,538,34,47130,27.491057741440983
"Neptune City borough, New Jersey",2266,2117,149,34,49920,6.575463371579876
"Ramtown CDP, New Jersey",1982,1917,65,34,61725,3.279515640766902
"Vernon Valley CDP, New Jersey",610,593,17,34,75750,2.7868852459016393
"Fanwood borough, New Jersey",2607,2544,63,34,22860,2.4165707710011506
"Linden city, New Jersey",15678,14434,1244,34,40350,7.934685546625846
"Presidential Lakes Estates CDP, New Jersey",764,685,79,34,60840,10.340314136125654
"Ramblewood CDP, New Jersey",2345,2179,166,34,61650,7.0788912579957355
"Morristown town, New Jersey",8954,8156,798,34,48300,8.912218003127094
"Crandon Lakes CDP, New Jersey",532,443,89,34,15610,16.729323308270676
"Cape May city, New Jersey",4242,1404,2838,34,10270,66.9024045261669
"Madison borough, New Jersey",5643,5456,187,34,42510,3.313840155945419
"Mendham borough, New Jersey",1876,1824,52,34,45330,2.771855010660981
"Morris Plains borough, New Jersey",2245,2108,137,34,48210,6.102449888641425
"Diamond Beach CDP, New Jersey",908,109,799,34,17815,87.99559471365639
"North Wildwood city, New Jersey",8830,1986,6844,34,53490,77.50849377123443
"Alloway CDP, New Jersey",574,518,56,34,00850,9.75609756097561
"Penns Grove borough, New Jersey",2167,1820,347,34,57750,16.01292108906322
"Lawrenceville CDP, New Jersey",1730,1714,16,34,39570,0.9248554913294799
"Paterson city, New Jersey",49713,44748,4965,34,57000,9.987327258463582
"Beachwood borough, New Jersey",3971,3766,205,34,04180,5.16242760010073
"Yorketown CDP, New Jersey",2048,1998,50,34,83245,2.44140625
"Branchville borough, New Jersey",374,324,50,34,07300,13.368983957219251
"Lake Mohawk CDP, New Jersey",3969,3569,400,34,38040,10.078105316200554
"Newton town, New Jersey",3828,3281,547,34,51930,14.289446185997909
"Sussex borough, New Jersey",978,781,197,34,71670,20.143149284253578
"Rahway city, New Jersey",12120,11188,932,34,61530,7.68976897689769
"Essex Fells borough, New Jersey",853,790,63,34,21840,7.38569753810082
"North Caldwell borough, New Jersey",2401,2385,16,34,52620,0.6663890045814245
"Rockaway borough, New Jersey",2588,2443,145,34,64050,5.602782071097372
"Ocean City city, New Jersey",20082,5262,14820,34,54360,73.79743053480729
"West Cape May borough, New Jersey",1141,480,661,34,78530,57.93163891323401
"Salem city, New Jersey",2684,1940,744,34,65490,27.719821162444113
"Moorestown-Lenola CDP, New Jersey",5411,5046,365,34,47895,6.745518388467936
"Budd Lake CDP, New Jersey",3744,3614,130,34,08620,3.4722222222222223
"Butler borough, New Jersey",3011,2920,91,34,09040,3.022251743606775
"Long Valley CDP, New Jersey",693,608,85,34,41400,12.265512265512266
"Wharton borough, New Jersey",2545,2339,206,34,80390,8.094302554027506
"North Cape May CDP, New Jersey",2162,1302,860,34,52650,39.77798334875116
"Wildwood city, New Jersey",7169,2367,4802,34,81170,66.98284279536895
"Woodstown borough, New Jersey",1566,1321,245,34,82720,15.644955300127714
"Cape May Point borough, New Jersey",610,99,511,34,10330,83.77049180327869
"Erma CDP, New Jersey",965,845,120,34,21660,12.435233160621761
"Ocean Acres CDP, New Jersey",6318,5823,495,34,54315,7.834757834757834
"Rio Grande CDP, New Jersey",1724,1190,534,34,63180,30.97447795823666
"West Wildwood borough, New Jersey",863,204,659,34,80210,76.36152954808807
"Prospect Park borough, New Jersey",1809,1619,190,34,61170,10.503040353786622
"Totowa borough, New Jersey",3527,3460,67,34,73140,1.8996314148001132
"White Sands CDP, New Mexico",450,256,194,35,84845,43.111111111111114
"Acomita Lake CDP, New Mexico",119,109,10,35,00765,8.403361344537815
"Jal city, New Mexico",919,722,197,35,35040,21.436343852013056
"Brimhall Nizhoni CDP, New Mexico",114,80,34,35,09035,29.82456140350877
"Moriarty city, New Mexico",1015,846,169,35,50160,16.65024630541872
"Rio en Medio CDP, New Mexico",94,87,7,35,63168,7.446808510638298
"Nenahnezad CDP, New Mexico",227,170,57,35,51715,25.11013215859031
"Zuni Pueblo CDP, New Mexico",1682,1440,242,35,86595,14.387633769322235
"Pueblo Pintado CDP, New Mexico",105,69,36,35,60000,34.285714285714285
"Thoreau CDP, New Mexico",575,479,96,35,77530,16.695652173913047
"Casa Colorada CDP, New Mexico",40,28,12,35,12786,30.0
"Ranchos de Taos CDP, New Mexico",1017,735,282,35,61710,27.728613569321535
"Santa Rosa city, New Mexico",1494,954,540,35,70670,36.144578313253014
"Mesita CDP, New Mexico",247,231,16,35,48200,6.477732793522267
"North Acomita Village CDP, New Mexico",131,82,49,35,52300,37.404580152671755
"Mesilla town, New Mexico",1076,915,161,35,48060,14.96282527881041
"Hobbs city, New Mexico",13871,11729,2142,35,32520,15.442289669093793
"Elida town, New Mexico",111,86,25,35,23000,22.52252252252252
"Ponderosa CDP, New Mexico",140,102,38,35,58980,27.142857142857142
"Santo Domingo Pueblo CDP, New Mexico",492,420,72,35,70810,14.634146341463413
"Clayton town, New Mexico",1339,933,406,35,15720,30.32113517550411
"Chupadero CDP, New Mexico",191,110,81,35,15300,42.40837696335078
"Eldorado at Santa Fe CDP, New Mexico",3102,2971,131,35,22625,4.223081882656351
"Pecan Park CDP, New Mexico",0,0,0,35,55605,
"Pie Town CDP, New Mexico",222,28,194,35,56950,87.38738738738738
"Pinon CDP, New Mexico",0,0,0,35,57440,
"Pinos Altos CDP, New Mexico",250,224,26,35,57510,10.4
"Placitas CDP (Do�a Ana County), New Mexico",278,278,0,35,57990,0.0
"Placitas CDP (Sandoval County), New Mexico",2582,2229,353,35,58070,13.67157242447715
"Playas CDP, New Mexico",78,0,78,35,58210,100.0
"Pleasanton CDP, New Mexico",142,109,33,35,58420,23.239436619718308
"Polvadera CDP, New Mexico",148,121,27,35,58910,18.243243243243242
"Ponderosa Pine CDP, New Mexico",632,523,109,35,59120,17.246835443037973
"Pueblito CDP, New Mexico",27,21,6,35,59750,22.22222222222222
"Pueblitos CDP, New Mexico",227,193,34,35,59820,14.977973568281937
"La Puebla CDP, New Mexico",666,416,250,35,39170,37.53753753753754
"Santa Fe city, New Mexico",41632,35593,6039,35,70500,14.505668716372021
"Magdalena village, New Mexico",511,231,280,35,46310,54.794520547945204
"Grady village, New Mexico",58,48,10,35,30210,17.24137931034483
"Melrose village, New Mexico",389,269,120,35,47570,30.848329048843187
"Texico city, New Mexico",415,338,77,35,77250,18.55421686746988
"Chilili CDP, New Mexico",49,49,0,35,14880,0.0
"Crystal CDP, New Mexico",122,100,22,35,19080,18.0327868852459
"Sheep Springs CDP, New Mexico",97,69,28,35,72600,28.865979381443296
"Cedar Grove CDP, New Mexico",340,261,79,35,13270,23.235294117647058
"Cuyamungue CDP, New Mexico",230,184,46,35,19640,20.0
"El Valle de Arroyo Seco CDP, New Mexico",692,554,138,35,24347,19.942196531791907
"Reserve village, New Mexico",324,173,151,35,62620,46.60493827160494
"Sanostee CDP, New Mexico",190,136,54,35,69620,28.421052631578945
"North Valley CDP, New Mexico",5158,4846,312,35,52750,6.048856145792943
"Fort Sumner village, New Mexico",606,411,195,35,27340,32.17821782178218
"Lake Sumner CDP, New Mexico",137,58,79,35,37875,57.66423357664233
"Maxwell village, New Mexico",173,103,70,35,47080,40.46242774566474
"Milan village, New Mexico",1410,1263,147,35,48620,10.425531914893616
"Pinehill CDP, New Mexico",39,23,16,35,57190,41.02564102564102
"University Park CDP, New Mexico",618,387,231,35,81030,37.37864077669903
"Sunland Park city, New Mexico",5256,4881,375,35,75640,7.134703196347032
"Clovis city, New Mexico",16730,14871,1859,35,16420,11.111775254034669
"Elizabeth city, New Jersey",44428,40394,4034,34,21000,9.079859548032772
"Angel Fire village, New Mexico",2566,370,2196,35,03400,85.58067030397505
"Encinal CDP, New Mexico",84,64,20,35,24540,23.809523809523807
"Plainfield city, New Jersey",16625,15338,1287,34,59190,7.741353383458646
"Kenilworth borough, New Jersey",2989,2828,161,34,36690,5.386416861826698
"Seabrook Farms CDP, New Jersey",648,648,0,34,66300,0.0
"Roseland borough, New Jersey",2491,2341,150,34,64590,6.02167804094741
"McGuire AFB CDP, New Jersey",1505,1403,102,34,42390,6.777408637873754
"East Orange city, New Jersey",28105,23608,4497,34,19390,16.000711617149975
"Pomona CDP, New Jersey",2355,2249,106,34,60030,4.501061571125265
"Phillipsburg town, New Jersey",6824,5795,1029,34,58350,15.079132473622508
"Society Hill CDP, New Jersey",1156,1103,53,34,68304,4.58477508650519
"Dover town, New Jersey",5939,5445,494,34,18070,8.317898636134029
"Browns Mills CDP, New Jersey",4343,3835,508,34,08455,11.696983651853557
"Audubon borough, New Jersey",3660,3489,171,34,02200,4.672131147540984
"Swedesboro borough, New Jersey",1017,899,118,34,71850,11.60275319567355
"Woodbury city, New Jersey",4542,3903,639,34,82120,14.06869220607662
"Ashland CDP, New Jersey",3186,3002,184,34,01990,5.775266792215945
"Audubon Park borough, New Jersey",492,469,23,34,02230,4.67479674796748
"Blackwood CDP, New Jersey",1986,1815,171,34,06040,8.610271903323262
"Westfield town, New Jersey",10906,10376,530,34,79040,4.859710251237851
"Hamburg borough, New Jersey",1458,1328,130,34,29220,8.916323731138547
"Hopatcong borough, New Jersey",6470,5570,900,34,32910,13.910355486862441
"Newark city, New Jersey",112724,96888,15836,34,51000,14.048472375004437
"Country Lake Estates CDP, New Jersey",1535,1292,243,34,15250,15.830618892508145
"Fieldsboro borough, New Jersey",349,325,24,34,23250,6.876790830945559
"Caldwell borough, New Jersey",3574,3288,286,34,09250,8.00223838836038
"Lake Como borough, New Jersey",1064,721,343,34,37560,32.23684210526316
"Woodland Park borough, New Jersey",4607,4364,243,34,82423,5.2745821575862815
"Zarephath CDP, New Jersey",15,15,0,34,83290,0.0
"Allamuchy CDP, New Jersey",14,14,0,34,00640,0.0
"Anderson CDP, New Jersey",144,144,0,34,01300,0.0
"Asbury CDP, New Jersey",103,103,0,34,01900,0.0
"Barclay CDP, New Jersey",1561,1465,96,34,02880,6.149903907751442
"Beattystown CDP, New Jersey",2088,1794,294,34,04252,14.080459770114942
"Belle Mead CDP, New Jersey",91,61,30,34,04630,32.967032967032964
"Belleplain CDP, New Jersey",208,200,8,34,04660,3.8461538461538463
"Blackwells Mills CDP, New Jersey",245,245,0,34,06025,0.0
"Blairstown CDP, New Jersey",134,91,43,34,06130,32.08955223880597
"Blawenburg CDP, New Jersey",63,63,0,34,06190,0.0
"Bradley Gardens CDP, New Jersey",4899,4793,106,34,07000,2.163706878954889
"Brainards CDP, New Jersey",68,68,0,34,07120,0.0
"Bridgeville CDP, New Jersey",30,30,0,34,07660,0.0
"Broadway CDP, New Jersey",157,136,21,34,08020,13.375796178343949
"Brookdale CDP, New Jersey",3400,3363,37,34,08110,1.088235294117647
"Brookfield CDP, New Jersey",572,572,0,34,08140,0.0
"Burleigh CDP, New Jersey",222,222,0,34,08890,0.0
"Buttzville CDP, New Jersey",180,47,133,34,09100,73.88888888888889
"Byram Center CDP, New Jersey",34,10,24,34,09170,70.58823529411765
"Clyde CDP, New Jersey",86,86,0,34,13990,0.0
"Columbia CDP, New Jersey",112,99,13,34,14590,11.607142857142858
"Delaware CDP, New Jersey",67,67,0,34,17200,0.0
"Delaware Park CDP, New Jersey",182,182,0,34,17260,0.0
"East Franklin CDP, New Jersey",2984,2407,577,34,19130,19.33646112600536
"East Millstone CDP, New Jersey",185,185,0,34,19330,0.0
"East Rocky Hill CDP, New Jersey",149,149,0,34,19490,0.0
"Finesville CDP, New Jersey",90,79,11,34,23340,12.222222222222221
"Ellisburg CDP, New Jersey",1892,1786,106,34,21120,5.602536997885835
"Elwood CDP, New Jersey",460,460,0,34,21420,0.0
"Finderne CDP, New Jersey",2299,2124,175,34,23310,7.612005219660722
"Franklin Center CDP, New Jersey",2449,2095,354,34,24965,14.45487954267048
"Franklin Park CDP, New Jersey",6157,5564,593,34,25020,9.631313951599806
"Paraje CDP, New Mexico",292,214,78,35,55340,26.71232876712329
"Seama CDP, New Mexico",137,112,25,35,71440,18.248175182481752
"Carlsbad city, New Mexico",12377,10677,1700,35,12150,13.735153914518866
"Loving village, New Mexico",549,484,65,35,44420,11.839708561020036
"Edgewood town, New Mexico",2635,2431,204,35,22380,7.741935483870968
"El Rancho CDP, New Mexico",530,429,101,35,23840,19.056603773584907
"Madrid CDP, New Mexico",130,123,7,35,46100,5.384615384615385
"Puerto de Luna CDP, New Mexico",71,18,53,35,60170,74.64788732394366
"Pulpotio Bareas CDP, New Mexico",51,51,0,35,60205,0.0
"Quemado CDP, New Mexico",109,41,68,35,60730,62.38532110091744
"Rancho Grande CDP, New Mexico",111,32,79,35,61675,71.17117117117117
"Ribera CDP, New Mexico",166,166,0,35,62760,0.0
"Rivers CDP, New Mexico",34,0,34,35,63660,100.0
"Rodeo CDP, New Mexico",80,47,33,35,64370,41.25
"Rodey CDP, New Mexico",95,95,0,35,64440,0.0
"Rosedale CDP, New Mexico",219,219,0,35,64900,0.0
"Rowe CDP, New Mexico",170,86,84,35,65000,49.411764705882355
"Sacramento CDP, New Mexico",46,46,0,35,65560,0.0
"San Acacia CDP, New Mexico",18,18,0,35,65910,0.0
"Irvington village, New York",2707,2413,294,36,37803,10.860731437015145
"South Glens Falls village, New York",1792,1685,107,36,69078,5.970982142857143
"Brushton village, New York",238,195,43,36,10286,18.067226890756302
"Burke village, New York",95,92,3,36,11154,3.1578947368421053
"Amityville village, New York",3603,3421,182,36,02044,5.051346100471829
"Babylon village, New York",4670,4324,346,36,03408,7.4089935760171315
"Central Islip CDP, New York",10168,9183,985,36,13552,9.687254130605822
"Copiague CDP, New York",7625,7016,609,36,18146,7.9868852459016395
"Coram CDP, New York",15980,14685,1295,36,18157,8.103879849812264
"East Islip CDP, New York",4733,4323,410,36,22315,8.662581871962814
"East Northport CDP, New York",7479,6983,496,36,22612,6.631902660783527
"East Quogue CDP, New York",3164,1895,1269,36,22832,40.10745891276864
"Hartsdale CDP, New York",2666,2408,258,36,32523,9.67741935483871
"Amagansett CDP, New York",1836,358,1478,36,01594,80.50108932461873
"Bayport CDP, New York",3402,3205,197,36,04913,5.790711346266901
"Centereach CDP, New York",10245,9682,563,36,13376,5.495363591996096
"Cold Spring Harbor CDP, New York",1879,1714,165,36,16958,8.781266631186801
"Elwood CDP, New York",3739,3566,173,36,24405,4.6269055897298745
"Candor village, New York",347,274,73,36,12210,21.037463976945244
"Crugers CDP, New York",836,789,47,36,19290,5.62200956937799
"Golden's Bridge CDP, New York",751,696,55,36,29476,7.323568575233022
"Hawthorne CDP, New York",1625,1618,7,36,32842,0.43076923076923074
"East Shoreham CDP, New York",2045,1984,61,36,22980,2.9828850855745723
"Halesite CDP, New York",1030,998,32,36,31445,3.1067961165048543
"Hampton Bays CDP, New York",8254,5502,2752,36,31896,33.341410225345285
"Holtsville CDP, New York",6843,6554,289,36,35254,4.2232938769545525
"Kings Park CDP, New York",6608,6071,537,36,39672,8.126513317191284
"Belle Terre village, New York",275,250,25,36,05672,9.090909090909092
"Bellport village, New York",1132,823,309,36,05771,27.296819787985864
"Center Moriches CDP, New York",2973,2753,220,36,13420,7.399932727884292
"Deer Park CDP, New York",9085,8594,491,36,19972,5.404512933406715
"Springs CDP, New York",4778,2679,2099,36,70387,43.930514859773965
"Richville village, New York",119,109,10,36,61621,8.403361344537815
"Terryville CDP, New York",3887,3742,145,36,73352,3.7303833290455364
"Tuckahoe CDP, New York",633,365,268,36,75572,42.338072669826225
"Millport village, New York",172,152,20,36,47427,11.627906976744185
"Red Creek village, New York",266,215,51,36,60829,19.172932330827066
"Wolcott village, New York",801,726,75,36,82678,9.363295880149813
"Wappingers Falls village, New York",2433,2098,335,36,78168,13.769009453349772
"Alexander village, New York",239,236,3,36,01154,1.2552301255230125
"West Sayville CDP, New York",1992,1604,388,36,80885,19.477911646586346
"Wheatley Heights CDP, New York",1472,1300,172,36,81419,11.684782608695652
"Great Meadows CDP, New Jersey",16,16,0,34,27360,0.0
"Green Knoll CDP, New Jersey",2463,2446,17,34,27840,0.6902151847340642
"Greenwich CDP, New Jersey",782,752,30,34,28250,3.8363171355498724
"Griggstown CDP, New Jersey",337,337,0,34,28470,0.0
"Groveville CDP, New Jersey",932,854,78,34,28620,8.369098712446352
"Hainesburg CDP, New Jersey",34,20,14,34,28920,41.17647058823529
"Hamilton Square CDP, New Jersey",4525,4390,135,34,29370,2.983425414364641
"Hancocks Bridge CDP, New Jersey",108,89,19,34,29520,17.59259259259259
"Harlingen CDP, New Jersey",78,78,0,34,29940,0.0
"Harmony CDP, New Jersey",185,185,0,34,30060,0.0
"Hope CDP, New Jersey",71,63,8,34,33030,11.267605633802818
"Hutchinson CDP, New Jersey",58,42,16,34,33690,27.586206896551722
"Johnsonburg CDP, New Jersey",24,14,10,34,36150,41.66666666666667
"Juliustown CDP, New Jersey",143,113,30,34,36300,20.97902097902098
"Kenvil CDP, New Jersey",1160,1150,10,34,36720,0.8620689655172413
"Kingston Estates CDP, New Jersey",2535,2432,103,34,36960,4.063116370808678
"Lopatcong Overlook CDP, New Jersey",384,338,46,34,41495,11.979166666666668
"Marksboro CDP, New Jersey",37,29,8,34,43980,21.62162162162162
"Martinsville CDP, New Jersey",4137,4012,125,34,44430,3.021513173797438
"Mercerville CDP, New Jersey",4816,4613,203,34,45480,4.215116279069767
"Middlebush CDP, New Jersey",854,820,34,34,45870,3.9812646370023423
"Mountain Lake CDP, New Jersey",360,277,83,34,48450,23.055555555555557
"Mount Hermon CDP, New Jersey",45,45,0,34,48840,0.0
"New Village CDP, New Jersey",165,159,6,34,52050,3.6363636363636362
"Panther Valley CDP, New Jersey",1881,1782,99,34,55895,5.263157894736842
"Pedricktown CDP, New Jersey",202,174,28,34,57360,13.861386138613863
"Pine Lake Park CDP, New Jersey",3181,2902,279,34,58830,8.770826784030179
"Pleasant Plains CDP, New Jersey",123,123,0,34,59500,0.0
"Port Colden CDP, New Jersey",63,63,0,34,60210,0.0
"Port Murray CDP, New Jersey",17,17,0,34,60450,0.0
"Quinton CDP, New Jersey",252,234,18,34,61440,7.142857142857142
"Richwood CDP, New Jersey",1145,1081,64,34,62820,5.5895196506550215
"Robbinsville CDP, New Jersey",1150,1095,55,34,63840,4.782608695652174
"Robertsville CDP, New Jersey",3831,3656,175,34,63900,4.567997911772383
"Roebling CDP, New Jersey",1496,1428,68,34,64350,4.545454545454546
"Ross Corner CDP, New Jersey",31,31,0,34,64860,0.0
"Short Hills CDP, New Jersey",4159,4050,109,34,67320,2.6208223130560233
"Silver Lake CDP (Essex County), New Jersey",1734,1525,209,34,67590,12.053056516724336
"Silver Lake CDP (Warren County), New Jersey",147,121,26,34,67650,17.687074829931973
"Singac CDP, New Jersey",1789,1656,133,34,67770,7.434320849636669
"Six Mile Run CDP, New Jersey",1189,1065,124,34,67820,10.428931875525652
"Skillman CDP, New Jersey",138,138,0,34,67860,0.0
"Smithville CDP, New Jersey",3921,3524,397,34,68190,10.124968120377455
"Stewartsville CDP, New Jersey",178,178,0,34,70800,0.0
"Succasunna CDP, New Jersey",3155,3080,75,34,71370,2.3771790808240887
"Upper Stewartsville CDP, New Jersey",64,64,0,34,75145,0.0
"Ten Mile Run CDP, New Jersey",568,568,0,34,72435,0.0
"Upper Montclair CDP, New Jersey",4105,3985,120,34,75020,2.92326431181486
"Upper Pohatcong CDP, New Jersey",741,624,117,34,75120,15.789473684210526
"Vernon Center CDP, New Jersey",1227,897,330,34,75745,26.894865525672373
"Vienna CDP, New Jersey",400,400,0,34,75950,0.0
"Voorhees CDP, New Jersey",561,561,0,34,76250,0.0
"Weston CDP, New Jersey",1320,1245,75,34,79715,5.681818181818182
"Yardville CDP, New Jersey",2605,2488,117,34,83170,4.491362763915547
"Florence CDP, New Jersey",2138,1912,226,34,23820,10.570626753975679
"Leisure Village West CDP, New Jersey",2450,2253,197,34,39916,8.040816326530614
"Whitesboro CDP, New Jersey",1096,738,358,34,80840,32.66423357664234
"Highland Lakes CDP, New Jersey",2480,1761,719,34,31410,28.991935483870968
"Princeton, New Jersey",11003,9979,1024,34,60900,9.306552758338634
"San Antonio CDP, New Mexico",71,11,60,35,66120,84.50704225352112
"Chappaqua CDP, New York",556,523,33,36,13805,5.935251798561151
"Frankfort village, New York",1153,940,213,36,27188,18.473547267996533
"Ilion village, New York",3545,3094,451,36,37275,12.722143864598026
"Kensington village, New York",469,421,48,36,39309,10.23454157782516
"Niagara Falls city, New York",26399,21474,4925,36,51055,18.65600969733702
"North Tonawanda city, New York",15041,13645,1396,36,53682,9.281297786051459
"Ransomville CDP, New York",611,562,49,36,60598,8.01963993453355
"Hewlett Bay Park village, New York",153,133,20,36,34297,13.071895424836603
"Hewlett Harbor village, New York",411,378,33,36,34308,8.02919708029197
"Lake Success village, New York",844,766,78,36,40937,9.24170616113744
"Malverne village, New York",3175,3108,67,36,44787,2.110236220472441
"Plandome village, New York",418,395,23,36,58475,5.502392344497608
"New Square village, New York",1471,1431,40,36,50705,2.719238613188307
"South Nyack village, New York",1312,1163,149,36,69441,11.356707317073171
"Viola CDP, New York",1902,1729,173,36,77574,9.095688748685594
"Gouverneur village, New York",1972,1721,251,36,29597,12.728194726166327
"Rensselaer Falls village, New York",135,127,8,36,61159,5.9259259259259265
"Newark village, New York",4031,3816,215,36,49891,5.333664103200198
"Elmira city, New York",11972,9931,2041,36,24229,17.04811226194454
"Van Etten village, New York",236,209,27,36,76881,11.440677966101696
"West Elmira CDP, New York",2344,2204,140,36,79785,5.972696245733788
"Mount Morris village, New York",1363,1224,139,36,48945,10.198092443140132
"Corfu village, New York",344,309,35,36,18201,10.174418604651162
"Sodus village, New York",820,694,126,36,68209,15.365853658536585
"Ogdensburg city, New York",4429,4029,400,36,54485,9.031384059607134
"Waddington village, New York",508,450,58,36,77728,11.41732283464567
"Clyde village, New York",844,746,98,36,16573,11.61137440758294
"Big Flats CDP, New York",2389,2179,210,36,06464,8.790288823775638
"Geneseo village, New York",2122,1922,200,36,28618,9.42507068803016
"Miller Place CDP, New York",4266,3820,446,36,47306,10.45475855602438
"Addison village, New York",763,658,105,36,00276,13.761467889908257
"Hornell city, New York",3912,3358,554,36,35672,14.161554192229039
"Riverside village, New York",240,240,0,36,62061,0.0
"Cold Spring village, New York",991,871,120,36,16936,12.108980827447024
"Lake Carmel CDP, New York",3216,3069,147,36,40398,4.57089552238806
"Putnam Lake CDP, New York",1549,1287,262,36,60103,16.914138153647514
"Port Byron village, New York",451,408,43,36,59212,9.534368070953436
"Au Sable Forks CDP, New York",196,170,26,36,03254,13.26530612244898
"Cumberland Head CDP, New York",945,688,257,36,19408,27.195767195767196
"Redford CDP, New York",141,141,0,36,60884,0.0
"Bemus Point village, New York",376,183,193,36,05848,51.329787234042556
"Freeville village, New York",231,194,37,36,27529,16.017316017316016
"Brocton village, New York",714,649,65,36,08488,9.103641456582633
"Frewsburg CDP, New York",791,728,63,36,27672,7.964601769911504
"Ripley CDP, New York",371,339,32,36,61874,8.62533692722372
"New Berlin village, New York",546,398,148,36,49946,27.106227106227106
"Friendship CDP, New York",570,477,93,36,27694,16.315789473684212
"Greene village, New York",855,775,80,36,30411,9.35672514619883
"Munnsville village, New York",198,168,30,36,49220,15.151515151515152
"Wampsville village, New York",244,197,47,36,78113,19.262295081967213
"Brookville village, New York",866,829,37,36,10132,4.272517321016166
"East Norwich CDP, New York",1007,984,23,36,22623,2.284011916583913
"Franklin Square CDP, New York",10098,9580,518,36,27309,5.129728659140423
"Harbor Hills CDP, New York",145,145,0,36,32094,0.0
"Hempstead village, New York",17132,15703,1429,36,33139,8.341116040158768
"Herricks CDP, New York",1351,1299,52,36,34198,3.84900074019245
"Hewlett CDP, New York",2624,2407,217,36,34286,8.269817073170731
"Lakeview CDP, New York",1593,1490,103,36,41003,6.465787821720024
"Manhasset Hills CDP, New York",1124,1116,8,36,44908,0.7117437722419928
"North Bellmore CDP, New York",6630,6469,161,36,51517,2.4283559577677227
"San Antonito CDP (Bernalillo County), New Mexico",588,479,109,35,66330,18.537414965986397
"San Antonito CDP (Socorro County), New Mexico",23,11,12,35,66400,52.17391304347826
"San Cristobal CDP, New Mexico",141,121,20,35,66540,14.184397163120568
"Sandia Heights CDP, New Mexico",1732,1552,180,35,66765,10.392609699769054
"Sandia Knolls CDP, New Mexico",685,586,99,35,66890,14.452554744525548
"Sandia Park CDP, New Mexico",128,94,34,35,66960,26.5625
"San Fidel CDP, New Mexico",131,131,0,35,67520,0.0
"San Jose CDP (Rio Arriba County), New Mexico",307,215,92,35,68430,29.967426710097723
"San Jose CDP (San Miguel County), New Mexico",85,85,0,35,68500,0.0
"San Lorenzo CDP, New Mexico",57,57,0,35,68920,0.0
"San Luis CDP, New Mexico",60,60,0,35,69060,0.0
"San Mateo CDP, New Mexico",103,103,0,35,69270,0.0
"San Miguel CDP, New Mexico",395,377,18,35,69410,4.556962025316456
"San Pablo CDP, New Mexico",355,311,44,35,69645,12.394366197183098
"San Pedro CDP, New Mexico",85,60,25,35,69825,29.411764705882355
"San Rafael CDP, New Mexico",463,333,130,35,69875,28.077753779697623
"San Ysidro CDP, New Mexico",774,718,56,35,71015,7.235142118863049
"Sausal CDP, New Mexico",726,656,70,35,71145,9.641873278236915
"Seboyeta CDP, New Mexico",94,94,0,35,71510,0.0
"Sedillo CDP, New Mexico",440,440,0,35,71700,0.0
"Sena CDP, New Mexico",166,55,111,35,71790,66.86746987951807
"Soham CDP, New Mexico",124,80,44,35,73680,35.483870967741936
"South Acomita Village CDP, New Mexico",40,30,10,35,73925,25.0
"Spencerville CDP, New Mexico",577,540,37,35,74660,6.412478336221837
"Sunshine CDP, New Mexico",120,120,0,35,75710,0.0
"Talpa CDP, New Mexico",342,265,77,35,76130,22.514619883040936
"Tecolote CDP, New Mexico",102,102,0,35,76760,0.0
"Tecolotito CDP, New Mexico",102,88,14,35,76830,13.725490196078432
"Tesuque Pueblo CDP, New Mexico",89,77,12,35,77100,13.48314606741573
"Tierra Amarilla CDP, New Mexico",218,193,25,35,77670,11.46788990825688
"Tome CDP, New Mexico",791,720,71,35,78650,8.97597977243995
"Trout Valley CDP, New Mexico",37,0,37,35,79680,100.0
"Truchas CDP, New Mexico",331,103,228,35,79700,68.8821752265861
"Twin Forks CDP, New Mexico",283,99,184,35,80470,65.01766784452296
"Tyrone CDP, New Mexico",330,271,59,35,80820,17.87878787878788
"Ute Park CDP, New Mexico",225,48,177,35,81450,78.66666666666666
"Veguita CDP, New Mexico",94,51,43,35,82640,45.744680851063826
"Waterflow CDP, New Mexico",627,546,81,35,83760,12.918660287081341
"Velarde CDP, New Mexico",95,73,22,35,82710,23.157894736842106
"Ventura CDP, New Mexico",286,213,73,35,82800,25.524475524475527
"Villanueva CDP, New Mexico",161,64,97,35,83130,60.24844720496895
"Watrous CDP, New Mexico",100,22,78,35,83830,78.0
"Weed CDP, New Mexico",0,0,0,35,83970,
"West Hammond CDP, New Mexico",1105,1009,96,35,84200,8.687782805429864
"Whites City CDP, New Mexico",63,63,0,35,84950,0.0
"White Signal CDP, New Mexico",120,120,0,35,84975,0.0
"Windmill CDP, New Mexico",81,43,38,35,85485,46.913580246913575
"Winston CDP, New Mexico",64,38,26,35,85720,40.625
"Young Place CDP, New Mexico",135,93,42,35,86175,31.11111111111111
"Youngsville CDP, New Mexico",37,25,12,35,86210,32.432432432432435
"Kirtland town, New Mexico",348,326,22,35,36230,6.321839080459771
"Rio Communities city, New Mexico",2292,2123,169,35,63145,7.37347294938918
"Gallina CDP, New Mexico",139,71,68,35,28180,48.92086330935252
"Anthony city, New Mexico",3072,2745,327,35,03820,10.64453125
"Espa�ola city, New Mexico",4638,3612,1026,35,25170,22.121604139715394
"Pueblo CDP, New Mexico",25,0,25,35,59840,100.0
"Albuquerque city, New Mexico",244382,222748,21634,35,02000,8.852534147359462
"Carnuel CDP, New Mexico",687,583,104,35,12430,15.138282387190685
"Tijeras village, New Mexico",297,248,49,35,77880,16.4983164983165
"Springer town, New Mexico",603,424,179,35,74800,29.684908789386398
"North Massapequa CDP, New York",6514,6189,325,36,53253,4.98925391464538
"Peru CDP, New York",740,680,60,36,57364,8.108108108108109
"Plattsburgh city, New York",8864,7894,970,36,58574,10.943140794223826
"Watervliet city, New York",5262,4716,546,36,78674,10.376282782212087
"East Hills village, New York",2430,2348,82,36,22260,3.374485596707819
"Farmingdale village, New York",4005,3704,301,36,25384,7.515605493133583
"Glenwood Landing CDP, New York",1379,1379,0,36,29421,0.0
"Great Neck Gardens CDP, New York",301,301,0,36,30202,0.0
"Inwood CDP, New York",3170,3043,127,36,37583,4.006309148264984
"Massapequa Park village, New York",5982,5669,313,36,45997,5.2323637579404885
"North New Hyde Park CDP, New York",4915,4790,125,36,53275,2.5432349949135302
"Old Westbury village, New York",1229,1100,129,36,54705,10.496338486574452
"Plandome Heights village, New York",331,329,2,36,58486,0.6042296072507553
"South Hempstead CDP, New York",1070,1053,17,36,69188,1.588785046728972
"South Valley Stream CDP, New York",2096,2029,67,36,69892,3.196564885496183
"Upper Brookville village, New York",584,504,80,36,76331,13.698630136986301
"Williston Park village, New York",2669,2582,87,36,82117,3.259647808167853
"Woodbury CDP, New York",3261,2964,297,36,82744,9.107635694572217
"New York Mills village, New York",1892,1737,155,36,51011,8.192389006342495
"Oriskany village, New York",692,607,85,36,55365,12.283236994219653
"Rome city, New York",14887,12622,2265,36,63418,15.214616779740714
"Fayetteville village, New York",1851,1727,124,36,25527,6.699081577525662
"Liverpool village, New York",1160,1098,62,36,42884,5.344827586206897
"Mattydale CDP, New York",2676,2419,257,36,46151,9.60388639760837
"Glen Head CDP, New York",1849,1712,137,36,29245,7.409410492157924
"Newfield Hamlet CDP, New York",316,280,36,36,50257,11.39240506329114
"Trumansburg village, New York",896,849,47,36,75506,5.245535714285714
"Penn Yan village, New York",2494,1985,509,36,57177,20.40898155573376
"Lewiston village, New York",1501,1378,123,36,42147,8.194536975349767
"South Lockport CDP, New York",3760,3255,505,36,69386,13.430851063829788
"Youngstown village, New York",914,802,112,36,84143,12.25382932166302
"Almond village, New York",198,177,21,36,01440,10.606060606060606
"Canisteo village, New York",1044,893,151,36,12254,14.46360153256705
"Cove Neck village, New York",133,101,32,36,18597,24.06015037593985
"Corning city, New York",5610,5069,541,36,18256,9.643493761140821
"Sleepy Hollow village, New York",3825,3670,155,36,67638,4.052287581699346
"Bellerose Terrace CDP, New York",597,572,25,36,05661,4.1876046901172534
"Baldwinsville village, New York",3467,3210,257,36,04198,7.412748774156332
"Galeville CDP, New York",2080,1952,128,36,28035,6.153846153846154
"Valatie village, New York",709,559,150,36,76617,21.156558533145276
"Ghent CDP, New York",164,164,0,36,28860,0.0
"Kinderhook village, New York",735,656,79,36,39562,10.748299319727892
"Lorenz Park CDP, New York",1010,953,57,36,43511,5.643564356435644
"Fairport village, New York",2524,2477,47,36,25076,1.862123613312203
"Hilton village, New York",2437,2295,142,36,34847,5.826836274107509
"Pittsford village, New York",778,729,49,36,58354,6.298200514138817
"Airmont village, New York",2568,2473,95,36,00408,3.699376947040498
"Congers CDP, New York",2829,2752,77,36,17739,2.7218098267939204
"Monsey CDP, New York",4269,3989,280,36,48010,6.558913094401499
"DeRuyter village, New York",223,176,47,36,20390,21.076233183856502
"Springville village, New York",2028,1850,178,36,70442,8.777120315581854
"Tonawanda city, New York",7511,6981,530,36,74166,7.056317401144987
"Canastota village, New York",2055,1762,293,36,12188,14.257907542579076
"Tonawanda CDP, New York",27376,25793,1583,36,74183,5.7824371712448865
"Jordan village, New York",638,572,66,36,38825,10.344827586206897
"Lyncourt CDP, New York",1850,1707,143,36,43885,7.72972972972973
"Manlius village, New York",2209,1985,224,36,45018,10.140334993209597
"Minoa village, New York",1501,1370,131,36,47757,8.727514990006663
"Nedrow CDP, New York",989,945,44,36,49726,4.448938321536906
"Seneca Knolls CDP, New York",975,932,43,36,66366,4.41025641025641
"Hatch village, New Mexico",619,483,136,35,31820,21.97092084006462
"Mesquite CDP, New Mexico",189,153,36,35,48270,19.047619047619047
"Rincon CDP, New Mexico",72,48,24,35,62900,33.33333333333333
"Artesia city, New Mexico",5233,4689,544,35,05220,10.39556659659851
"Lovington city, New Mexico",4130,3579,551,35,44490,13.341404358353511
"Floyd village, New Mexico",41,33,8,35,26570,19.51219512195122
"Portales city, New Mexico",5156,4434,722,35,59260,14.003103180760279
"San Ysidro village, New Mexico",110,95,15,35,71020,13.636363636363635
"Mountainair town, New Mexico",601,405,196,35,50370,32.61231281198003
"Flora Vista CDP, New Mexico",982,854,128,35,26360,13.034623217922606
"Cuartelez CDP, New Mexico",219,73,146,35,19110,66.66666666666666
"Pojoaque CDP, New Mexico",922,805,117,35,58630,12.689804772234273
"Isleta Village Proper CDP, New Mexico",278,152,126,35,34760,45.32374100719424
"Los Ranchos de Albuquerque village, New Mexico",2966,2632,334,35,43930,11.260957518543494
"Farmington city, New Mexico",17794,16095,1699,35,25800,9.548162301899517
"Naschitti CDP, New Mexico",124,98,26,35,51280,20.967741935483872
"Shiprock CDP, New Mexico",2965,2292,673,35,72770,22.698145025295112
"Cannon AFB CDP, New Mexico",799,643,156,35,10750,19.524405506883603
"Salem CDP, New Mexico",178,178,0,35,65840,0.0
"Corona village, New Mexico",121,40,81,35,17680,66.94214876033058
"Santa Teresa CDP, New Mexico",2001,1824,177,35,70700,8.845577211394302
"Vado CDP, New Mexico",826,752,74,35,81590,8.958837772397095
"Estancia town, New Mexico",603,466,137,35,25380,22.71973466003317
"Jemez Springs village, New Mexico",121,89,32,35,35320,26.446280991735538
"La Jara CDP, New Mexico",158,113,45,35,37490,28.48101265822785
"Grenville village, New Mexico",27,7,20,35,30770,74.07407407407408
"Los Chaves CDP, New Mexico",2283,2102,181,35,42740,7.928164695575997
"Tatum town, New Mexico",352,297,55,35,76620,15.625
"Dora village, New Mexico",77,58,19,35,21180,24.675324675324674
"Willard village, New Mexico",119,57,62,35,85160,52.10084033613446
"Santa Ana Pueblo CDP, New Mexico",184,174,10,35,70250,5.434782608695652
"Zia Pueblo CDP, New Mexico",240,212,28,35,86420,11.666666666666666
"Torreon CDP (Torrance County), New Mexico",123,123,0,35,79140,0.0
"Vadito CDP, New Mexico",131,94,37,35,81520,28.24427480916031
"Los Alamos CDP, New Mexico",5968,5312,656,35,42320,10.991957104557642
"Wagon Mound village, New Mexico",205,98,107,35,83340,52.19512195121951
"Tularosa village, New Mexico",1464,1146,318,35,79980,21.721311475409834
"Church Rock CDP, New Mexico",268,224,44,35,15370,16.417910447761194
"Tohatchi CDP, New Mexico",354,222,132,35,78440,37.28813559322034
"Las Vegas city, New Mexico",6282,5141,1141,35,39940,18.16300541228908
"Mosquero village, New Mexico",88,23,65,35,50300,73.86363636363636
"Williamsburg village, New Mexico",284,187,97,35,85300,34.154929577464785
"Lordsburg city, New Mexico",1342,1009,333,35,42180,24.81371087928465
"Logan village, New Mexico",1224,346,878,35,42040,71.73202614379085
"Tucumcari city, New Mexico",2686,1756,930,35,79910,34.623976172747575
"Tse Bonito CDP, New Mexico",152,76,76,35,79885,50.0
"Dulce CDP, New Mexico",821,615,206,35,21390,25.091352009744217
"Questa village, New Mexico",1237,738,499,35,60870,40.33953112368634
"Valencia CDP, New Mexico",901,859,42,35,81800,4.661487236403995
"Elephant Butte city, New Mexico",1504,688,816,35,22720,54.25531914893617
"Picuris Pueblo CDP, New Mexico",56,41,15,35,56810,26.785714285714285
"Taos Ski Valley village, New Mexico",384,32,352,35,76480,91.66666666666666
"Hurley town, New Mexico",696,539,157,35,33850,22.557471264367816
"Nageezi CDP, New Mexico",117,91,26,35,50790,22.22222222222222
"Chamisal CDP, New Mexico",169,126,43,35,14110,25.443786982248522
"Rio Lucio CDP, New Mexico",193,139,54,35,63250,27.979274611398964
"Silver City town, New Mexico",4992,4196,796,35,73260,15.94551282051282
"Dexter town, New Mexico",437,389,48,35,20620,10.983981693363845
"Virden village, New Mexico",65,61,4,35,83200,6.153846153846154
"Ca�ada de los Alamos CDP, New Mexico",175,151,24,35,10470,13.714285714285715
"Castile village, New York",430,407,23,36,12771,5.348837209302325
"Fort Johnson village, New York",287,259,28,36,26880,9.75609756097561
"Tribes Hill CDP, New York",517,377,140,36,75341,27.079303675048354
"Delanson village, New York",148,106,42,36,20082,28.37837837837838
"Rotterdam CDP, New York",8694,7210,1484,36,63924,17.06924315619968
"Brewerton CDP, New York",1875,1660,215,36,08059,11.466666666666667
"Broadalbin village, New York",701,617,84,36,08422,11.982881597717546
"Gloversville city, New York",7617,6159,1458,36,29443,19.141394249704607
"Mayfield village, New York",401,321,80,36,46206,19.950124688279303
"Sand Ridge CDP, New York",299,242,57,36,65024,19.063545150501675
"Vails Gate CDP, New York",1579,1385,194,36,76584,12.286257124762507
"Warwick village, New York",2999,2912,87,36,78355,2.900966988996332
"Niverville CDP, New York",720,465,255,36,51297,35.41666666666667
"Irondequoit CDP, New York",23863,22085,1778,36,37737,7.450865356409504
"Scottsville village, New York",870,803,67,36,65959,7.7011494252873565
"Blauvelt CDP, New York",1655,1617,38,36,06860,2.29607250755287
"Chestnut Ridge village, New York",2529,2432,97,36,15400,3.835508105970739
"Haverstraw village, New York",3816,3641,175,36,32754,4.585953878406709
"Kaser village, New York",944,926,18,36,38934,1.9067796610169492
"Montebello village, New York",1792,1673,119,36,48090,6.640625
"New City CDP, New York",11887,11451,436,36,50100,3.667872465718853
"Pomona village, New York",1001,991,10,36,58992,0.999000999000999
"Heuvelton village, New York",344,319,25,36,34264,7.267441860465117
"Dolgeville village, New York",1094,1006,88,36,20731,8.043875685557587
"Herkimer village, New York",3586,2894,692,36,34121,19.297267150027885
"Schaghticoke village, New York",280,273,7,36,65475,2.5
"Middleville village, New York",231,225,6,36,47108,2.5974025974025974
"Beacon city, New York",5961,5178,783,36,05100,13.135379969803724
"Victor village, New York",1200,1122,78,36,77376,6.5
"Wynantskill CDP, New York",1358,1358,0,36,83349,0.0
"Union Springs village, New York",540,439,101,36,76155,18.703703703703702
"Colonie village, New York",3213,3013,200,36,17332,6.224712107065048
"Weston Mills CDP, New York",726,613,113,36,80632,15.564738292011018
"Clayton village, New York",1155,884,271,36,16089,23.463203463203463
"Deferiet village, New York",135,120,15,36,19994,11.11111111111111
"Depauville CDP, New York",178,162,16,36,20302,8.98876404494382
"Evans Mills village, New York",264,218,46,36,24823,17.424242424242426
"Odessa village, New York",247,225,22,36,54452,8.906882591093117
"Watkins Glen village, New York",1037,835,202,36,78696,19.47926711668274
"Interlaken village, New York",288,237,51,36,37528,17.708333333333336
"Belmont village, New York",426,377,49,36,05815,11.502347417840376
"Holland CDP, New York",521,509,12,36,35111,2.3032629558541267
"Lackawanna city, New York",8406,7426,980,36,40189,11.65833928146562
"Orchard Park village, New York",1496,1396,100,36,55266,6.684491978609626
"West Seneca CDP, New York",21057,19753,1304,36,80907,6.1927150116350855
"Burdett village, New York",207,184,23,36,11132,11.11111111111111
"East Ithaca CDP, New York",1136,987,149,36,22326,13.11619718309859
"Groton village, New York",976,835,141,36,30961,14.446721311475411
"Lansing village, New York",1843,1639,204,36,41223,11.068909386869235
"West Hills CDP, New York",2054,1852,202,36,80258,9.834469328140214
"Ardsley village, New York",1688,1638,50,36,02506,2.962085308056872
"Croton-on-Hudson village, New York",3167,3027,140,36,19213,4.420587306599305
"Pelham village, New York",2440,2249,191,36,57001,7.827868852459016
"Arcade village, New York",1033,978,55,36,02407,5.324298160696999
"Rapids CDP, New York",645,469,176,36,60609,27.286821705426355
"Mahopac CDP, New York",3400,3120,280,36,44534,8.235294117647058
"Shenorock CDP, New York",811,754,57,36,66872,7.028360049321824
"Dundee village, New York",767,697,70,36,21050,9.126466753585397
"Richburg village, New York",187,163,24,36,61434,12.834224598930483
"Cassadaga village, New York",297,242,55,36,12749,18.51851851851852
"Lakewood village, New York",1700,1407,293,36,41069,17.235294117647058
"Do�a Ana CDP, New Mexico",512,470,42,35,21110,8.203125
"Napi Headquarters CDP, New Mexico",193,175,18,35,51035,9.32642487046632
"Pe�a Blanca CDP, New Mexico",239,207,32,35,55830,13.389121338912133
"Pe�asco CDP, New Mexico",305,217,88,35,55900,28.852459016393446
"Peralta town, New Mexico",1506,1323,183,35,56180,12.151394422310757
"Ruidoso Downs city, New Mexico",1400,829,571,35,65280,40.785714285714285
"Abeytas CDP, New Mexico",17,17,0,35,00240,0.0
"Abiquiu CDP, New Mexico",194,96,98,35,00310,50.51546391752577
"Adelino CDP, New Mexico",517,474,43,35,00940,8.317214700193423
"Alamillo CDP, New Mexico",99,43,56,35,01640,56.56565656565656
"Animas CDP, New Mexico",89,65,24,35,03750,26.96629213483146
"Anton Chico CDP, New Mexico",152,117,35,35,03890,23.026315789473685
"Anzac Village CDP, New Mexico",22,22,0,35,03970,0.0
"Apache Creek CDP, New Mexico",76,52,24,35,04030,31.57894736842105
"Aragon CDP, New Mexico",103,25,78,35,04450,75.72815533980582
"Arenas Valley CDP, New Mexico",666,559,107,35,04660,16.066066066066064
"Arrey CDP, New Mexico",38,23,15,35,04870,39.473684210526315
"Arroyo Hondo CDP, New Mexico",64,40,24,35,05010,37.5
"Arroyo Seco CDP, New Mexico",758,279,479,35,05150,63.19261213720316
"Atoka CDP, New Mexico",520,406,114,35,05430,21.923076923076923
"Blanco CDP, New Mexico",65,37,28,35,07810,43.07692307692308
"Bent CDP, New Mexico",16,16,0,35,06760,0.0
"Berino CDP, New Mexico",590,475,115,35,06830,19.491525423728813
"Bibo CDP, New Mexico",58,58,0,35,07145,0.0
"Bluewater Acres CDP, New Mexico",299,131,168,35,08185,56.187290969899664
"Bluewater Village CDP, New Mexico",215,123,92,35,08190,42.7906976744186
"Brazos CDP, New Mexico",62,50,12,35,08860,19.35483870967742
"Buckhorn CDP, New Mexico",119,88,31,35,09630,26.05042016806723
"Caballo CDP, New Mexico",58,58,0,35,10050,0.0
"Canjilon CDP, New Mexico",194,118,76,35,10610,39.175257731958766
"Ca�on CDP, New Mexico",119,92,27,35,10770,22.689075630252102
"Ca�ones CDP, New Mexico",47,11,36,35,11310,76.59574468085107
"Canova CDP, New Mexico",60,60,0,35,11520,0.0
"Capulin CDP, New Mexico",53,14,39,35,12010,73.58490566037736
"Cedar Hill CDP, New Mexico",409,354,55,35,13340,13.447432762836186
"Cedro CDP, New Mexico",194,148,46,35,13450,23.711340206185564
"Chamberino CDP, New Mexico",321,245,76,35,14040,23.67601246105919
"Chamita CDP, New Mexico",503,344,159,35,14180,31.610337972166995
"Chamizal CDP, New Mexico",52,10,42,35,14200,80.76923076923077
"Chical CDP, New Mexico",50,42,8,35,14670,16.0
"Chili CDP, New Mexico",330,203,127,35,14810,38.484848484848484
"City of the Sun CDP, New Mexico",92,47,45,35,15560,48.91304347826087
"Cliff CDP, New Mexico",125,95,30,35,15860,24.0
"Cobre CDP, New Mexico",24,24,0,35,16490,0.0
"Cochiti Lake CDP, New Mexico",320,264,56,35,16585,17.5
"Conchas Dam CDP, New Mexico",661,16,645,35,17260,97.57942511346445
"Cordova CDP, New Mexico",320,214,106,35,17610,33.125
"Costilla CDP, New Mexico",127,39,88,35,18240,69.29133858267717
"Cotton City CDP, New Mexico",134,101,33,35,18310,24.62686567164179
"Coyote CDP, New Mexico",86,56,30,35,18660,34.883720930232556
"Cruzville CDP, New Mexico",74,58,16,35,19010,21.62162162162162
"Cubero CDP, New Mexico",167,102,65,35,19220,38.92215568862276
"Cuyamungue Grant CDP, New Mexico",82,80,2,35,19645,2.4390243902439024
"Datil CDP, New Mexico",51,8,43,35,19920,84.31372549019608
"Dixon CDP, New Mexico",425,274,151,35,20830,35.529411764705884
"Duran CDP, New Mexico",28,5,23,35,21810,82.14285714285714
"East Pecos CDP, New Mexico",217,217,0,35,22230,0.0
"Edith Endave CDP, New Mexico",139,128,11,35,22390,7.913669064748201
"El Cerro CDP, New Mexico",1126,981,145,35,22580,12.877442273534637
"El Cerro Mission CDP, New Mexico",1612,1409,203,35,22582,12.59305210918114
"El Duende CDP, New Mexico",376,180,196,35,22650,52.12765957446809
"Westfield village, New York",1427,1261,166,36,79939,11.632796075683252
"Cobleskill village, New York",1641,1468,173,36,16628,10.542352224253504
"Esperance village, New York",166,148,18,36,24713,10.843373493975903
"Schoharie village, New York",434,354,80,36,65585,18.433179723502306
"Bainbridge village, New York",720,613,107,36,04033,14.86111111111111
"Great Neck Plaza village, New York",4038,3831,207,36,30213,5.12630014858841
"Laurel Hollow village, New York",627,583,44,36,41487,7.017543859649122
"Long Beach city, New York",16492,14366,2126,36,43335,12.891098714528257
"Muttontown village, New York",1323,1209,114,36,49330,8.616780045351474
"North Lynbrook CDP, New York",137,137,0,36,53231,0.0
"North Wantagh CDP, New York",4190,4112,78,36,53792,1.8615751789976134
"Old Bethpage CDP, New York",1983,1908,75,36,54551,3.7821482602118004
"Greenlawn CDP, New York",4906,4399,507,36,30543,10.334284549531187
"Brentwood CDP, New York",14868,13677,1191,36,08026,8.010492332526232
"Cutchogue CDP, New York",2134,1245,889,36,19466,41.65885660731021
"Eastport CDP, New York",768,702,66,36,22810,8.59375
"West Islip CDP, New York",8698,8476,222,36,80302,2.552310876063463
"Napeague CDP, New York",663,53,610,36,49424,92.00603318250377
"North Patchogue CDP, New York",2484,2397,87,36,53319,3.5024154589371985
"Northport village, New York",3295,2999,296,36,53396,8.98330804248862
"Wyandanch CDP, New York",3235,2744,491,36,83294,15.17774343122102
"Armonk CDP, New York",1642,1458,184,36,02649,11.20584652862363
"Crompond CDP, New York",808,787,21,36,19092,2.599009900990099
"Dobbs Ferry village, New York",3858,3671,187,36,20698,4.8470710212545365
"Asharoken village, New York",304,173,131,36,02737,43.09210526315789
"Baiting Hollow CDP, New York",1238,657,581,36,04055,46.93053311793215
"Sea Cliff village, New York",2012,1909,103,36,66047,5.119284294234593
"Valley Stream village, New York",12720,12116,604,36,76705,4.748427672955975
"Cazenovia village, New York",1128,945,183,36,13145,16.22340425531915
"Earlville village, New York",480,414,66,36,21523,13.750000000000002
"Cortland city, New York",7875,6537,1338,36,18388,16.99047619047619
"Albertson CDP, New York",1851,1795,56,36,01011,3.0253916801728797
"Bath village, New York",3016,2728,288,36,04759,9.549071618037134
"South Corning village, New York",573,533,40,36,68847,6.980802792321117
"Wayland village, New York",883,757,126,36,78850,14.269535673839185
"Tully village, New York",459,425,34,36,75627,7.4074074074074066
"Marcellus village, New York",877,822,55,36,45480,6.2713797035347785
"Syracuse city, New York",67256,55306,11950,36,73000,17.767931485666708
"Warsaw village, New York",1634,1544,90,36,78333,5.507955936352509
"Cohocton village, New York",349,309,40,36,16727,11.461318051575931
"Hammondsport village, New York",387,269,118,36,31852,30.490956072351423
"Northeast Ithaca CDP, New York",1111,1062,49,36,51915,4.41044104410441
"Schenectady city, New York",32564,22694,9870,36,65508,30.309544282029233
"Fulton city, New York",5353,4662,691,36,27815,12.90864935550159
"Hannibal village, New York",223,206,17,36,32017,7.623318385650224
"Jeffersonville village, New York",212,150,62,36,38506,29.245283018867923
"Livingston Manor CDP, New York",628,387,241,36,42928,38.375796178343954
"Dresden village, New York",155,117,38,36,20896,24.516129032258064
"Whitehall village, New York",1145,904,241,36,81622,21.048034934497817
"Nesconset CDP, New York",4815,4609,206,36,49825,4.278296988577362
"New Suffolk CDP, New York",288,117,171,36,50727,59.375
"North Amityville CDP, New York",5427,4952,475,36,51396,8.752533628155518
"Roslyn village, New York",1432,1310,122,36,63770,8.519553072625698
"Oyster Bay Cove village, New York",779,738,41,36,56011,5.263157894736842
"Port Washington CDP, New York",6261,5713,548,36,59520,8.75259543203961
"Roosevelt CDP, New York",4611,4292,319,36,63506,6.918238993710692
"Russell Gardens village, New York",339,324,15,36,64232,4.424778761061947
"Uniondale CDP, New York",8488,7964,524,36,76089,6.173421300659755
"University Gardens CDP, New York",1666,1615,51,36,76287,3.061224489795918
"West Hempstead CDP, New York",6078,5782,296,36,80225,4.8700230338927275
"El Rito CDP, New Mexico",304,203,101,35,24120,33.223684210526315
"Ensenada CDP, New Mexico",52,28,24,35,24960,46.15384615384615
"Escondida CDP, New Mexico",50,15,35,35,25100,70.0
"Escudilla Bonita CDP, New Mexico",163,46,117,35,25135,71.77914110429448
"Fairacres CDP, New Mexico",473,405,68,35,25590,14.376321353065538
"Faywood CDP, New Mexico",16,16,0,35,25870,0.0
"Fence Lake CDP, New Mexico",55,33,22,35,26010,40.0
"Garfield CDP, New Mexico",0,0,0,35,28670,
"Gila CDP, New Mexico",206,140,66,35,29160,32.038834951456316
"Glen Acres CDP, New Mexico",113,81,32,35,29540,28.31858407079646
"Glenwood CDP, New Mexico",74,22,52,35,29790,70.27027027027027
"Golden CDP, New Mexico",14,7,7,35,30000,50.0
"Hernandez CDP, New Mexico",413,236,177,35,32100,42.857142857142854
"Hachita CDP, New Mexico",50,19,31,35,31190,62.0
"Hanover CDP, New Mexico",81,81,0,35,31540,0.0
"Happy Valley CDP, New Mexico",290,225,65,35,31680,22.413793103448278
"Highland Meadows CDP, New Mexico",309,177,132,35,32148,42.71844660194174
"High Rolls CDP, New Mexico",483,334,149,35,32160,30.848861283643892
"Hillsboro CDP, New Mexico",120,69,51,35,32380,42.5
"Homestead CDP, New Mexico",74,12,62,35,33130,83.78378378378379
"Hot Springs Landing CDP, New Mexico",206,37,169,35,33640,82.03883495145631
"Indian Hills CDP, New Mexico",429,338,91,35,34430,21.21212121212121
"Jacona CDP, New Mexico",215,168,47,35,34900,21.86046511627907
"Keeler Farm CDP, New Mexico",632,521,111,35,35595,17.563291139240505
"Kingston CDP, New Mexico",39,0,39,35,36090,100.0
"La Cueva CDP, New Mexico",175,92,83,35,36880,47.42857142857143
"La Hacienda CDP, New Mexico",203,138,65,35,37407,32.01970443349754
"La Huerta CDP, New Mexico",569,513,56,35,37420,9.84182776801406
"La Joya CDP, New Mexico",58,8,50,35,37700,86.20689655172413
"Lake Roberts CDP, New Mexico",148,16,132,35,37860,89.1891891891892
"Lake Roberts Heights CDP, New Mexico",39,39,0,35,37862,0.0
"Lake Valley CDP, New Mexico",44,34,10,35,37910,22.727272727272727
"La Madera CDP, New Mexico",62,22,40,35,38470,64.51612903225806
"Alamogordo city, New Mexico",15117,12768,2349,35,01780,15.538797380432626
"Holloman AFB CDP, New Mexico",1077,992,85,35,32940,7.892293407613741
"Mescalero CDP, New Mexico",419,363,56,35,47920,13.365155131264917
"Chama village, New Mexico",675,372,303,35,13970,44.888888888888886
"Meadow Lake CDP, New Mexico",1679,1380,299,35,47220,17.80821917808219
"Taos Pueblo CDP, New Mexico",571,500,71,35,76410,12.43432574430823
"Hagerman town, New Mexico",378,284,94,35,31330,24.867724867724867
"Roswell city, New Mexico",20244,17422,2822,35,64930,13.93993281960087
"Black Rock CDP, New Mexico",410,348,62,35,07670,15.121951219512194
"Crownpoint CDP, New Mexico",856,651,205,35,18940,23.948598130841123
"Gallup city, New Mexico",8483,7233,1250,35,28460,14.735353059059294
"Lamy CDP, New Mexico",78,78,0,35,38890,0.0
"La Mesa CDP, New Mexico",340,264,76,35,38680,22.35294117647059
"La Mesilla CDP, New Mexico",970,818,152,35,38820,15.670103092783505
"La Plata CDP, New Mexico",254,205,49,35,39030,19.291338582677163
"Las Maravillas CDP, New Mexico",604,575,29,35,39430,4.801324503311259
"Las Nutrias CDP, New Mexico",68,34,34,35,39450,50.0
"Las Palomas CDP, New Mexico",125,125,0,35,39520,0.0
"La Union CDP, New Mexico",373,317,56,35,40220,15.013404825737265
"La Villita CDP, New Mexico",572,399,173,35,40360,30.244755244755243
"Lee Acres CDP, New Mexico",2381,2076,305,35,40525,12.809743805123897
"Lemitar CDP, New Mexico",267,177,90,35,40570,33.70786516853933
"Livingston Wheeler CDP, New Mexico",220,220,0,35,41420,0.0
"Llano del Medio CDP, New Mexico",112,34,78,35,41620,69.64285714285714
"Loco Hills CDP, New Mexico",11,11,0,35,41970,0.0
"Los Luceros CDP, New Mexico",300,133,167,35,43300,55.666666666666664
"Los Ojos CDP, New Mexico",90,26,64,35,43510,71.11111111111111
"Lower Frisco CDP, New Mexico",9,0,9,35,44595,100.0
"Silver Springs village, New York",401,384,17,36,67466,4.239401496259352
"Cherry Creek village, New York",213,177,36,36,15187,16.901408450704224
"Fredonia village, New York",4304,3627,677,36,27419,15.729553903345725
"Constableville village, New York",134,108,26,36,17882,19.402985074626866
"Copenhagen village, New York",449,357,92,36,18135,20.489977728285076
"Lyons Falls village, New York",258,232,26,36,44006,10.077519379844961
"Middleburgh village, New York",863,704,159,36,46866,18.424101969872538
"Palatine Bridge village, New York",300,275,25,36,56110,8.333333333333332
"Richmondville village, New York",402,334,68,36,61588,16.91542288557214
"Ithaca city, New York",11314,10239,1075,36,38077,9.501502563196041
"Fort Plain village, New York",1031,718,313,36,26924,30.358874878758485
"Elba village, New York",256,235,21,36,23745,8.203125
"Hudson city, New York",3295,2694,601,36,35969,18.239757207890744
"Stottville CDP, New York",685,556,129,36,71718,18.83211678832117
"Brockport village, New York",2522,2260,262,36,08466,10.388580491673276
"Honeoye Falls village, New York",1313,1203,110,36,35364,8.377760853008377
"Webster village, New York",2618,2426,192,36,78960,7.3338426279602755
"Nichols village, New York",254,202,52,36,51110,20.47244094488189
"Dexter village, New York",494,408,86,36,20500,17.408906882591094
"Nassau village, New York",540,442,98,36,49506,18.14814814814815
"Troy city, New York",23580,19954,3626,36,75484,15.377438507209499
"Glen Cove city, New York",10475,9792,683,36,29113,6.520286396181383
"Johnson City village, New York",7186,6288,898,36,38748,12.496521013080992
"Le Roy village, New York",1957,1782,175,36,42026,8.942258559018907
"Lisle village, New York",111,96,15,36,42642,13.513513513513514
"Mohawk village, New York",1188,1034,154,36,47823,12.962962962962962
"Port Dickinson village, New York",819,770,49,36,59245,5.982905982905983
"Millbrook village, New York",774,676,98,36,47273,12.661498708010335
"Rhinebeck village, New York",1368,1254,114,36,61346,8.333333333333332
"Greece CDP, New York",6615,6305,310,36,30279,4.686318972033257
"Nyack village, New York",3798,3300,498,36,54100,13.112164296998422
"Pearl River CDP, New York",6116,5735,381,36,56902,6.2295618051013735
"Suffern village, New York",4680,4364,316,36,71894,6.752136752136752
"Star Lake CDP, New York",527,369,158,36,70849,29.98102466793169
"Palmyra village, New York",1521,1471,50,36,56187,3.2873109796186717
"Elmira Heights village, New York",2063,1811,252,36,24251,12.21522055259331
"Horseheads village, New York",3250,2998,252,36,35694,7.753846153846154
"Wellsburg village, New York",215,165,50,36,79081,23.25581395348837
"Caledonia village, New York",1016,935,81,36,11704,7.97244094488189
"Lima village, New York",982,911,71,36,42323,7.230142566191446
"Pleasant Valley CDP, New York",662,662,0,36,58684,0.0
"Spackenkill CDP, New York",1445,1389,56,36,70035,3.875432525951557
"Claverack-Red Mills CDP, New York",347,251,96,36,16050,27.6657060518732
"Germantown CDP, New York",444,375,69,36,28761,15.54054054054054
"Grand View-on-Hudson village, New York",149,132,17,36,29872,11.409395973154362
"Nanuet CDP, New York",6765,6382,383,36,49407,5.66149297856615
"Orangeburg CDP, New York",1463,1406,57,36,55167,3.896103896103896
"Spring Valley village, New York",10096,9373,723,36,70420,7.161251980982568
"Scotchtown CDP, New York",3642,3313,329,36,65882,9.033498077979132
"Harriman village, New York",1220,1065,155,36,32325,12.704918032786885
"Kiryas Joel village, New York",4318,4089,229,36,39853,5.303381194997684
"Orange Lake CDP, New York",2475,2314,161,36,55189,6.505050505050505
"Waterville village, New York",687,633,54,36,78663,7.860262008733625
"Gang Mills CDP, New York",1809,1763,46,36,28145,2.542841348811498
"Painted Post village, New York",854,788,66,36,56088,7.728337236533958
"Gasport CDP, New York",611,564,47,36,28431,7.6923076923076925
"Lockport city, New York",10520,8879,1641,36,43082,15.598859315589353
"Pelham Manor village, New York",1770,1698,72,36,57023,4.067796610169491
"Port Chester village, New York",9794,9129,665,36,59223,6.7898713498060035
"Scarsdale village, New York",5921,5590,331,36,65431,5.59027191352812
"Luis Lopez CDP, New Mexico",71,51,20,35,45190,28.169014084507044
"Lumberton CDP, New Mexico",15,15,0,35,45260,0.0
"Luna CDP, New Mexico",159,17,142,35,45330,89.30817610062893
"Madrone CDP, New Mexico",328,283,45,35,46170,13.719512195121952
"Lyden CDP, New Mexico",65,65,0,35,45400,0.0
"McCartys Village CDP, New Mexico",19,14,5,35,45690,26.31578947368421
"McIntosh CDP, New Mexico",583,416,167,35,46030,28.644939965694682
"Malaga CDP, New Mexico",57,57,0,35,46380,0.0
"Manzano Springs CDP, New Mexico",69,69,0,35,46770,0.0
"Mayhill CDP, New Mexico",105,25,80,35,47150,76.19047619047619
"Middle Frisco CDP, New Mexico",56,16,40,35,48425,71.42857142857143
"Midway CDP, New Mexico",319,277,42,35,48480,13.166144200626958
"Mimbres CDP, New Mexico",476,334,142,35,48830,29.831932773109244
"Monterey Park CDP, New Mexico",346,301,45,35,49515,13.005780346820808
"Monument CDP, New Mexico",47,33,14,35,49950,29.78723404255319
"Moquino CDP, New Mexico",25,25,0,35,50020,0.0
"Mora CDP, New Mexico",304,244,60,35,50090,19.736842105263158
"Morningside CDP, New Mexico",202,202,0,35,50195,0.0
"Mountain View CDP, New Mexico",69,69,0,35,50515,0.0
"Nadine CDP, New Mexico",133,125,8,35,50720,6.015037593984962
"Nambe CDP, New Mexico",919,745,174,35,50930,18.933623503808487
"Nara Visa CDP, New Mexico",69,38,31,35,51140,44.927536231884055
"Navajo Dam CDP, New Mexico",267,151,116,35,51490,43.445692883895134
"Newkirk CDP, New Mexico",0,0,0,35,51840,
"Nogal CDP, New Mexico",70,47,23,35,52190,32.857142857142854
"North Hobbs CDP, New Mexico",2428,2179,249,35,52500,10.255354200988467
"North Hurley CDP, New Mexico",96,73,23,35,52540,23.958333333333336
"North Light Plant CDP, New Mexico",179,117,62,35,52560,34.63687150837989
"North San Ysidro CDP, New Mexico",44,0,44,35,52680,100.0
"Oasis CDP, New Mexico",115,35,80,35,53010,69.56521739130434
"Ohkay Owingeh CDP, New Mexico",362,290,72,35,53150,19.88950276243094
"Organ CDP, New Mexico",124,101,23,35,54430,18.548387096774192
"Orogrande CDP, New Mexico",57,40,17,35,54500,29.82456140350877
"Pajarito Mesa CDP, New Mexico",163,75,88,35,54940,53.987730061349694
"Paradise Hills CDP, New Mexico",2000,1868,132,35,55270,6.6000000000000005
"Pastura CDP, New Mexico",32,8,24,35,55550,75.0
"Peak Place CDP, New Mexico",143,129,14,35,55595,9.79020979020979
"Roy village, New Mexico",196,94,102,35,65070,52.04081632653062
"Vaughn town, New Mexico",272,83,189,35,82570,69.48529411764706
"Chimayo CDP, New Mexico",1374,852,522,35,14950,37.99126637554585
"Jaconita CDP, New Mexico",201,192,9,35,34925,4.477611940298507
"Los Cerrillos CDP, New Mexico",112,99,13,35,42600,11.607142857142858
"San Ildefonso Pueblo CDP, New Mexico",305,248,57,35,68010,18.688524590163937
"Tesuque CDP, New Mexico",805,503,302,35,77040,37.515527950310556
"Alamo CDP, New Mexico",418,175,243,35,01710,58.133971291866025
"Socorro city, New Mexico",3689,2391,1298,35,73540,35.18568717809705
"Bloomfield city, New Mexico",2875,2493,382,35,07880,13.28695652173913
"Raton city, New Mexico",3773,3011,762,35,62060,20.196130400212034
"Grants city, New Mexico",3632,3198,434,35,30490,11.949339207048459
"Paguate CDP, New Mexico",195,152,43,35,54710,22.05128205128205
"Chaparral CDP, New Mexico",5017,4281,736,35,14250,14.670121586605541
"Skyline-Ganipa CDP, New Mexico",302,287,15,35,73440,4.966887417218543
"Agua Fria CDP, New Mexico",1179,1096,83,35,01220,7.039864291772689
"Cedar Crest CDP, New Mexico",490,392,98,35,13200,20.0
"Laguna CDP, New Mexico",331,299,32,35,37070,9.667673716012084
"Las Cruces city, New Mexico",44575,39934,4641,35,39380,10.411665731912507
"Hope village, New Mexico",49,37,12,35,33290,24.489795918367346
"Causey village, New Mexico",43,33,10,35,12850,23.25581395348837
"Bernalillo town, New Mexico",3897,3464,433,35,06970,11.11111111111111
"East Moriches CDP, New York",2156,1838,318,36,22546,14.749536178107606
"Rio Rancho city, New Mexico",36583,34078,2505,35,63460,6.847442801301151
"Belen city, New Mexico",3242,2740,502,35,06480,15.484268969771744
"Hamilton village, New York",1003,823,180,36,31709,17.94616151545364
"Farmingville CDP, New York",4790,4599,191,36,25417,3.987473903966597
"Fishers Island CDP, New York",758,73,685,36,25923,90.36939313984169
"Fort Salonga CDP, New York",3563,3336,227,36,26946,6.3710356441201235
"Gordon Heights CDP, New York",1203,1010,193,36,29509,16.043225270157937
"Holbrook CDP, New York",9353,8854,499,36,35056,5.33518657115364
"Stewart Manor village, New York",829,778,51,36,71267,6.15199034981906
"Mooers CDP, New York",298,229,69,36,48241,23.154362416107382
"Cape Vincent village, New York",428,289,139,36,12353,32.476635514018696
"West Bay Shore CDP, New York",1707,1632,75,36,79301,4.393673110720562
"Portville village, New York",459,424,35,36,59498,7.625272331154684
"Alexandria Bay village, New York",639,456,183,36,01187,28.638497652582164
"Calcium CDP, New York",1733,1591,142,36,11671,8.193883439122908
"Glen Park village, New York",242,199,43,36,29322,17.768595041322314
"Great Bend CDP, New York",394,374,20,36,30136,5.0761421319796955
"Gilbertsville village, New York",208,168,40,36,28959,19.230769230769234
"Oneonta city, New York",5218,4322,896,36,54881,17.171330011498657
"West End CDP, New York",1180,961,219,36,79796,18.559322033898304
"Country Knolls CDP, New York",811,775,36,36,18542,4.438964241676942
"Galway village, New York",94,80,14,36,28101,14.893617021276595
"East Kingston CDP, New York",230,230,0,36,22370,0.0
"Kerhonkson CDP, New York",929,720,209,36,39397,22.497308934337997
"North Sea CDP, New York",3553,1887,1666,36,53561,46.889952153110045
"Noyack CDP, New York",3136,1524,1612,36,54056,51.4030612244898
"Patchogue village, New York",5699,5250,449,36,56660,7.8785751886295845
"Peconic CDP, New York",563,384,179,36,56968,31.793960923623445
"Southold CDP, New York",4156,2493,1663,36,69452,40.014436958614056
"Village of the Branch village, New York",651,591,60,36,77519,9.216589861751153
"Delevan village, New York",473,403,70,36,20115,14.799154334038056
"St. Bonaventure CDP, New York",295,295,0,36,64551,0.0
"Adams village, New York",754,642,112,36,00199,14.854111405835543
"Ellisburg village, New York",97,89,8,36,24075,8.24742268041237
"Philadelphia village, New York",538,486,52,36,57551,9.66542750929368
"Hobart village, New York",203,169,34,36,34979,16.748768472906402
"Theresa village, New York",365,278,87,36,73517,23.835616438356162
"Watertown city, New York",13200,11110,2090,36,78608,15.833333333333332
"Morris village, New York",299,219,80,36,48483,26.755852842809364
"Otego village, New York",463,414,49,36,55618,10.583153347732182
"Castleton-on-Hudson village, New York",630,552,78,36,12870,12.380952380952381
"Hampton Manor CDP, New York",1016,979,37,36,31918,3.6417322834645667
"Poestenkill CDP, New York",427,427,0,36,58794,0.0
"Windham CDP, New York",554,133,421,36,82469,75.9927797833935
"Wilson village, New York",621,506,115,36,82359,18.51851851851852
"Mariaville Lake CDP, New York",276,134,142,36,45573,51.449275362318836
"Altona CDP, New York",133,105,28,36,01572,21.052631578947366
"Parc CDP, New York",27,27,0,36,56291,0.0
"Brewster village, New York",912,791,121,36,08070,13.267543859649123
"Afton village, New York",531,436,95,36,00342,17.890772128060263
"Smyrna village, New York",120,107,13,36,68099,10.833333333333334
"Oneida city, New York",5088,4436,652,36,54837,12.814465408805031
"Marathon village, New York",411,339,72,36,45392,17.51824817518248
"Baldwin Harbor CDP, New York",2741,2477,264,36,04154,9.631521342575702
"Altamont village, New York",701,690,11,36,01517,1.5691868758915835
"Valhalla CDP, New York",1231,1149,82,36,76639,6.6612510154346065
"Blasdell village, New York",1303,1183,120,36,06849,9.20951650038373
"Buffalo city, New York",131868,110701,21167,36,11000,16.051657718324385
"Kenmore village, New York",7578,7009,569,36,39232,7.508577461071522
"Lincolndale CDP, New York",557,548,9,36,42455,1.615798922800718
"New Rochelle city, New York",29645,28073,1572,36,50617,5.302749198853094
"Peach Lake CDP, New York",713,622,91,36,56869,12.76297335203366
"Perry village, New York",1703,1404,299,36,57243,17.557251908396946
"Dryden village, New York",910,861,49,36,20951,5.384615384615385
"Fonda village, New York",367,284,83,36,26462,22.615803814713896
"St. Johnsville village, New York",835,708,127,36,64639,15.209580838323353
"Constantia CDP, New York",648,566,82,36,17893,12.654320987654321
"Oswego city, New York",8632,7551,1081,36,55574,12.523169601482856
"Parish village, New York",217,182,35,36,56341,16.129032258064516
"Pulaski village, New York",1077,933,144,36,59960,13.370473537604457
"Bloomingburg village, New York",217,143,74,36,06959,34.10138248847927
"Rock Hill CDP, New York",1310,535,775,36,63132,59.16030534351145
"South Fallsburg CDP, New York",1310,807,503,36,68968,38.396946564885496
"Champlain village, New York",510,440,70,36,13739,13.725490196078432
"Dannemora village, New York",399,324,75,36,19642,18.796992481203006
"Rushville village, New York",336,268,68,36,64199,20.238095238095237
"Newfane CDP, New York",1620,1526,94,36,50221,5.802469135802469
"Olcott CDP, New York",729,491,238,36,54540,32.647462277091904
"Elmont CDP, New York",10391,9804,587,36,24273,5.6491194302762
"Greenport West CDP, New York",1610,1025,585,36,30581,36.33540372670808
"Yorktown Heights CDP, New York",616,616,0,36,84088,0.0
"Fort Montgomery CDP, New York",723,604,119,36,26902,16.459197786998615
"Pine Bush CDP, New York",740,657,83,36,57980,11.216216216216218
"Walton Park CDP, New York",875,798,77,36,78063,8.799999999999999
"Salisbury CDP, New York",3905,3808,97,36,64842,2.4839948783610755
"South Farmingdale CDP, New York",5078,4895,183,36,69001,3.6037810161480897
"Bridgeport CDP, New York",603,603,0,36,08147,0.0
"North Syracuse village, New York",3154,3065,89,36,53660,2.8218135700697524
"Arkport village, New York",371,361,10,36,02583,2.6954177897574128
"Savona village, New York",368,332,36,36,65354,9.782608695652174
"South Hill CDP, New York",1181,1161,20,36,69199,1.6934801016088061
"Hagaman village, New York",715,655,60,36,31291,8.391608391608392
"Morrisville village, New York",478,262,216,36,48593,45.18828451882845
"Andover village, New York",425,367,58,36,02143,13.647058823529413
"Norwich city, New York",3412,2990,422,36,53979,12.368112543962486
"Madison village, New York",208,158,50,36,44424,24.03846153846154
"West Sand Lake CDP, New York",1074,1000,74,36,80863,6.890130353817504
"Forest Home CDP, New York",327,290,37,36,26561,11.314984709480122
"Mayville village, New York",783,524,259,36,46239,33.077905491698594
"Lake Placid village, New York",1904,940,964,36,40761,50.63025210084034
"Canandaigua city, New York",5253,4792,461,36,12144,8.775937559489815
"Manchester village, New York",793,742,51,36,44853,6.431273644388398
"Cato village, New York",272,233,39,36,12958,14.338235294117647
"Moravia village, New York",621,572,49,36,48296,7.890499194847021
"East Williston village, New York",801,801,0,36,23217,0.0
"Flower Hill village, New York",1606,1571,35,36,26352,2.179327521793275
"Chaumont village, New York",304,267,37,36,14036,12.171052631578947
"Fort Drum CDP, New York",3538,3248,290,36,26759,8.19672131147541
"Eatons Neck CDP, New York",607,530,77,36,23316,12.685337726523887
"Batavia city, New York",6908,6129,779,36,04715,11.276780544296468
"Hastings-on-Hudson village, New York",3035,2860,175,36,32710,5.766062602965404
"La Fargeville CDP, New York",216,201,15,36,40233,6.944444444444445
"Blue Point CDP, New York",1720,1577,143,36,07069,8.313953488372093
"East Rochester village, New York",3035,2834,201,36,22865,6.622734761120263
"Plattsburgh West CDP, New York",617,582,35,36,58601,5.6726094003241485
"Great Neck Estates village, New York",1111,966,145,36,30191,13.051305130513052
"New Hyde Park village, New York",2875,2798,77,36,50397,2.6782608695652175
"Callicoon CDP, New York",173,140,33,36,11748,19.07514450867052
"Hillburn village, New York",342,295,47,36,34660,13.742690058479532
"Valley Cottage CDP, New York",3683,3452,231,36,76661,6.272060819983709
"West Winfield village, New York",425,353,72,36,81292,16.941176470588236
"Red Hook village, New York",954,830,124,36,60895,12.997903563941298
"Thiells CDP, New York",1552,1514,38,36,73583,2.448453608247423
"Adams Center CDP, New York",666,625,41,36,00232,6.156156156156156
"Clintondale CDP, New York",608,582,26,36,16452,4.276315789473684
"Homer village, New York",1422,1330,92,36,35276,6.469760900140647
"Port Leyden village, New York",303,244,59,36,59454,19.471947194719473
"Point Lookout CDP, New York",572,420,152,36,58849,26.573426573426573
"Roslyn Estates village, New York",443,409,34,36,63792,7.674943566591422
"Roslyn Heights CDP, New York",2239,2083,156,36,63814,6.967396158999553
"Saddle Rock Estates CDP, New York",158,158,0,36,64441,0.0
"Syosset CDP, New York",6442,6216,226,36,72554,3.5082272586153365
"Wantagh CDP, New York",6026,5845,181,36,78146,3.003650846332559
"Boonville village, New York",920,833,87,36,07355,9.456521739130434
"Camden village, New York",1225,1110,115,36,11847,9.387755102040817
"Utica city, New York",28333,23520,4813,36,76540,16.987258673631455
"East Syracuse village, New York",1532,1348,184,36,23052,12.010443864229766
"Elbridge village, New York",415,398,17,36,23789,4.096385542168675
"Akron village, New York",1268,1228,40,36,00441,3.1545741324921135
"Billington Heights CDP, New York",739,704,35,36,06574,4.7361299052774015
"Depew village, New York",7138,6669,469,36,20313,6.570467918184366
"East Aurora village, New York",2773,2576,197,36,21589,7.10421925712225
"Eden CDP, New York",1373,1280,93,36,23404,6.773488710852149
"Naples village, New York",505,438,67,36,49429,13.267326732673268
"Head of the Harbor village, New York",555,479,76,36,32963,13.693693693693692
"Saratoga Springs city, New York",14364,12393,1971,36,65255,13.721804511278195
"Owego village, New York",1931,1703,228,36,55882,11.807353702744692
"Fort Ann village, New York",158,140,18,36,26704,11.39240506329114
"Morristown village, New York",236,128,108,36,48571,45.76271186440678
"New Hempstead village, New York",1295,1295,0,36,50353,0.0
"Tappan CDP, New York",2422,2359,63,36,73154,2.601156069364162
"Wesley Hills village, New York",1547,1508,39,36,79174,2.5210084033613445
"Norfolk CDP, New York",742,660,82,36,51319,11.05121293800539
"Poughkeepsie city, New York",14240,12627,1613,36,59641,11.327247191011235
"Tivoli village, New York",588,486,102,36,74023,17.346938775510203
"Horseheads North CDP, New York",1171,1053,118,36,35710,10.076857386848847
"Southport CDP, New York",3492,3236,256,36,69606,7.331042382588775
"Yaphank CDP, New York",2063,1994,69,36,83426,3.3446437227338826
"Buchanan village, New York",851,727,124,36,10341,14.571092831962398
"Eastchester CDP, New York",8317,7817,500,36,21809,6.011783094865937
"Elmsford village, New York",1791,1558,233,36,24295,13.009491903964266
"Greenville CDP (Westchester County), New York",2442,2282,160,36,30642,6.552006552006552
"Caroga Lake CDP, New York",878,268,610,36,12584,69.4760820045558
"Central Bridge CDP, New York",151,108,43,36,13530,28.47682119205298
"Chadwicks CDP, New York",582,582,0,36,13662,0.0
"Chautauqua CDP, New York",1333,68,1265,36,14058,94.8987246811703
"Chazy CDP, New York",218,191,27,36,14102,12.385321100917432
"Lyon Mountain CDP, New York",241,123,118,36,43951,48.96265560165975
"Chenango Bridge CDP, New York",1197,1097,100,36,15121,8.35421888053467
"Lake Katrine CDP, New York",979,936,43,36,40585,4.39223697650664
"Auburn city, New York",12914,11607,1307,36,03078,10.120799132724176
"Ovid village, New York",276,217,59,36,55816,21.3768115942029
"Valley Falls village, New York",206,178,28,36,76672,13.592233009708737
"Solvay village, New York",3182,2802,380,36,68286,11.942174732872408
"Ossining village, New York",9143,8418,725,36,55530,7.929563600568741
"Sands Point village, New York",1023,947,76,36,65035,7.429130009775172
"Oneida Castle village, New York",293,276,17,36,54848,5.802047781569966
"East Hampton North CDP, New York",2954,1753,1201,36,22200,40.656736628300614
"Waverly village, New York",1939,1702,237,36,78806,12.22279525528623
"Tupper Lake village, New York",1937,1735,202,36,75671,10.428497676819823
"Greenport village, New York",1239,838,401,36,30576,32.36481033091202
"Nissequogue village, New York",671,518,153,36,51286,22.801788375558868
"Windsor village, New York",463,400,63,36,82524,13.606911447084233
"Hopewell Junction CDP, New York",159,118,41,36,35573,25.78616352201258
"Leicester village, New York",265,210,55,36,41872,20.754716981132077
"Barker village, New York",230,215,15,36,04440,6.521739130434782
"Jefferson Heights CDP, New York",570,424,146,36,38451,25.6140350877193
"Stamford village, New York",708,579,129,36,70618,18.220338983050848
"Saltaire village, New York",431,4,427,36,64881,99.07192575406032
"Cornwall-on-Hudson village, New York",1048,1014,34,36,18333,3.2442748091603053
"Fillmore CDP, New York",260,200,60,36,25747,23.076923076923077
"Sagaponack village, New York",779,107,672,36,64452,86.26444159178433
"Schenevus CDP, New York",279,210,69,36,65519,24.731182795698924
"South Blooming Grove village, New York",1273,1123,150,36,68610,11.78318931657502
"Ticonderoga CDP, New York",1412,1212,200,36,73880,14.164305949008499
"Westport CDP, New York",364,213,151,36,80764,41.48351648351649
"Woodbury village, New York",3699,3267,432,36,82750,11.678832116788321
"Andes CDP, New York",140,113,27,36,02121,19.28571428571429
"Bedford Hills CDP, New York",1383,1268,115,36,05342,8.315256688358641
"Belfast CDP, New York",360,291,69,36,05562,19.166666666666668
"Belleville CDP, New York",144,126,18,36,05683,12.5
"Binghamton University CDP, New York",8,8,0,36,06644,0.0
"Bliss CDP, New York",246,210,36,36,06904,14.634146341463413
"Blodgett Mills CDP, New York",110,110,0,36,06937,0.0
"Bloomville CDP, New York",107,64,43,36,07025,40.18691588785047
"Bolton Landing CDP, New York",546,254,292,36,07245,53.47985347985348
"Brasher Falls CDP, New York",362,308,54,36,07960,14.917127071823206
"Breesport CDP, New York",222,222,0,36,08004,0.0
"Busti CDP, New York",151,99,52,36,11440,34.437086092715234
"Byersville CDP, New York",17,17,0,36,11550,0.0
"Campbell CDP, New York",333,305,28,36,11935,8.408408408408409
"Chestertown CDP, New York",342,263,79,36,15363,23.099415204678362
"Clarence CDP, New York",1131,1054,77,36,15814,6.80813439434129
"Clarkson CDP, New York",1740,1740,0,36,15946,0.0
"Colton CDP, New York",176,157,19,36,17398,10.795454545454545
"Conesus Hamlet CDP, New York",188,159,29,36,17620,15.425531914893616
"Conesus Lake CDP, New York",2053,1232,821,36,17622,39.99025815879202
"Coopers Plains CDP, New York",221,204,17,36,18036,7.6923076923076925
"Cranberry Lake CDP, New York",361,83,278,36,18817,77.00831024930747
"Crystal Beach CDP, New York",475,400,75,36,19308,15.789473684210526
"Cumminsville CDP, New York",107,107,0,36,19411,0.0
"Cuylerville CDP, New York",157,136,21,36,19510,13.375796178343949
"Dalton CDP, New York",135,130,5,36,19587,3.7037037037037033
"Durhamville CDP, New York",314,266,48,36,21226,15.286624203821656
"Davenport Center CDP, New York",116,94,22,36,19774,18.96551724137931
"DeKalb Junction CDP, New York",225,209,16,36,20049,7.111111111111111
"Downsville CDP, New York",277,217,60,36,20852,21.660649819494584
"East Avon CDP, New York",350,350,0,36,21600,0.0
"Edmeston CDP, New York",366,267,99,36,23602,27.049180327868854
"Eggertsville CDP, New York",6777,6447,330,36,23701,4.869411243913236
"Elizabethtown CDP, New York",368,262,106,36,23822,28.804347826086957
"Erin CDP, New York",172,164,8,36,24625,4.651162790697675
"Felts Mills CDP, New York",184,167,17,36,25571,9.239130434782608
"Fishers Landing CDP, New York",276,32,244,36,25934,88.40579710144928
"Fort Covington Hamlet CDP, New York",591,502,89,36,26752,15.059221658206429
"Fowlerville CDP, New York",58,58,0,36,27133,0.0
"Freedom Plains CDP, New York",202,166,36,36,27452,17.82178217821782
"Gates CDP, New York",2098,2079,19,36,28453,0.905624404194471
"Gilgo CDP, New York",72,72,0,36,28990,0.0
"Glen Aubrey CDP, New York",157,115,42,36,29058,26.751592356687897
"Gorham CDP, New York",230,230,0,36,29520,0.0
"Grandyle Village CDP, New York",2113,1966,147,36,29894,6.956933270231898
"Greigsville CDP, New York",135,113,22,36,30807,16.296296296296298
"Groveland Station CDP, New York",104,93,11,36,31022,10.576923076923077
"Guilford CDP, New York",180,146,34,36,31137,18.88888888888889
"Hadley CDP, New York",528,372,156,36,31258,29.545454545454547
"Hailesboro CDP, New York",324,291,33,36,31346,10.185185185185185
"Hall CDP, New York",81,65,16,36,31533,19.753086419753085
"Hamlin CDP, New York",2097,2030,67,36,31786,3.195040534096328
"Hannawa Falls CDP, New York",554,370,184,36,32006,33.2129963898917
"Hartwick CDP, New York",316,250,66,36,32578,20.88607594936709
"Hemlock CDP, New York",260,194,66,36,33128,25.384615384615383
"Henderson CDP, New York",86,68,18,36,34044,20.930232558139537
"Honeoye CDP, New York",346,302,44,36,35353,12.716763005780345
"Hortonville CDP, New York",142,103,39,36,35738,27.464788732394368
"Hunt CDP, New York",48,48,0,36,36156,0.0
"Hyde Park CDP, New York",849,802,47,36,37198,5.535924617196701
"Katonah CDP, New York",719,650,69,36,38946,9.596662030598054
"Kennedy CDP, New York",204,172,32,36,39243,15.686274509803921
"Keuka Park CDP, New York",178,87,91,36,39463,51.12359550561798
"Kysorville CDP, New York",91,67,24,36,40175,26.373626373626376
"Lakeville CDP, New York",335,335,0,36,41036,0.0
"Lime Lake CDP, New York",624,303,321,36,42345,51.442307692307686
"Linwood CDP, New York",36,36,0,36,42609,0.0
"Livonia Center CDP, New York",141,141,0,36,42972,0.0
"Long Lake CDP, New York",852,120,732,36,43401,85.91549295774648
"Lorraine CDP, New York",48,40,8,36,43533,16.666666666666664
"Machias CDP, New York",209,166,43,36,44226,20.574162679425836
"Madrid CDP, New York",280,248,32,36,44479,11.428571428571429
"Malden-on-Hudson CDP, New York",222,142,80,36,44677,36.03603603603604
"Marion CDP, New York",661,661,0,36,45634,0.0
"Merritt Park CDP, New York",652,603,49,36,46750,7.515337423312883
"Mineville CDP, New York",593,456,137,36,47702,23.102866779089375
"Montrose CDP, New York",1276,1201,75,36,48208,5.877742946708464
"Mountain Lodge Park CDP, New York",807,674,133,36,48750,16.480793060718714
"North Creek CDP, New York",387,237,150,36,51847,38.759689922480625
"North Gates CDP, New York",4558,4299,259,36,52040,5.682316805616498
"North Rose CDP, New York",282,220,62,36,53462,21.98581560283688
"Oak Beach-Captree CDP, New York",166,31,135,36,54112,81.32530120481928
"Old Forge CDP, New York",699,234,465,36,54639,66.52360515021459
"Parishville CDP, New York",373,281,92,36,56363,24.664879356568363
"Ontario CDP, New York",1032,971,61,36,55002,5.910852713178294
"Oxbow CDP, New York",45,34,11,36,55937,24.444444444444443
"Pamelia Center CDP, New York",214,186,28,36,56212,13.084112149532709
"Paul Smiths CDP, New York",0,0,0,36,56770,
"Pavilion CDP, New York",222,217,5,36,56781,2.2522522522522523
"Pierrepont Manor CDP, New York",112,52,60,36,57782,53.57142857142857
"Piffard CDP, New York",131,131,0,36,57804,0.0
"Pike CDP, New York",120,110,10,36,57815,8.333333333333332
"Pine Valley CDP, New York",387,306,81,36,58189,20.930232558139537
"Plessis CDP, New York",66,43,23,36,58739,34.84848484848485
"Port Gibson CDP, New York",162,162,0,36,59322,0.0
"Pottersville CDP, New York",230,148,82,36,59619,35.65217391304348
"Prattsburgh CDP, New York",345,304,41,36,59708,11.884057971014492
"Prattsville CDP, New York",195,92,103,36,59740,52.820512820512825
"Pultneyville CDP, New York",286,257,29,36,59993,10.13986013986014
"Retsof CDP, New York",60,60,0,36,61236,0.0
"Rhinecliff CDP, New York",210,132,78,36,61368,37.142857142857146
"Rodman CDP, New York",81,71,10,36,63330,12.345679012345679
"Romulus CDP, New York",178,148,30,36,63429,16.853932584269664
"Rosendale Hamlet CDP, New York",596,506,90,36,63742,15.100671140939598
"Rushford CDP, New York",205,177,28,36,64155,13.658536585365855
"St. Regis Falls CDP, New York",241,176,65,36,64716,26.970954356846473
"Salisbury Mills CDP, New York",96,73,23,36,64859,23.958333333333336
"Salt Point CDP, New York",64,55,9,36,64892,14.0625
"Sanborn CDP, New York",561,549,12,36,64958,2.13903743315508
"Savannah CDP, New York",217,195,22,36,65332,10.138248847926267
"Schroon Lake CDP, New York",820,304,516,36,65640,62.926829268292686
"Scio CDP, New York",291,255,36,36,65761,12.371134020618557
"Scottsburg CDP, New York",64,33,31,36,65926,48.4375
"Smithville Flats CDP, New York",173,152,21,36,68088,12.138728323699421
"South Lima CDP, New York",104,104,0,36,69364,0.0
"Sparkill CDP, New York",560,560,0,36,70068,0.0
"Springwater Hamlet CDP, New York",169,156,13,36,70477,7.6923076923076925
"Stony Brook University CDP, New York",28,17,11,36,71620,39.285714285714285
"Strykersville CDP, New York",314,282,32,36,71817,10.191082802547772
"Sunset Bay CDP, New York",390,254,136,36,72246,34.87179487179487
"SUNY Oswego CDP, New York",7,7,0,36,72327,0.0
"Thousand Island Park CDP, New York",350,39,311,36,73726,88.85714285714286
"Three Mile Bay CDP, New York",122,100,22,36,73737,18.0327868852459
"Titusville CDP, New York",300,269,31,36,74017,10.333333333333334
"Tuscarora CDP, New York",27,27,0,36,75726,0.0
"University at Buffalo CDP, New York",95,95,0,36,76280,0.0
"Verona CDP, New York",455,351,104,36,77167,22.857142857142858
"Wadsworth CDP, New York",123,123,0,36,77783,0.0
"Wanakah CDP, New York",1359,1275,84,36,78124,6.181015452538632
"Washington Mills CDP, New York",725,725,0,36,78454,0.0
"Watchtower CDP, New York",0,0,0,36,78487,
"Water Mill CDP, New York",2047,759,1288,36,78575,62.92134831460674
"Websters Crossing CDP, New York",48,14,34,36,78982,70.83333333333334
"West Chazy CDP, New York",261,233,28,36,79543,10.727969348659004
"Westmoreland CDP, New York",318,318,0,36,80522,0.0
"West Valley CDP, New York",227,193,34,36,81138,14.977973568281937
"Williamson CDP, New York",1054,1043,11,36,82029,1.0436432637571158
"Willsboro CDP, New York",388,345,43,36,82260,11.082474226804123
"Wilmington CDP, New York",612,350,262,36,82304,42.810457516339866
"Winthrop CDP, New York",85,66,19,36,82612,22.35294117647059
"York Hamlet CDP, New York",210,210,0,36,84035,0.0
"Witherbee CDP, New York",129,129,0,36,82656,0.0
"Woodsville CDP, New York",45,36,9,36,83063,20.0
"Worcester CDP, New York",445,364,81,36,83118,18.202247191011235
"Altmar CDP, New York",188,150,38,36,01550,20.212765957446805
"Lyons CDP, New York",1825,1457,368,36,43962,20.164383561643838
"Prospect CDP, New York",144,120,24,36,59883,16.666666666666664
"Forestville CDP, New York",383,297,86,36,26649,22.45430809399478
"Keeseville CDP, New York",1398,1202,196,36,39089,14.020028612303289
"Salem CDP, New York",394,298,96,36,64771,24.36548223350254
"Barneveld CDP, New York",172,150,22,36,04528,12.790697674418606
"Hermon CDP, New York",221,194,27,36,34165,12.217194570135746
"Herrings CDP, New York",50,47,3,36,34220,6.0
"Macedon CDP, New York",928,855,73,36,44149,7.866379310344827
"Port Henry CDP, New York",677,536,141,36,59333,20.82717872968981
"Beaver Dam Lake CDP, New York",691,615,76,36,05188,10.998552821997105
"Lake Luzerne CDP, New York",733,406,327,36,40651,44.61118690313779
"Limestone CDP, New York",177,177,0,36,42378,0.0
"Loch Sheldrake CDP, New York",1079,336,743,36,43038,68.86005560704356
"Niskayuna CDP, New York",1837,1656,181,36,51262,9.853021230266739
"Quiogue CDP, New York",692,340,352,36,60408,50.86705202312138
"Mastic Beach village, New York",4915,4117,798,36,46085,16.236012207527974
"East Randolph CDP, New York",213,189,24,36,22843,11.267605633802818
"Perrysburg CDP, New York",144,133,11,36,57287,7.638888888888889
"Seneca Falls CDP, New York",2923,2664,259,36,66322,8.860759493670885
"Copake Falls CDP, New York",181,155,26,36,18113,14.3646408839779
"Copake Hamlet CDP, New York",122,97,25,36,18118,20.491803278688526
"Edwards CDP, New York",165,162,3,36,23635,1.8181818181818181
"Randolph CDP, New York",556,493,63,36,60576,11.33093525179856
"Taconic Shores CDP, New York",499,253,246,36,73057,49.298597194388776
"Thendara CDP, New York",159,38,121,36,73495,76.10062893081762
"Virgil CDP, New York",148,148,0,36,77585,0.0
"Wells CDP, New York",514,116,398,36,79048,77.431906614786
"Bridgewater CDP, New York",237,177,60,36,08169,25.31645569620253
"Wagram town, North Carolina",391,311,80,37,70480,20.460358056265985
"Lansing town, North Carolina",90,63,27,37,36960,30.0
"Pantego town, North Carolina",117,92,25,37,50080,21.367521367521366
"Bryson City town, North Carolina",879,633,246,37,08480,27.986348122866893
"Fuquay-Varina town, North Carolina",9157,8828,329,37,25300,3.5928797641148846
"Franklinville town, North Carolina",493,395,98,37,24740,19.878296146044626
"White Plains CDP, North Carolina",614,503,111,37,73460,18.078175895765472
"Norwood town, North Carolina",1470,1038,432,37,47980,29.38775510204082
"Stanfield town, North Carolina",594,551,43,37,64460,7.23905723905724
"Hemby Bridge town, North Carolina",666,632,34,37,30620,5.105105105105105
"Marshville town, North Carolina",1038,955,83,37,41640,7.996146435452794
"Mineral Springs town, North Carolina",1215,1128,87,37,43360,7.160493827160494
"Unionville town, North Carolina",2616,2520,96,37,69260,3.669724770642202
"Kittrell town, North Carolina",69,61,8,37,36020,11.594202898550725
"Seagrove town, North Carolina",146,130,16,37,60080,10.95890410958904
"Thomasville city, North Carolina",12383,11034,1349,37,67420,10.893967536138254
"Foxfire village, North Carolina",605,524,81,37,24570,13.388429752066116
"Everetts town, North Carolina",63,53,10,37,22040,15.873015873015872
"Mountain View CDP, North Carolina",1481,1436,45,37,44770,3.038487508440243
"Sylva town, North Carolina",1300,1061,239,37,66500,18.384615384615387
"Hot Springs town, North Carolina",375,230,145,37,32840,38.666666666666664
"Cameron town, North Carolina",173,133,40,37,09800,23.121387283236995
"Yadkinville town, North Carolina",1255,1091,164,37,75960,13.06772908366534
"Southern Pines town, North Carolina",7093,6180,913,37,63120,12.871845481460594
"Vass town, North Carolina",341,263,78,37,69840,22.87390029325513
"Royal Pines CDP, North Carolina",2033,1793,240,37,58260,11.805213969503198
"Rhodhiss town, North Carolina",495,410,85,37,56240,17.17171717171717
"Stantonsburg town, North Carolina",374,317,57,37,64560,15.240641711229946
"East Bend town, North Carolina",299,234,65,37,19320,21.73913043478261
"Hays CDP, North Carolina",723,631,92,37,30340,12.72475795297372
"Jacksonville city, North Carolina",23897,20963,2934,37,34200,12.277691760472026
"Bayboro town, North Carolina",405,288,117,37,03960,28.888888888888886
"Stonewall town, North Carolina",126,107,19,37,65120,15.079365079365079
"Burgaw town, North Carolina",1295,1138,157,37,08960,12.123552123552123
"Sandyfield town, North Carolina",188,149,39,37,59135,20.74468085106383
"Linden town, North Carolina",58,46,12,37,38360,20.689655172413794
"Harmony town, North Carolina",259,232,27,37,29640,10.424710424710424
"Rural Hall town, North Carolina",1436,1355,81,37,58360,5.64066852367688
"Statesville city, North Carolina",11474,10296,1178,37,64740,10.266689907617222
"Gibsonville town, North Carolina",2634,2512,122,37,25980,4.6317388003037205
"Aulander town, North Carolina",441,316,125,37,02580,28.34467120181406
"Lewiston Woodville town, North Carolina",381,285,96,37,38030,25.196850393700785
"Elizabethtown town, North Carolina",1826,1503,323,37,20600,17.68893756845564
"Swannanoa CDP, North Carolina",2096,1683,413,37,66280,19.704198473282442
"Pittsboro town, North Carolina",1882,1822,60,37,52660,3.1880977683315623
"Brookford town, North Carolina",219,181,38,37,08140,17.35159817351598
"Brices Creek CDP, North Carolina",1367,1321,46,37,07765,3.3650329188002925
"Neuse Forest CDP, North Carolina",686,606,80,37,46280,11.661807580174926
"Southern Shores town, North Carolina",2347,1181,1166,37,63130,49.68044311887516
"Lillington town, North Carolina",1158,985,173,37,38220,14.939550949913643
"Hassell town, North Carolina",26,12,14,37,30040,53.84615384615385
"Franklin town, North Carolina",2493,1886,607,37,24640,24.348174889691133
"Charlotte city, North Carolina",351143,323709,27434,37,12000,7.812771434999416
"Trenton town, North Carolina",189,130,59,37,68320,31.216931216931215
"Harrisburg town, North Carolina",4927,4854,73,37,29800,1.4816318246397402
"Northlakes CDP, North Carolina",565,565,0,37,47695,0.0
"Mesic town, North Carolina",110,87,23,37,42480,20.909090909090907
"Millers Creek CDP, North Carolina",994,788,206,37,43160,20.72434607645875
"Boone town, North Carolina",6988,5704,1284,37,07080,18.37435603892387
"Seven Devils town, North Carolina",589,160,429,37,60505,72.83531409168081
"Vander CDP, North Carolina",675,532,143,37,69740,21.185185185185183
"Wade town, North Carolina",298,243,55,37,70340,18.456375838926174
"Winston-Salem city, North Carolina",107116,94937,12179,37,75000,11.3699167257926
"Hobgood town, North Carolina",201,139,62,37,31860,30.845771144278604
"Love Valley town, North Carolina",142,59,83,37,39420,58.45070422535211
"Troutman town, North Carolina",1112,988,124,37,68500,11.151079136690647
"Drexel town, North Carolina",882,752,130,37,17860,14.73922902494331
"Badin town, North Carolina",707,568,139,37,02960,19.660537482319658
"Dundarrach CDP, North Carolina",34,19,15,37,18300,44.11764705882353
"East Arcadia town, North Carolina",237,210,27,37,19300,11.39240506329114
"Calabash town, North Carolina",1584,841,743,37,09540,46.90656565656566
"Sandy Creek town, North Carolina",107,107,0,37,59090,0.0
"Icard CDP, North Carolina",1105,979,126,37,33320,11.402714932126697
"Harkers Island CDP, North Carolina",1135,578,557,37,29560,49.07488986784141
"Grandfather village, North Carolina",440,45,395,37,27320,89.77272727272727
"Newland town, North Carolina",476,391,85,37,46740,17.857142857142858
"China Grove town, North Carolina",1814,1652,162,37,12480,8.930540242557882
"Castle Hayne CDP, North Carolina",642,559,83,37,10880,12.92834890965732
"Rich Square town, North Carolina",564,410,154,37,56440,27.30496453900709
"Eden city, North Carolina",8097,6619,1478,37,20080,18.253674200321107
"Cleveland town, North Carolina",472,395,77,37,13000,16.3135593220339
"Broadway town, North Carolina",613,562,51,37,08080,8.31973898858075
"Greenevers town, North Carolina",370,328,42,37,27780,11.351351351351353
"Light Oak CDP, North Carolina",488,444,44,37,38170,9.01639344262295
"White Oak CDP, North Carolina",121,121,0,37,73320,0.0
"Holden Beach town, North Carolina",2580,438,2142,37,31960,83.02325581395348
"Leland town, North Carolina",8877,8075,802,37,37680,9.034583755773347
"Atlantic Beach town, North Carolina",4888,912,3976,37,02500,81.34206219312603
"Hildebran town, North Carolina",914,840,74,37,31500,8.096280087527353
"Shelby city, North Carolina",9958,8202,1756,37,61200,17.634063064872464
"Waco town, North Carolina",165,121,44,37,70320,26.666666666666668
"Gorman CDP, North Carolina",326,281,45,37,27120,13.803680981595093
"Como town, North Carolina",41,38,3,37,14060,7.317073170731707
"Murfreesboro town, North Carolina",1214,1044,170,37,45640,14.00329489291598
"Winton town, North Carolina",359,289,70,37,75080,19.498607242339833
"Laurel Park town, North Carolina",1448,1221,227,37,37160,15.676795580110497
"Louisburg town, North Carolina",1435,1217,218,37,39360,15.191637630662022
"Robbinsville town, North Carolina",491,300,191,37,57020,38.90020366598778
"Forest Hills village, North Carolina",158,135,23,37,24170,14.556962025316455
"Biscoe town, North Carolina",821,710,111,37,06000,13.520097442143728
"Troy town, North Carolina",1473,1139,334,37,68520,22.674813306177867
"Boardman town, North Carolina",87,80,7,37,06660,8.045977011494253
"Catawba town, North Carolina",233,205,28,37,10980,12.017167381974248
"Hickory city, North Carolina",18731,16434,2297,37,31060,12.263093267844749
"James City CDP, North Carolina",2677,2345,332,37,34260,12.401942472917444
"Coats town, North Carolina",995,860,135,37,13360,13.5678391959799
"Erwin town, North Carolina",2301,1993,308,37,21740,13.385484571925248
"Jamesville town, North Carolina",260,214,46,37,34320,17.692307692307693
"Oak City town, North Carolina",173,134,39,37,48060,22.54335260115607
"Williamston town, North Carolina",2969,2292,677,37,74220,22.802290333445605
"Davidson town, North Carolina",4707,4273,434,37,16400,9.220310176333122
"Cerro Gordo town, North Carolina",89,69,20,37,11620,22.47191011235955
"Chadbourn town, North Carolina",1138,953,185,37,11640,16.25659050966608
"Shrub Oak CDP, New York",1054,997,57,36,67279,5.407969639468691
"Yonkers city, New York",81894,74848,7046,36,84000,8.603804918553251
"Round Lake village, New York",355,332,23,36,63957,6.478873239436619
"Franklin village, New York",239,165,74,36,27221,30.962343096234306
"Hancock village, New York",744,531,213,36,31940,28.62903225806452
"Margaretville village, New York",364,246,118,36,45557,32.417582417582416
"North Lindenhurst CDP, New York",3799,3581,218,36,53198,5.738352197946829
"Riverhead CDP, New York",5840,5373,467,36,61973,7.9965753424657535
"South Huntington CDP, New York",3587,3302,285,36,69254,7.945358238081962
"Shinnecock Hills CDP, New York",2024,1017,1007,36,67048,49.75296442687747
"Flanders CDP, New York",1835,1354,481,36,26121,26.212534059945504
"Fort Edward village, New York",1505,1381,124,36,26770,8.23920265780731
"Stillwater village, New York",847,735,112,36,71322,13.223140495867769
"West Glens Falls CDP, New York",2847,2714,133,36,80082,4.671584123638918
"Great River CDP, New York",510,425,85,36,30235,16.666666666666664
"Hauppauge CDP, New York",7437,6795,642,36,32732,8.63251311012505
"Lindenhurst village, New York",9544,8839,705,36,42554,7.3868398994132445
"Mattituck CDP, New York",2654,1940,714,36,46140,26.90278824415976
"Orient CDP, New York",899,361,538,36,55321,59.84427141268076
"Melville CDP, New York",7504,6681,823,36,46514,10.967484008528784
"Montauk CDP, New York",4631,1380,3251,36,48054,70.2008205571151
"Oakdale CDP, New York",3086,2838,248,36,54144,8.036292935839274
"Quogue village, New York",1688,336,1352,36,60422,80.09478672985783
"Ridge CDP, New York",6226,5669,557,36,61665,8.946353999357532
"Ronkonkoma CDP, New York",6396,6059,337,36,63473,5.268918073796123
"Bedford CDP, New York",806,685,121,36,05309,15.012406947890819
"Spencer village, New York",373,334,39,36,70167,10.455764075067025
"Catskill village, New York",1872,1406,466,36,13002,24.89316239316239
"Greenville CDP (Greene County), New York",376,274,102,36,30609,27.127659574468083
"Harrison village, New York",8814,8228,586,36,32402,6.648513728159745
"Jefferson Valley-Yorktown CDP, New York",5591,5233,358,36,38500,6.403147916294044
"Lake Mohegan CDP, New York",2041,1954,87,36,40689,4.262616364527193
"Milton CDP (Ulster County), New York",582,536,46,36,47554,7.903780068728522
"Greenwich village, New York",885,753,132,36,30675,14.915254237288137
"Holley village, New York",882,793,89,36,35155,10.090702947845804
"Bohemia CDP, New York",3483,3383,100,36,07157,2.8710881424059718
"Medford CDP, New York",8328,7956,372,36,46404,4.46685878962536
"Town Line CDP, New York",767,683,84,36,75121,10.951760104302476
"Sherburne village, New York",712,680,32,36,66883,4.49438202247191
"Farnham village, New York",191,170,21,36,25428,10.99476439790576
"Sherman village, New York",320,300,20,36,66949,6.25
"Sharon Springs village, New York",309,213,96,36,66663,31.06796116504854
"Greenvale CDP, New York",493,469,24,36,30598,4.86815415821501
"Island Park village, New York",1771,1610,161,36,37847,9.090909090909092
"Saddle Rock village, New York",274,236,38,36,64430,13.86861313868613
"Cortland West CDP, New York",570,530,40,36,18443,7.017543859649122
"Angelica village, New York",395,324,71,36,02176,17.974683544303797
"East Meadow CDP, New York",12801,12217,584,36,22502,4.562143582532615
"Massapequa CDP, New York",7611,7191,420,36,45986,5.518328734726055
"Celoron village, New York",558,454,104,36,13288,18.63799283154122
"Cherry Valley village, New York",300,226,74,36,15242,24.666666666666668
"Milford village, New York",222,180,42,36,47229,18.91891891891892
"Richfield Springs village, New York",627,492,135,36,61489,21.5311004784689
"Sidney village, New York",2187,1729,458,36,67334,20.94192958390489
"Walton village, New York",1542,1258,284,36,78036,18.417639429312583
"Albany city, New York",48625,41207,7418,36,01000,15.255526992287919
"Hoosick Falls village, New York",1732,1425,307,36,35474,17.725173210161664
"New York city, New York",3472354,3154103,318251,36,51000,9.165280959257034
"Bloomfield village, New York",670,603,67,36,06945,10.0
"Phelps village, New York",829,764,65,36,57518,7.840772014475271
"Falconer village, New York",1235,1097,138,36,25164,11.17408906882591
"Jamestown city, New York",15035,12652,2383,36,38264,15.849684070502162
"Silver Creek village, New York",1157,970,187,36,67411,16.16248919619706
"Turin village, New York",144,87,57,36,75682,39.58333333333333
"Woodmere CDP, New York",5396,5140,256,36,82942,4.744255003706449
"Plandome Manor village, New York",279,259,20,36,58497,7.168458781362006
"South Floral Park village, New York",587,562,25,36,69023,4.258943781942079
"Westbury village, New York",5223,4918,305,36,79444,5.839555810836684
"Woodsburgh village, New York",282,268,14,36,82986,4.964539007092199
"Clark Mills CDP, New York",858,798,60,36,15902,6.993006993006993
"Holland Patent village, New York",203,166,37,36,35144,18.226600985221676
"Oriskany Falls village, New York",358,325,33,36,55376,9.217877094972067
"Mechanicstown CDP, New York",3192,2941,251,36,46349,7.863408521303258
"Tuxedo Park village, New York",360,233,127,36,75803,35.27777777777778
"Balmville CDP, New York",1297,1178,119,36,04286,9.175019275250579
"Washingtonville village, New York",2190,2122,68,36,78465,3.105022831050228
"Phoenix village, New York",1171,1086,85,36,57661,7.2587532023911185
"Sandy Creek village, New York",341,302,39,36,65068,11.436950146627565
"Florida village, New York",1066,1008,58,36,26319,5.440900562851782
"Greenwood Lake village, New York",1650,1218,432,36,30752,26.181818181818183
"Middletown city, New York",11504,10331,1173,36,47042,10.19645340751043
"New Windsor CDP, New York",3800,3506,294,36,50837,7.7368421052631575
"Walden village, New York",2399,2210,189,36,77849,7.878282617757399
"West Point CDP, New York",1021,882,139,36,80747,13.614103819784527
"Chester village, New York",1578,1418,160,36,15297,10.139416983523446
"Fishkill village, New York",1104,980,124,36,25967,11.231884057971014
"Myers Corner CDP, New York",2561,2359,202,36,49363,7.8875439281530655
"Pine Plains CDP, New York",576,551,25,36,58145,4.340277777777778
"Arlington CDP, New York",1222,1090,132,36,02616,10.801963993453354
"Philmont village, New York",693,568,125,36,57639,18.037518037518037
"Brighton CDP, New York",16362,15441,921,36,08257,5.628896222955629
"Rochester city, New York",99510,86057,13453,36,63000,13.519244297055572
"Stony Point CDP, New York",4757,4376,381,36,71663,8.009249527012823
"Upper Nyack village, New York",814,784,30,36,76386,3.6855036855036856
"West Haverstraw village, New York",3093,3071,22,36,80203,0.7112835434852893
"Canton village, New York",1801,1513,288,36,12331,15.991116046640755
"Bardonia CDP, New York",1321,1321,0,36,04396,0.0
"Piermont village, New York",1323,1184,139,36,57749,10.506424792139079
"Sloatsburg village, New York",1168,1087,81,36,67708,6.934931506849315
"Massena village, New York",4986,4635,351,36,46019,7.039711191335741
"Potsdam village, New York",2476,2107,369,36,59564,14.90306946688207
"Unadilla village, New York",528,462,66,36,76001,12.5
"Highland CDP, New York",2408,2101,307,36,34484,12.749169435215945
"Lincoln Park CDP, New York",1174,1121,53,36,42488,4.514480408858603
"Marlboro CDP, New York",1704,1520,184,36,45700,10.7981220657277
"New Paltz village, New York",2288,1935,353,36,50551,15.428321678321677
"Pine Hill CDP, New York",348,91,257,36,58057,73.85057471264368
"Deposit village, New York",979,669,310,36,20346,31.66496424923391
"Corinth village, New York",1098,981,117,36,18212,10.655737704918032
"North Ballston Spa CDP, New York",746,703,43,36,51467,5.7640750670241285
"East Greenbush CDP, New York",1923,1821,102,36,22106,5.30421216848674
"Thornwood CDP, New York",1397,1316,81,36,73715,5.798138869005011
"White Plains city, New York",24467,22929,1538,36,81677,6.286017901663465
"Antwerp village, New York",252,221,31,36,02286,12.3015873015873
"Southampton village, New York",3513,1352,2161,36,68462,61.514375177910615
"Olean city, New York",7142,6158,984,36,54716,13.777653318398208
"Yorkshire CDP, New York",656,573,83,36,84044,12.652439024390244
"Schuylerville village, New York",641,614,27,36,65750,4.212168486739469
"Glens Falls city, New York",7263,6466,797,36,29333,10.97342695855707
"Ravena village, New York",1518,1363,155,36,60675,10.210803689064559
"Hamburg village, New York",4228,4033,195,36,31643,4.612109744560076
"Harris Hill CDP, New York",2312,2268,44,36,32391,1.9031141868512111
"Lake Erie Beach CDP, New York",2194,1649,545,36,40486,24.840474020054696
"Lancaster village, New York",4907,4600,307,36,41135,6.256368453230079
"Cayuga Heights village, New York",1643,1561,82,36,13079,4.990870359099208
"Westvale CDP, New York",2049,1983,66,36,81127,3.22108345534407
"Attica village, New York",1322,1239,83,36,03001,6.278366111951589
"Gainesville village, New York",120,101,19,36,27969,15.833333333333332
"Amsterdam city, New York",9074,7238,1836,36,02066,20.233634560282123
"Ames village, New York",55,52,3,36,01737,5.454545454545454
"Morrisonville CDP, New York",607,577,30,36,48538,4.942339373970346
"Fultonville village, New York",387,251,136,36,27859,35.14211886304909
"Duanesburg CDP, New York",222,127,95,36,20995,42.792792792792795
"Fair Haven village, New York",670,402,268,36,24988,40.0
"Rouses Point village, New York",1126,1009,117,36,63979,10.390763765541742
"Cohoes city, New York",8496,7484,1012,36,16749,11.911487758945386
"Plainview CDP, New York",9400,8913,487,36,58442,5.180851063829787
"Port Washington North village, New York",1258,1229,29,36,59531,2.305246422893482
"Roslyn Harbor village, New York",368,326,42,36,63803,11.41304347826087
"Searingtown CDP, New York",1559,1433,126,36,66102,8.082103912764593
"Thomaston village, New York",1004,949,55,36,73605,5.47808764940239
"Clayville village, New York",146,105,41,36,16111,28.08219178082192
"New Hartford village, New York",915,769,146,36,50298,15.956284153005464
"Vernon village, New York",544,502,42,36,77112,7.720588235294118
"Whitesboro village, New York",2003,1714,289,36,81710,14.428357463804293
"Fairmount CDP, New York",4416,4134,282,36,25043,6.385869565217392
"Village Green CDP, New York",1933,1885,48,36,77513,2.4831867563372994
"Bay Park CDP, New York",735,647,88,36,04891,11.972789115646258
"McGraw village, New York",425,356,69,36,44193,16.235294117647058
"Munsons Corners CDP, New York",1193,1108,85,36,49242,7.124895222129086
"Barnum Island CDP, New York",955,922,33,36,04550,3.4554973821989527
"Bellerose village, New York",428,399,29,36,05639,6.775700934579438
"Bellmore CDP, New York",5619,5384,235,36,05738,4.182238832532479
"East Rockaway village, New York",4124,3761,363,36,22876,8.802133850630456
"Garden City Park CDP, New York",2570,2502,68,36,28189,2.6459143968871595
"Canajoharie village, New York",911,829,82,36,12111,9.001097694840835
"Duane Lake CDP, New York",107,92,15,36,20989,14.018691588785046
"East Glenville CDP, New York",2688,2203,485,36,22084,18.043154761904763
"Scotia village, New York",3746,3061,685,36,65893,18.286171916711158
"Northville village, New York",597,449,148,36,53770,24.79061976549414
"Cleveland village, New York",314,283,31,36,16188,9.872611464968154
"Mexico village, New York",729,642,87,36,46811,11.934156378600823
"Monticello village, New York",3306,2430,876,36,48175,26.497277676950997
"Goshen village, New York",2275,1990,285,36,29542,12.527472527472527
"Highland Falls village, New York",1872,1662,210,36,34495,11.217948717948719
"Maybrook village, New York",1525,1370,155,36,46162,10.163934426229508
"Lacona village, New York",283,250,33,36,40200,11.66077738515901
"Minetto CDP, New York",505,467,38,36,47680,7.524752475247524
"Liberty village, New York",1882,1469,413,36,42224,21.944739638682254
"Monroe village, New York",2746,2584,162,36,47988,5.8994901675163876
"Smallwood CDP, New York",1097,241,856,36,67730,78.03099361896079
"Wurtsboro village, New York",535,460,75,36,83272,14.018691588785046
"Montgomery village, New York",1703,1573,130,36,48142,7.633587786259542
"Newburgh city, New York",11765,9358,2407,36,50034,20.458988525286866
"Unionville village, New York",326,260,66,36,76210,20.245398773006134
"Washington Heights CDP, New York",851,714,137,36,78421,16.09870740305523
"Verplanck CDP, New York",582,467,115,36,77211,19.759450171821307
"Phoenicia CDP, New York",206,183,23,36,57650,11.165048543689322
"Athens village, New York",775,644,131,36,02902,16.903225806451612
"Accord CDP, New York",229,182,47,36,00155,20.52401746724891
"Napanoch CDP, New York",557,464,93,36,49418,16.696588868940754
"Port Ewen CDP, New York",1652,1449,203,36,59311,12.288135593220339
"Saugerties South CDP, New York",844,756,88,36,65310,10.42654028436019
"Stone Ridge CDP, New York",444,428,16,36,71597,3.6036036036036037
"Wallkill CDP, New York",987,773,214,36,78003,21.681864235055727
"West Hurley CDP, New York",1035,894,141,36,80291,13.623188405797102
"Waterford village, New York",1048,958,90,36,78520,8.587786259541986
"Woodstock CDP, New York",1602,1096,506,36,83041,31.585518102372035
"Cambridge village, New York",954,824,130,36,11825,13.626834381551362
"Hudson Falls village, New York",3324,2901,423,36,35980,12.725631768953068
"Lake George village, New York",700,494,206,36,40508,29.428571428571427
"Chateaugay village, New York",405,313,92,36,13981,22.71604938271605
"Malone village, New York",2703,2501,202,36,44710,7.473177950425453
"Aquebogue CDP, New York",1145,792,353,36,02374,30.829694323144103
"Bridgehampton CDP, New York",2592,534,2058,36,08136,79.39814814814815
"Little Valley village, New York",493,445,48,36,42829,9.73630831643002
"Centerport CDP, New York",2151,1938,213,36,13442,9.902370990237099
"Dix Hills CDP, New York",8875,8269,606,36,20687,6.828169014084507
"West Babylon CDP, New York",14161,13351,810,36,79246,5.7199350328366645
"Brownville village, New York",435,407,28,36,10231,6.436781609195402
"Natural Bridge CDP, New York",135,135,0,36,49605,0.0
"Laurens village, New York",117,77,40,36,41520,34.18803418803419
"Ellenville village, New York",1849,1592,257,36,23965,13.899405083829098
"Gardiner CDP, New York",353,307,46,36,28244,13.031161473087819
"Hurley CDP, New York",1542,1398,144,36,37132,9.33852140077821
"Shokan CDP, New York",489,453,36,36,67081,7.361963190184049
"Zena CDP, New York",533,433,100,36,84187,18.76172607879925
"Averill Park CDP, New York",610,610,0,36,03320,0.0
"Rensselaer city, New York",4684,4109,575,36,61148,12.275832621690864
"Oxford village, New York",757,680,77,36,55948,10.171730515191546
"Bayville village, New York",2705,2500,205,36,05034,7.578558225508318
"Bethpage CDP, New York",6206,5911,295,36,06387,4.753464389300676
"Carle Place CDP, New York",1889,1757,132,36,12419,6.987824245632609
"Rifton CDP, New York",128,128,0,36,61797,0.0
"Saugerties village, New York",1946,1765,181,36,65288,9.301130524152107
"Walker Valley CDP, New York",405,355,50,36,77948,12.345679012345679
"Geneva city, New York",5062,4545,517,36,28640,10.213354405373371
"Bolivar village, New York",492,435,57,36,07190,11.585365853658537
"Cuba village, New York",724,582,142,36,19356,19.613259668508288
"Wellsville village, New York",2389,2164,225,36,79092,9.41816659690247
"Green Island village, New York",1355,1247,108,36,30521,7.970479704797048
"Sloan village, New York",1640,1640,0,36,67686,0.0
"Aurora village, New York",180,118,62,36,03188,34.44444444444444
"Cayuga village, New York",255,220,35,36,13068,13.725490196078432
"Weedsport village, New York",868,769,99,36,79015,11.405529953917052
"Jamesport CDP, New York",1358,446,912,36,38253,67.15758468335787
"Lake Ronkonkoma CDP, New York",7164,6770,394,36,40838,5.499720826353992
"Mastic CDP, New York",4574,4079,495,36,46074,10.822037603847836
"North Bay Shore CDP, New York",4719,4347,372,36,51495,7.8830260648442465
"North Haven village, New York",820,383,437,36,52188,53.29268292682927
"Port Jefferson village, New York",3230,3030,200,36,59355,6.191950464396285
"Riverside CDP, New York",706,512,194,36,62066,27.47875354107649
"Selden CDP, New York",6775,6214,561,36,66212,8.280442804428043
"Smithtown CDP, New York",9369,8888,481,36,67851,5.133952396200235
"Sound Beach CDP, New York",3055,2737,318,36,68374,10.409165302782323
"Westhampton CDP, New York",2166,983,1183,36,80170,54.61680517082179
"Westhampton Beach village, New York",2360,721,1639,36,80181,69.44915254237289
"Salamanca city, New York",2626,2170,456,36,64749,17.364813404417365
"Poquott village, New York",384,346,38,36,59157,9.895833333333332
"Rocky Point CDP, New York",5151,4491,660,36,63319,12.8130460104834
"Shelter Island Heights CDP, New York",1800,450,1350,36,66850,75.0
"Stony Brook CDP, New York",4929,4487,442,36,71608,8.967336173666059
"Cragsmoor CDP, New York",271,153,118,36,18762,43.542435424354245
"Ellicottville village, New York",546,144,402,36,24020,73.62637362637363
"Black River village, New York",592,513,79,36,06794,13.344594594594595
"Carthage village, New York",1479,1245,234,36,12683,15.821501014198782
"High Falls CDP, New York",269,269,0,36,34451,0.0
"Delhi village, New York",897,779,118,36,20126,13.154960981047935
"Redwood CDP, New York",271,200,71,36,61016,26.199261992619927
"Sackets Harbor village, New York",1017,816,201,36,64408,19.76401179941003
"Cheektowaga CDP, New York",35424,33144,2280,36,15000,6.436314363143632
"Nelsonville village, New York",258,238,20,36,49781,7.751937984496124
"Rye Brook village, New York",3588,3369,219,36,64325,6.103678929765886
"Tuckahoe village, New York",2941,2741,200,36,75583,6.800408024481469
"Elma Center CDP, New York",1203,1203,0,36,24141,0.0
"Middleport village, New York",825,726,99,36,46998,12.0
"Avoca village, New York",425,362,63,36,03331,14.823529411764705
"North Hornell village, New York",346,310,36,36,53055,10.404624277456648
"Carmel Hamlet CDP, New York",2619,2433,186,36,12532,7.101947308132875
"Mamaroneck village, New York",7424,7027,397,36,44831,5.347521551724138
"Mount Vernon city, New York",27427,25248,2179,36,49121,7.94472599992708
"Peekskill city, New York",10688,9628,1060,36,56979,9.917664670658683
"Rye city, New York",5831,5573,258,36,64309,4.424626993654605
"Scotts Corners CDP, New York",351,296,55,36,65948,15.669515669515668
"Tarrytown village, New York",4646,4413,233,36,73176,5.015066724063711
"Johnstown city, New York",3735,3447,288,36,38781,7.710843373493977
"Central Square village, New York",997,890,107,36,13585,10.732196589769307
"Narrowsburg CDP, New York",264,173,91,36,49473,34.46969696969697
"Roscoe CDP, New York",331,249,82,36,63583,24.773413897280967
"Gardnertown CDP, New York",1853,1697,156,36,28310,8.41878035617917
"Otisville village, New York",444,403,41,36,55673,9.234234234234235
"Port Jervis city, New York",4652,3897,755,36,59388,16.22957867583835
"Manorville CDP, New York",5175,4926,249,36,45139,4.811594202898551
"Huntington Bay village, New York",596,522,74,36,37022,12.416107382550337
"Islip CDP, New York",6405,5934,471,36,37869,7.3536299765807955
"Islip Terrace CDP, New York",1712,1610,102,36,38022,5.957943925233645
"Moriches CDP, New York",1654,1548,106,36,48450,6.408706166868199
"Mount Sinai CDP, New York",4114,4024,90,36,49066,2.1876519202722413
"North Great River CDP, New York",1488,1327,161,36,52078,10.81989247311828
"Port Jefferson Station CDP, New York",2924,2702,222,36,59377,7.59233926128591
"Remsenburg-Speonk CDP, New York",1779,846,933,36,61142,52.4451939291737
"St. James CDP, New York",5016,4687,329,36,64584,6.559011164274323
"Shelter Island CDP, New York",1430,755,675,36,66828,47.2027972027972
"Shirley CDP, New York",9150,8406,744,36,67070,8.131147540983607
"Shoreham village, New York",194,162,32,36,67191,16.49484536082474
"Fire Island CDP, New York",3473,76,3397,36,25839,97.81169018139937
"Cooperstown village, New York",1102,882,220,36,18047,19.96370235934664
"Mechanicville city, New York",2535,2310,225,36,46360,8.875739644970414
"Floral Park village, New York",5882,5706,176,36,26264,2.992179530771846
"Freeport village, New York",14713,14021,692,36,27485,4.703323591381771
"Garden City village, New York",7626,7365,261,36,28178,3.4225019669551533
"East Farmingdale CDP, New York",1960,1827,133,36,21985,6.785714285714286
"East Marion CDP, New York",1119,449,670,36,22447,59.87488829311886
"Glens Falls North CDP, New York",4102,3721,381,36,29338,9.288152120916626
"Tannersville village, New York",714,346,368,36,73143,51.540616246498594
"Oakfield village, New York",697,632,65,36,54155,9.32568149210904
"Briarcliff Manor village, New York",2846,2661,185,36,08103,6.500351370344343
"Bronxville village, New York",2370,2190,180,36,08532,7.59493670886076
"Mount Kisco village, New York",4271,4036,235,36,48890,5.502224303441817
"Centre Island village, New York",261,184,77,36,13618,29.50191570881226
"Chittenango village, New York",1922,1732,190,36,15561,9.88553590010406
"Larchmont village, New York",2033,2033,0,36,41333,0.0
"Pleasantville village, New York",2781,2548,233,36,58728,8.378281193815175
"Atlantic Beach village, New York",910,601,309,36,02968,33.956043956043956
"Baldwin CDP, New York",8175,7894,281,36,04143,3.437308868501529
"Cedarhurst village, New York",1986,1888,98,36,13233,4.934541792547835
"East Massapequa CDP, New York",7353,6794,559,36,22480,7.602339181286549
"Garden City South CDP, New York",1353,1332,21,36,28200,1.5521064301552108
"Great Neck village, New York",3386,3089,297,36,30169,8.771411695215594
"Kings Point village, New York",1499,1306,193,36,39694,12.875250166777851
"Lido Beach CDP, New York",1332,1203,129,36,42279,9.684684684684685
"Matinecock village, New York",313,273,40,36,46107,12.779552715654951
"Mill Neck village, New York",410,341,69,36,47405,16.82926829268293
"Munsey Park village, New York",808,790,18,36,49231,2.2277227722772275
"North Merrick CDP, New York",4001,3884,117,36,53264,2.9242689327668083
"East Nassau village, New York",272,216,56,36,22557,20.588235294117645
"Menands village, New York",1793,1659,134,36,46536,7.473508087005019
"Mannsville village, New York",138,122,16,36,45073,11.594202898550725
"Nelliston village, New York",270,218,52,36,49748,19.25925925925926
"Firthcliffe CDP, New York",2221,2012,209,36,25857,9.410175596578119
"Seaford CDP, New York",5175,5083,92,36,66058,1.7777777777777777
"Wyoming village, New York",169,153,16,36,83371,9.467455621301776
"Brewster Hill CDP, New York",789,738,51,36,08092,6.4638783269961975
"Hammond village, New York",164,107,57,36,31830,34.756097560975604
"Harrisville village, New York",293,232,61,36,32424,20.819112627986346
"Clinton village, New York",824,727,97,36,16419,11.771844660194175
"Alden village, New York",1227,1173,54,36,01088,4.400977995110025
"Sodus Point village, New York",744,462,282,36,68242,37.903225806451616
"Hillside Lake CDP, New York",409,339,70,36,34803,17.114914425427873
"Churchville village, New York",981,911,70,36,15638,7.135575942915392
"West Nyack CDP, New York",1470,1470,0,36,80599,0.0
"Cold Brook village, New York",139,117,22,36,16815,15.827338129496402
"Chatham village, New York",931,713,218,36,14003,23.415682062298604
"Spencerport village, New York",1484,1438,46,36,70189,3.0997304582210243
"Sayville CDP, New York",5903,5547,356,36,65409,6.030831780450619
"Wading River CDP, New York",3182,2642,540,36,77772,16.97045883092395
"Argyle village, New York",242,206,36,36,02550,14.87603305785124
"Northampton CDP, New York",347,203,144,36,51418,41.4985590778098
"Allegany village, New York",898,742,156,36,01286,17.37193763919822
"Sag Harbor village, New York",1960,993,967,36,64485,49.336734693877546
"Franklinville village, New York",797,633,164,36,27331,20.5771643663739
"Hillside CDP, New York",373,342,31,36,34786,8.310991957104557
"North Collins village, New York",539,478,61,36,51792,11.317254174397032
"East Atlantic Beach CDP, New York",964,760,204,36,21578,21.16182572614108
"Malverne Park Oaks CDP, New York",188,151,37,36,44792,19.680851063829788
"Oceanside CDP, New York",11069,10618,451,36,54441,4.074442135694281
"Angola on the Lake CDP, New York",974,796,178,36,02220,18.275154004106774
"Baxter Estates village, New York",501,451,50,36,04803,9.980039920159681
"Stannards CDP, New York",363,271,92,36,70717,25.344352617079892
"Williamsville village, New York",2642,2431,211,36,82084,7.986373959121877
"Northwest Ithaca CDP, New York",657,537,120,36,53853,18.2648401826484
"Woodridge village, New York",748,301,447,36,82953,59.759358288770045
"Heritage Hills CDP, New York",2681,2373,308,36,34118,11.488250652741515
"Lattingtown village, New York",737,632,105,36,41432,14.246947082767978
"Lyndonville village, New York",337,301,36,36,43918,10.682492581602373
"Harbor Isle CDP, New York",395,395,0,36,32105,0.0
"Hicksville CDP, New York",14177,13296,881,36,34374,6.2142907526274955
"Levittown CDP, New York",16790,16391,399,36,42081,2.3764145324597976
"Locust Valley CDP, New York",1350,1246,104,36,43192,7.703703703703704
"Lynbrook village, New York",7508,7168,340,36,43874,4.528502930207779
"Manhasset CDP, New York",2980,2744,236,36,44897,7.919463087248323
"North Valley Stream CDP, New York",5755,5570,185,36,53748,3.214596003475239
"Old Brookville village, New York",635,550,85,36,54562,13.385826771653544
"Oyster Bay CDP, New York",3067,2675,392,36,55992,12.781219432670362
"Plainedge CDP, New York",3048,2972,76,36,58409,2.493438320209974
"Rockville Centre village, New York",9746,9458,288,36,63264,2.9550584855325264
"Remsen village, New York",241,167,74,36,61115,30.70539419087137
"Sherrill city, New York",1271,1271,0,36,66993,0.0
"Sylvan Beach village, New York",800,346,454,36,72521,56.75
"Yorkville village, New York",1182,1080,102,36,84099,8.629441624365482
"Camillus village, New York",620,563,57,36,11902,9.193548387096774
"Fabius village, New York",148,135,13,36,24867,8.783783783783784
"Clifton Springs village, New York",992,942,50,36,16375,5.040322580645161
"Huntington CDP, New York",7697,7053,644,36,36233,8.366896193322074
"Huntington Station CDP, New York",11466,10017,1449,36,37044,12.637362637362637
"Lloyd Harbor village, New York",1470,1234,236,36,43005,16.054421768707485
"Northville CDP, New York",810,583,227,36,53775,28.02469135802469
"Northwest Harbor CDP, New York",3487,1654,1833,36,53852,52.56667622598222
"Old Field village, New York",332,301,31,36,54617,9.33734939759036
"Setauket-East Setauket CDP, New York",5524,4865,659,36,66481,11.929761042722664
"Wainscott CDP, New York",945,132,813,36,77805,86.03174603174604
"Cattaraugus village, New York",444,418,26,36,13024,5.8558558558558556
"South Dayton village, New York",329,277,52,36,68891,15.80547112462006
"West Carthage village, New York",791,718,73,36,79499,9.22882427307206
"Speculator village, New York",522,72,450,36,70123,86.20689655172413
"Fleischmanns village, New York",256,98,158,36,26209,61.71875
"Ballston Spa village, New York",2524,2272,252,36,04253,9.984152139461171
"Milton CDP (Saratoga County), New York",1268,1268,0,36,47548,0.0
"Hewlett Neck village, New York",149,143,6,36,34319,4.026845637583892
"Jericho CDP, New York",4890,4682,208,36,38539,4.25357873210634
"Lawrence village, New York",2392,2162,230,36,41553,9.615384615384617
"Manorhaven village, New York",2798,2457,341,36,45106,12.187276626161545
"Merrick CDP, New York",7331,6906,425,36,46668,5.797299140635657
"Mineola village, New York",7661,7456,205,36,47636,2.6758908758647695
"New Cassel CDP, New York",3466,3290,176,36,50067,5.077899596076168
"North Hills village, New York",2856,2658,198,36,53022,6.932773109243698
"Jamestown West CDP, New York",1129,1068,61,36,38275,5.403011514614704
"Sinclairville village, New York",307,279,28,36,67488,9.120521172638437
"Castorland village, New York",139,119,20,36,12881,14.388489208633093
"Livonia village, New York",551,527,24,36,42950,4.3557168784029034
"Norwood village, New York",765,711,54,36,54012,7.0588235294117645
"Binghamton city, New York",23734,19873,3861,36,06607,16.267801466250948
"Whitney Point village, New York",451,390,61,36,81831,13.52549889135255
"Bergen village, New York",441,426,15,36,06046,3.4013605442176873
"West Hampton Dunes village, New York",265,28,237,36,80186,89.43396226415095
"Apalachin CDP, New York",554,528,26,36,02308,4.693140794223827
"Newark Valley village, New York",475,388,87,36,49902,18.31578947368421
"Cairo CDP, New York",643,439,204,36,11638,31.726283048211506
"Haviland CDP, New York",1410,1351,59,36,32776,4.184397163120567
"Palenville CDP, New York",535,393,142,36,56132,26.542056074766357
"Poland village, New York",173,143,30,36,58937,17.341040462427745
"Crown Heights CDP, New York",1090,1053,37,36,19229,3.3944954128440368
"Pawling village, New York",1000,897,103,36,56814,10.299999999999999
"Red Oaks Mill CDP, New York",1311,1236,75,36,60983,5.720823798627003
"Hillcrest CDP, New York",1918,1792,126,36,34693,6.569343065693431
"Mount Ivy CDP, New York",2916,2648,268,36,48879,9.190672153635116
"Preston-Potter Hollow CDP, New York",241,118,123,36,59831,51.037344398340245
"Shortsville village, New York",558,517,41,36,67257,7.347670250896058
"Lakeland CDP, New York",1130,1094,36,36,40607,3.185840707964602
"Skaneateles village, New York",1297,1089,208,36,67510,16.037008481110256
"Warrensburg CDP, New York",1665,1398,267,36,78289,16.036036036036037
"Little Falls city, New York",2444,1820,624,36,42741,25.53191489361702
"Newport village, New York",274,253,21,36,50573,7.664233576642336
"Copake Lake CDP, New York",750,228,522,36,18124,69.6
"Granville village, New York",1248,1146,102,36,30026,8.173076923076923
"Victory village, New York",255,204,51,36,77431,20.0
"Bay Shore CDP, New York",9651,9081,570,36,04935,5.906123717749456
"Calverton CDP, New York",3639,3330,309,36,11781,8.491343775762573
"Commack CDP, New York",12498,11978,520,36,17530,4.160665706513042
"Dering Harbor village, New York",38,0,38,36,20379,100.0
"East Hampton village, New York",1893,517,1376,36,22183,72.68885367142103
"Islandia village, New York",1069,960,109,36,37840,10.19644527595884
"Lake Grove village, New York",4058,3894,164,36,40530,4.0413997042878265
"Laurel CDP, New York",827,408,419,36,41465,50.66505441354293
"Middle Island CDP, New York",4449,4146,303,36,46976,6.810519217801753
"North Babylon CDP, New York",5983,5646,337,36,51440,5.632625773023567
"North Bellport CDP, New York",3830,3530,300,36,51528,7.83289817232376
"Ocean Beach village, New York",625,14,611,36,54430,97.76
"Endicott village, New York",6812,5697,1115,36,24515,16.368173810921903
"Endwell CDP, New York",5660,5207,453,36,24526,8.003533568904594
"Amenia CDP, New York",470,444,26,36,01682,5.531914893617021
"Brinckerhoff CDP, New York",993,968,25,36,08334,2.5176233635448138
"Dover Plains CDP, New York",651,544,107,36,20841,16.43625192012289
"Fairview CDP (Dutchess County), New York",2039,1759,280,36,25109,13.732221677292792
"Millerton village, New York",447,416,31,36,47361,6.935123042505594
"Staatsburg CDP, New York",184,158,26,36,70552,14.130434782608695
"Avon village, New York",1361,1328,33,36,03353,2.4246877296105804
"Dansville village, New York",2157,2036,121,36,19664,5.609643022716736
"Nunda village, New York",594,538,56,36,54078,9.427609427609427
"Leeds CDP, New York",140,96,44,36,41784,31.428571428571427
"Fairview CDP (Westchester County), New York",1160,1092,68,36,25120,5.862068965517241
"Coxsackie village, New York",1253,1038,215,36,18718,17.158818834796488
"Hunter village, New York",945,305,640,36,36167,67.72486772486772
"Glasco CDP, New York",1052,973,79,36,29014,7.509505703422054
"Kingston city, New York",10592,9361,1231,36,39727,11.621978851963746
"Plattekill CDP, New York",348,311,37,36,58541,10.632183908045976
"Tillson CDP, New York",683,620,63,36,73902,9.224011713030746
"Saranac Lake village, New York",3186,2489,697,36,65233,21.876961707470183
"Albion village, New York",2564,2274,290,36,01033,11.310452418096723
"Medina village, New York",2842,2691,151,36,46415,5.313159746657284
"Baywood CDP, New York",2292,2187,105,36,05039,4.5811518324607325
"Brightwaters village, New York",1166,1144,22,36,08323,1.8867924528301887
"Brookhaven CDP, New York",1242,1124,118,36,09000,9.500805152979067
"East Patchogue CDP, New York",8641,8248,393,36,22733,4.548084712417545
"Westmere CDP, New York",3339,3173,166,36,80423,4.9715483677747825
"Melrose Park CDP, New York",880,832,48,36,46503,5.454545454545454
"Meridian village, New York",111,102,9,36,46646,8.108108108108109
"Voorheesville village, New York",1191,1097,94,36,77684,7.892527287993283
"Angola village, New York",963,844,119,36,02198,12.357217030114226
"Clarence Center CDP, New York",1068,1033,35,36,15836,3.2771535580524342
"Gowanda village, New York",1276,1191,85,36,29630,6.661442006269593
"North Boston CDP, New York",1229,1229,0,36,51583,0.0
"Dunkirk city, New York",5845,5182,663,36,21105,11.343028229255774
"Panama village, New York",200,180,20,36,56231,10.0
"Croghan village, New York",317,267,50,36,19070,15.772870662460567
"Lowville village, New York",1507,1338,169,36,43720,11.214333112143331
"Montour Falls village, New York",779,682,97,36,48197,12.45186136071887
"Lodi village, New York",176,153,23,36,43214,13.068181818181818
"Waterloo village, New York",2188,1991,197,36,78553,9.0036563071298
"Alfred village, New York",498,382,116,36,01198,23.293172690763054
"Canaseraga village, New York",257,207,50,36,12177,19.45525291828794
"Houghton CDP, New York",302,282,20,36,35771,6.622516556291391
"Gatesville town, North Carolina",146,120,26,37,25680,17.80821917808219
"Harrellsville town, North Carolina",53,44,9,37,29720,16.9811320754717
"Mountain Home CDP, North Carolina",1595,1540,55,37,44700,3.4482758620689653
"Lowesville CDP, North Carolina",1306,1224,82,37,39520,6.278713629402756
"Old Fort town, North Carolina",496,421,75,37,48920,15.120967741935484
"West Marion CDP, North Carolina",713,673,40,37,72600,5.610098176718092
"Oak Ridge town, North Carolina",2341,2230,111,37,48480,4.7415634344297315
"Sedalia town, North Carolina",274,214,60,37,60180,21.897810218978105
"Bladenboro town, North Carolina",940,757,183,37,06240,19.46808510638298
"Burlington city, North Carolina",24580,22211,2369,37,09060,9.637917005695687
"Lake Junaluska CDP, North Carolina",2056,1387,669,37,36480,32.538910505836576
"Rockfish CDP, North Carolina",1535,1342,193,37,57200,12.57328990228013
"Kenansville town, North Carolina",473,365,108,37,35460,22.832980972515855
"Ivanhoe CDP, North Carolina",100,100,0,37,33940,0.0
"Plain View CDP, North Carolina",827,784,43,37,52685,5.199516324062878
"Roseboro town, North Carolina",628,510,118,37,57800,18.789808917197455
"Salemburg town, North Carolina",252,216,36,37,58840,14.285714285714285
"Trent Woods town, North Carolina",1800,1693,107,37,68340,5.944444444444445
"Robersonville town, North Carolina",822,649,173,37,57100,21.046228710462287
"Brunswick town, North Carolina",173,144,29,37,08420,16.76300578034682
"Patterson Springs town, North Carolina",320,298,22,37,50700,6.875000000000001
"Morehead City town, North Carolina",5683,4381,1302,37,44320,22.91043462959704
"Salem CDP, North Carolina",969,865,104,37,58740,10.732714138286893
"Cape Carteret town, North Carolina",1161,934,227,37,10260,19.55211024978467
"Cedar Point town, North Carolina",1136,732,404,37,11340,35.563380281690144
"Lattimore town, North Carolina",140,111,29,37,37040,20.714285714285715
"Nags Head town, North Carolina",4948,1290,3658,37,45880,73.92886014551334
"Wanchese CDP, North Carolina",827,720,107,37,70920,12.93833131801693
"Parmele town, North Carolina",120,87,33,37,50540,27.500000000000004
"Colerain town, North Carolina",142,100,42,37,13560,29.577464788732392
"Clarkton town, North Carolina",389,305,84,37,12780,21.59383033419023
"Tar Heel town, North Carolina",120,102,18,37,66740,15.0
"Connelly Springs town, North Carolina",784,642,142,37,14280,18.112244897959183
"Beaufort town, North Carolina",3022,2227,795,37,04260,26.307081403044343
"Newport town, North Carolina",2038,1743,295,37,46860,14.474975466143277
"Yanceyville town, North Carolina",948,780,168,37,76000,17.72151898734177
"Polkville city, North Carolina",264,238,26,37,53160,9.848484848484848
"Pinehurst village, North Carolina",9280,7241,2039,37,51940,21.97198275862069
"Fletcher town, North Carolina",3663,3312,351,37,23760,9.582309582309582
"Bessemer City city, North Carolina",2237,1952,285,37,05220,12.74027715690657
"Cherryville city, North Carolina",2498,2235,263,37,12340,10.528422738190553
"Whispering Pines village, North Carolina",1226,1125,101,37,73140,8.238172920065253
"Forest Oaks CDP, North Carolina",1540,1384,156,37,24198,10.129870129870131
"McLeansville CDP, North Carolina",412,412,0,37,40460,0.0
"Claremont city, North Carolina",705,655,50,37,12720,7.092198581560284
"Conover city, North Carolina",3468,3242,226,37,14340,6.516724336793541
"Bridgeton town, North Carolina",232,154,78,37,07860,33.62068965517241
"New Bern city, North Carolina",15411,13334,2077,37,46340,13.477386282525469
"River Bend town, North Carolina",1514,1327,187,37,56710,12.351387054161163
"Vanceboro town, North Carolina",569,495,74,37,69680,13.005272407732866
"Manteo town, North Carolina",1515,829,686,37,41060,45.28052805280528
"Angier town, North Carolina",2032,2004,28,37,01400,1.3779527559055118
"Bakersville town, North Carolina",233,200,33,37,03100,14.163090128755366
"Spruce Pine town, North Carolina",1076,948,128,37,64260,11.895910780669144
"Pineville town, North Carolina",4183,3898,285,37,52220,6.813291895768588
"Spring Hope town, North Carolina",720,626,94,37,64160,13.055555555555557
"Welcome CDP, North Carolina",1900,1697,203,37,71760,10.68421052631579
"Princeville town, North Carolina",1125,894,231,37,53840,20.533333333333335
"Magnolia town, North Carolina",439,361,78,37,40640,17.76765375854214
"Sparta town, North Carolina",995,770,225,37,63680,22.613065326633166
"Wadesboro town, North Carolina",2444,1974,470,37,70380,19.230769230769234
"Crossnore town, North Carolina",91,39,52,37,15580,57.14285714285714
"Washington Park town, North Carolina",290,252,38,37,71240,13.10344827586207
"Momeyer town, North Carolina",136,118,18,37,43860,13.23529411764706
"Whitakers town, North Carolina",427,350,77,37,73160,18.0327868852459
"Murraysville CDP, North Carolina",6515,6392,123,37,45720,1.8879508825786646
"Seaboard town, North Carolina",405,306,99,37,59980,24.444444444444443
"Enochville CDP, North Carolina",1261,1136,125,37,21500,9.912767644726408
"Landis town, North Carolina",1456,1196,260,37,36860,17.857142857142858
"Rutherfordton town, North Carolina",2255,1996,259,37,58460,11.485587583148558
"Sims town, North Carolina",206,191,15,37,62060,7.281553398058252
"Fountain town, North Carolina",209,149,60,37,24440,28.708133971291865
"Hertford town, North Carolina",1258,1060,198,37,30900,15.73926868044515
"Elrod CDP, North Carolina",203,164,39,37,21120,19.21182266009852
"Pembroke town, North Carolina",1045,932,113,37,51080,10.813397129186603
"Burnsville town, North Carolina",1004,820,184,37,09140,18.326693227091635
"Moravian Falls CDP, North Carolina",1075,925,150,37,44280,13.953488372093023
"Richlands town, North Carolina",921,817,104,37,56360,11.292073832790445
"Alliance town, North Carolina",317,284,33,37,01000,10.410094637223976
"Fair Bluff town, North Carolina",471,319,152,37,22240,32.27176220806794
"Fayetteville city, North Carolina",95129,80598,14531,37,22920,15.275047566987984
"Hope Mills town, North Carolina",6424,5660,764,37,32640,11.892901618929017
"Cooleemee town, North Carolina",450,345,105,37,14460,23.333333333333332
"Stony Point CDP, North Carolina",912,746,166,37,65260,18.201754385964914
"La Grange town, North Carolina",1290,1226,64,37,36400,4.961240310077519
"Kelford town, North Carolina",157,123,34,37,35360,21.656050955414013
"Middleburg town, North Carolina",49,43,6,37,42640,12.244897959183673
"Graham city, North Carolina",6668,6274,394,37,27280,5.9088182363527295
"Haw River town, North Carolina",1145,1049,96,37,30260,8.384279475982533
"Ansonville town, North Carolina",362,289,73,37,01420,20.165745856353592
"Winterville town, North Carolina",3731,3664,67,37,75060,1.7957652103993569
"East Laurinburg town, North Carolina",141,115,26,37,19620,18.439716312056735
"Elkin town, North Carolina",1955,1522,433,37,20620,22.148337595907925
"Ellenboro town, North Carolina",364,277,87,37,20780,23.9010989010989
"Danbury town, North Carolina",63,49,14,37,16240,22.22222222222222
"Maxton town, North Carolina",1202,966,236,37,42020,19.633943427620633
"Oakboro town, North Carolina",830,751,79,37,48040,9.518072289156626
"Walnut Cove town, North Carolina",895,718,177,37,70780,19.776536312849164
"Lake Park village, North Carolina",1483,1426,57,37,36512,3.8435603506405935
"Marvin village, North Carolina",1833,1787,46,37,41720,2.5095471903982545
"Monroe city, North Carolina",12138,11288,850,37,43920,7.002801120448179
"Waxhaw town, North Carolina",4711,4414,297,37,71460,6.304393971555933
"Weddington town, North Carolina",3572,3453,119,37,71680,3.3314669652855544
"Asheboro city, North Carolina",11952,10817,1135,37,02080,9.49631860776439
"High Point city, North Carolina",46343,41011,5332,37,31400,11.505513238245259
"Staley town, North Carolina",137,120,17,37,64380,12.408759124087592
"Rosman town, North Carolina",279,221,58,37,58020,20.78853046594982
"Plymouth town, North Carolina",1746,1389,357,37,53040,20.446735395189002
"Garner town, North Carolina",12074,11338,736,37,25480,6.095742918668213
"Wake Forest town, North Carolina",14605,13874,731,37,70540,5.00513522766176
"Winfall town, North Carolina",380,283,97,37,74720,25.526315789473685
"Columbus town, North Carolina",549,487,62,37,13980,11.293260473588344
"Lumberton city, North Carolina",8749,7198,1551,37,39700,17.72774031317865
"Powellsville town, North Carolina",127,103,24,37,53680,18.89763779527559
"Roxobel town, North Carolina",163,138,25,37,58180,15.337423312883436
"Kelly CDP, North Carolina",286,135,151,37,35440,52.7972027972028
"Bolivia town, North Carolina",93,81,12,37,06820,12.903225806451612
"Grifton town, North Carolina",1211,1066,145,37,28200,11.973575557390587
"Grimesland town, North Carolina",235,206,29,37,28240,12.340425531914894
"Navassa town, North Carolina",775,666,109,37,46060,14.06451612903226
"Ocean Isle Beach town, North Carolina",3486,358,3128,37,48700,89.73034997131383
"Shallotte town, North Carolina",2161,1769,392,37,60800,18.139750115687182
"Indian Beach town, North Carolina",1742,107,1635,37,33460,93.85763490241102
"Peletier town, North Carolina",498,350,148,37,51040,29.71887550200803
"Pine Knoll Shores town, North Carolina",2081,675,1406,37,52000,67.56367131186929
"Lawndale town, North Carolina",369,322,47,37,37260,12.737127371273713
"Andrews town, North Carolina",1016,723,293,37,01380,28.838582677165352
"Cramerton town, North Carolina",1632,1497,135,37,15260,8.272058823529411
"Dallas town, North Carolina",2004,1851,153,37,16180,7.634730538922156
"Kings Mountain city, North Carolina",4763,4122,641,37,35880,13.457904681923157
"Lowell city, North Carolina",1477,1233,244,37,39480,16.519972918077183
"Ranlo town, North Carolina",1448,1356,92,37,55260,6.353591160220995
"Spencer Mountain town, North Carolina",0,0,0,37,63780,
"Mars Hill town, North Carolina",850,757,93,37,41620,10.941176470588236
"Aberdeen town, North Carolina",3310,2869,441,37,00160,13.323262839879154
"Taylortown town, North Carolina",407,325,82,37,66980,20.14742014742015
"Parkton town, North Carolina",223,166,57,37,50340,25.56053811659193
"Simpson village, North Carolina",197,171,26,37,62040,13.19796954314721
"Pumpkin Center CDP, North Carolina",781,601,180,37,54160,23.047375160051217
"Topsail Beach town, North Carolina",1315,197,1118,37,68040,85.0190114068441
"Swansboro town, North Carolina",1493,1221,272,37,66360,18.218352310783654
"St. Helena village, North Carolina",208,178,30,37,58620,14.423076923076922
"Oriental town, North Carolina",725,505,220,37,49380,30.344827586206897
"Wallace town, North Carolina",1916,1626,290,37,70720,15.1356993736952
"Dobbins Heights town, North Carolina",516,396,120,37,17325,23.25581395348837
"White Lake town, North Carolina",1397,499,898,37,73300,64.28060128847531
"Blowing Rock town, North Carolina",2124,618,1506,37,06500,70.90395480225989
"Arapahoe town, North Carolina",302,225,77,37,01640,25.496688741721858
"Vandemere town, North Carolina",159,102,57,37,69720,35.84905660377358
"Watha town, North Carolina",116,100,16,37,71320,13.793103448275861
"Rockingham city, North Carolina",4337,3809,528,37,57260,12.174314041964491
"Windsor town, North Carolina",1175,1085,90,37,74680,7.659574468085106
"Bald Head Island village, North Carolina",1220,141,1079,37,03150,88.44262295081967
"Caswell Beach town, North Carolina",759,214,545,37,10960,71.80500658761528
"Northwest city, North Carolina",363,345,18,37,47860,4.958677685950414
"Southport city, North Carolina",1883,1377,506,37,63400,26.872012745618694
"Varnamtown town, North Carolina",293,209,84,37,69795,28.668941979522184
"Rutland city, North Dakota",97,78,19,38,69340,19.587628865979383
"Grenora city, North Dakota",96,67,29,38,33500,30.208333333333332
"Dawson city, North Dakota",48,22,26,38,18260,54.166666666666664
"Pettibone city, North Dakota",58,50,8,38,62060,13.793103448275861
"Tuttle city, North Dakota",85,52,33,38,80140,38.82352941176471
"Deering city, North Dakota",48,48,0,38,18620,0.0
"Towner city, North Dakota",341,289,52,38,79420,15.249266862170089
"Rhame city, North Dakota",149,119,30,38,66300,20.13422818791946
"Kathryn city, North Dakota",48,35,13,38,41500,27.083333333333332
"Sanborn city, North Dakota",81,81,0,38,70380,0.0
"Sibley city, North Dakota",77,26,51,38,72820,66.23376623376623
"Colfax city, North Dakota",70,64,6,38,15180,8.571428571428571
"Mooreton city, North Dakota",88,88,0,38,54220,0.0
"Kensal city, North Dakota",122,90,32,38,42180,26.229508196721312
"Berlin city, North Dakota",17,15,2,38,06300,11.76470588235294
"Marion city, North Dakota",92,57,35,38,50780,38.04347826086957
"Mandan city, North Dakota",10548,9962,586,38,49900,5.555555555555555
"Neche city, North Dakota",186,152,34,38,55620,18.27956989247312
"Souris city, North Dakota",52,42,10,38,74020,19.230769230769234
"Westhope city, North Dakota",217,176,41,38,85020,18.89400921658986
"Rugby city, North Dakota",1588,1353,235,38,68860,14.798488664987405
"Hannah city, North Dakota",9,4,5,38,35060,55.55555555555556
"Fingal city, North Dakota",68,62,6,38,26380,8.823529411764707
"Leal city, North Dakota",10,10,0,38,45460,0.0
"Elgin city, North Dakota",390,314,76,38,23020,19.48717948717949
"Carson city, North Dakota",207,138,69,38,12460,33.33333333333333
"Barney city, North Dakota",35,28,7,38,04940,20.0
"Dwight city, North Dakota",41,37,4,38,21220,9.75609756097561
"Fredonia city, North Dakota",31,21,10,38,28380,32.25806451612903
"Belfield city, North Dakota",560,373,187,38,05820,33.39285714285714
"Luverne city, North Dakota",24,19,5,38,48580,20.833333333333336
"Butte city, North Dakota",80,40,40,38,11180,50.0
"Garrison city, North Dakota",775,702,73,38,29460,9.419354838709678
"Mercer city, North Dakota",47,23,24,38,52340,51.06382978723404
"Underwood city, North Dakota",405,355,50,38,80660,12.345679012345679
"Milton city, North Dakota",56,33,23,38,53020,41.07142857142857
"Epping city, North Dakota",48,35,13,38,24540,27.083333333333332
"Wales city, North Dakota",17,9,8,38,82940,47.05882352941176
"Cogswell city, North Dakota",63,45,18,38,15100,28.57142857142857
"Milnor city, North Dakota",394,352,42,38,52940,10.65989847715736
"Ray city, North Dakota",288,233,55,38,65580,19.09722222222222
"Williston city, North Dakota",14454,10656,3798,38,86220,26.276463262764633
"Churchs Ferry city, North Dakota",3,3,0,38,14140,0.0
"Edmore city, North Dakota",110,85,25,38,22340,22.727272727272727
"Grano city, North Dakota",2,2,0,38,32580,0.0
"Canton City city, North Dakota",12,10,2,38,12060,16.666666666666664
"Hamilton city, North Dakota",43,26,17,38,34620,39.53488372093023
"Horace city, North Dakota",998,971,27,38,38900,2.7054108216432864
"Springbrook city, North Dakota",10,6,4,38,74780,40.0
"Brocket city, North Dakota",25,14,11,38,09700,44.0
"Edinburg city, North Dakota",126,96,30,38,22260,23.809523809523807
"Davenport city, North Dakota",110,110,0,38,18180,0.0
"Pekin city, North Dakota",42,26,16,38,61460,38.095238095238095
"Beulah city, North Dakota",1652,1380,272,38,06660,16.46489104116223
"Minot AFB CDP, North Dakota",1712,1564,148,38,53420,8.644859813084112
"Fort Ransom city, North Dakota",58,49,9,38,27580,15.517241379310345
"Jamestown city, North Dakota",7308,6697,611,38,40580,8.360700602079913
"Dodge city, North Dakota",78,58,20,38,19820,25.64102564102564
"Lansford city, North Dakota",146,129,17,38,44900,11.643835616438356
"Gackle city, North Dakota",197,128,69,38,28860,35.025380710659896
"New Rockford city, North Dakota",801,676,125,38,56620,15.605493133583021
"Solen city, North Dakota",42,31,11,38,73820,26.190476190476193
"Wimbledon city, North Dakota",149,114,35,38,86620,23.48993288590604
"Fortuna city, North Dakota",20,6,14,38,27820,70.0
"Bowman city, North Dakota",923,687,236,38,08700,25.568797399783318
"Noonan city, North Dakota",187,122,65,38,57220,34.75935828877005
"Cavalier city, North Dakota",735,581,154,38,12940,20.952380952380953
"Mohall city, North Dakota",392,303,89,38,53780,22.70408163265306
"Oriska city, North Dakota",63,54,9,38,59660,14.285714285714285
"Robinson city, North Dakota",44,21,23,38,67180,52.27272727272727
"Hettinger city, North Dakota",747,555,192,38,37700,25.702811244979916
"New Town city, North Dakota",783,627,156,38,56740,19.923371647509576
"Hoople city, North Dakota",180,153,27,38,38780,15.0
"Prairie Rose city, North Dakota",22,22,0,38,64320,0.0
"Sharon city, North Dakota",69,32,37,38,71940,53.62318840579711
"Bismarck city, North Dakota",33970,31893,2077,38,07200,6.114218428024728
"McVille city, North Dakota",258,179,79,38,49580,30.620155038759687
"Conway city, North Dakota",12,12,0,38,15820,0.0
"Clifford city, North Dakota",14,14,0,38,14740,0.0
"Casselton city, North Dakota",953,909,44,38,12700,4.616998950682056
"Riverdale city, North Dakota",210,117,93,38,66980,44.285714285714285
"Hampden city, North Dakota",24,15,9,38,34860,37.5
"Sawyer city, North Dakota",164,138,26,38,70980,15.853658536585366
"Cando city, North Dakota",656,540,116,38,11860,17.682926829268293
"Gardena city, North Dakota",17,14,3,38,29180,17.647058823529413
"Kramer city, North Dakota",46,26,20,38,43500,43.47826086956522
"Landa city, North Dakota",40,34,6,38,44700,15.0
"Willow City city, North Dakota",151,115,36,38,86380,23.841059602649008
"Benedict city, North Dakota",40,40,0,38,05980,0.0
"Ruso city, North Dakota",1,1,0,38,69140,0.0
"Hatton city, North Dakota",367,327,40,38,36100,10.899182561307901
"Wing city, North Dakota",90,62,28,38,86780,31.11111111111111
"Buxton city, North Dakota",175,171,4,38,11340,2.2857142857142856
"Grandin city, North Dakota",79,79,0,38,32300,0.0
"Portland city, North Dakota",312,285,27,38,63900,8.653846153846153
"Wahpeton city, North Dakota",3693,3282,411,38,82660,11.129163281884647
"Walcott city, North Dakota",131,101,30,38,82780,22.900763358778626
"Amidon city, North Dakota",18,10,8,38,02060,44.44444444444444
"Marmarth city, North Dakota",113,77,36,38,50860,31.858407079646017
"Lakota city, North Dakota",370,351,19,38,44300,5.135135135135135
"Minnewaukan city, North Dakota",157,95,62,38,53220,39.490445859872615
"Tolna city, North Dakota",112,105,7,38,79180,6.25
"Grafton city, North Dakota",2003,1810,193,38,31820,9.63554667998003
"Esmond city, North Dakota",106,58,48,38,24780,45.28301886792453
"Oberon city, North Dakota",50,32,18,38,59020,36.0
"Oakes city, North Dakota",922,864,58,38,58740,6.29067245119306
"Braddock city, North Dakota",61,7,54,38,08900,88.52459016393442
"Columbus city, North Dakota",115,42,73,38,15460,63.47826086956522
"Calvin city, North Dakota",3,3,0,38,11700,0.0
"Osnabrock city, North Dakota",106,71,35,38,60100,33.0188679245283
"Forman city, North Dakota",259,227,32,38,27260,12.355212355212355
"Alamo city, North Dakota",32,16,16,38,00940,50.0
"Tioga city, North Dakota",760,520,240,38,78940,31.57894736842105
"Gwinner city, North Dakota",534,497,37,38,34020,6.928838951310862
"Wildrose city, North Dakota",74,35,39,38,86020,52.702702702702695
"Aneta city, North Dakota",192,161,31,38,02380,16.145833333333336
"Michigan City city, North Dakota",146,105,41,38,52740,28.08219178082192
"Maddock city, North Dakota",273,204,69,38,49620,25.274725274725274
"Wilton city, North Dakota",396,368,28,38,86580,7.07070707070707
"Dickinson city, North Dakota",10786,9126,1660,38,19620,15.39032078620434
"Richardton city, North Dakota",409,322,87,38,66500,21.271393643031786
"Taylor city, North Dakota",130,99,31,38,78180,23.846153846153847
"Ludden city, North Dakota",24,20,4,38,48460,16.666666666666664
"Crary city, North Dakota",41,36,5,38,16580,12.195121951219512
"Devils Lake city, North Dakota",3870,3396,474,38,19420,12.248062015503876
"Lincoln city, North Dakota",1341,1279,62,38,46640,4.6234153616703955
"Mayville city, North Dakota",883,746,137,38,51500,15.51528878822197
"Reynolds city, North Dakota",132,125,7,38,66260,5.303030303030303
"Amenia city, North Dakota",46,38,8,38,01940,17.391304347826086
"Briarwood city, North Dakota",18,17,1,38,09320,5.555555555555555
"Fordville city, North Dakota",116,99,17,38,27060,14.655172413793101
"Forest River city, North Dakota",57,47,10,38,27100,17.543859649122805
"Lankin city, North Dakota",68,51,17,38,44860,25.0
"Martin city, North Dakota",31,29,2,38,51060,6.451612903225806
"Coleharbor city, North Dakota",40,38,2,38,15140,5.0
"White Shield CDP, North Dakota",136,102,34,38,85660,25.0
"Monango city, North Dakota",22,16,6,38,53820,27.27272727272727
"Hazelton city, North Dakota",134,103,31,38,36700,23.134328358208954
"Hannaford city, North Dakota",74,61,13,38,35020,17.56756756756757
"Buffalo city, North Dakota",107,94,13,38,10420,12.149532710280374
"Erie CDP, North Dakota",34,20,14,38,24620,41.17647058823529
"Hunter city, North Dakota",118,105,13,38,39460,11.016949152542372
"Kenmare city, North Dakota",603,430,173,38,42020,28.689883913764515
"Sykeston city, North Dakota",68,47,21,38,77660,30.88235294117647
"Surrey city, North Dakota",483,454,29,38,77180,6.004140786749482
"McHenry city, North Dakota",38,28,10,38,49260,26.31578947368421
"Mott city, North Dakota",446,349,97,38,54620,21.748878923766814
"Emerado city, North Dakota",226,180,46,38,24060,20.353982300884958
"Munich city, North Dakota",155,144,11,38,55020,7.096774193548387
"South Heart city, North Dakota",151,133,18,38,74185,11.920529801324504
"Max city, North Dakota",201,170,31,38,51380,15.422885572139302
"Washburn city, North Dakota",803,681,122,38,83700,15.193026151930262
"Fort Totten CDP, North Dakota",310,268,42,38,27700,13.548387096774196
"York city, North Dakota",27,14,13,38,87860,48.148148148148145
"Ardoch city, North Dakota",47,23,24,38,02860,51.06382978723404
"Minto city, North Dakota",356,319,37,38,53540,10.393258426966293
"Strasburg city, North Dakota",219,162,57,38,76500,26.027397260273972
"Bowdon city, North Dakota",101,89,12,38,08580,11.881188118811881
"Hamberg city, North Dakota",18,18,0,38,34460,0.0
"Fullerton city, North Dakota",43,40,3,38,28780,6.976744186046512
"Cooperstown city, North Dakota",553,458,95,38,15900,17.17902350813743
"Starkweather city, North Dakota",50,37,13,38,75580,26.0
"Beach city, North Dakota",639,534,105,38,05420,16.431924882629108
"Golva city, North Dakota",52,38,14,38,31420,26.923076923076923
"Carrington city, North Dakota",1059,913,146,38,12340,13.786591123701605
"New England city, North Dakota",333,249,84,38,56180,25.225225225225223
"Regent city, North Dakota",143,88,55,38,66020,38.46153846153847
"Galesburg city, North Dakota",94,86,8,38,28980,8.51063829787234
"Argusville city, North Dakota",158,157,1,38,03020,0.6329113924050633
"Mountain city, North Dakota",18,18,0,38,54740,0.0
"Antler city, North Dakota",22,15,7,38,02660,31.818181818181817
"Hansboro city, North Dakota",19,14,5,38,35140,26.31578947368421
"Portal city, North Dakota",88,64,24,38,63740,27.27272727272727
"Perth city, North Dakota",5,3,2,38,61780,40.0
"Overly city, North Dakota",10,10,0,38,60380,0.0
"Venturia city, North Dakota",15,10,5,38,81700,33.33333333333333
"Alexander city, North Dakota",171,73,98,38,01180,57.30994152046783
"Loraine city, North Dakota",8,8,0,38,48020,0.0
"Flaxton city, North Dakota",70,39,31,38,26700,44.285714285714285
"Powers Lake city, North Dakota",176,116,60,38,64140,34.090909090909086
"Ellendale city, North Dakota",706,545,161,38,23220,22.804532577903682
"Hague city, North Dakota",51,32,19,38,34180,37.254901960784316
"Linton city, North Dakota",627,520,107,38,46980,17.065390749601274
"Binford city, North Dakota",140,92,48,38,07020,34.285714285714285
"Goodrich city, North Dakota",74,43,31,38,31500,41.891891891891895
"McClusky city, North Dakota",262,233,29,38,49020,11.068702290076336
"Dunseith city, North Dakota",283,237,46,38,21020,16.25441696113074
"Gardner city, North Dakota",37,37,0,38,29220,0.0
"Lawton city, North Dakota",36,11,25,38,45300,69.44444444444444
"Park River city, North Dakota",756,689,67,38,60900,8.862433862433862
"Knox city, North Dakota",24,14,10,38,43260,41.66666666666667
"Leeds city, North Dakota",295,248,47,38,45580,15.932203389830507
"Adams city, North Dakota",133,101,32,38,00340,24.06015037593985
"Grace City city, North Dakota",44,37,7,38,31740,15.909090909090908
"Alice city, North Dakota",19,12,7,38,01420,36.84210526315789
"Ayr city, North Dakota",5,5,0,38,04020,0.0
"Thompson city, North Dakota",412,408,4,38,78660,0.9708737864077669
"Inkster city, North Dakota",29,17,12,38,39980,41.37931034482759
"Manvel city, North Dakota",133,125,8,38,50420,6.015037593984962
"Niagara city, North Dakota",37,23,14,38,56780,37.83783783783784
"Egeland city, North Dakota",55,21,34,38,22540,61.81818181818181
"Pick City city, North Dakota",181,64,117,38,62260,64.64088397790056
"Belcourt CDP, North Dakota",899,717,182,38,05740,20.24471635150167
"East Dunseith CDP, North Dakota",138,129,9,38,21520,6.521739130434782
"Minot city, North Dakota",24076,20278,3798,38,53380,15.7750456886526
"Brinsmade city, North Dakota",20,11,9,38,09460,45.0
"Warwick city, North Dakota",33,26,7,38,83580,21.21212121212121
"Fairdale city, North Dakota",27,13,14,38,25180,51.85185185185185
"Fessenden city, North Dakota",380,285,95,38,26180,25.0
"Golden Valley city, North Dakota",135,121,14,38,31180,10.37037037037037
"North River city, North Dakota",21,21,0,38,58120,0.0
"Page city, North Dakota",126,99,27,38,60500,21.428571428571427
"Donnybrook city, North Dakota",28,24,4,38,19900,14.285714285714285
"Tower City city, North Dakota",137,127,10,38,79340,7.2992700729927
"Stanton city, North Dakota",181,160,21,38,75420,11.602209944751381
"Rolla city, North Dakota",594,515,79,38,67820,13.299663299663301
"Cathay city, North Dakota",18,13,5,38,12820,27.77777777777778
"Gilby city, North Dakota",110,94,16,38,30180,14.545454545454545
"Grand Forks city, North Dakota",26772,24991,1781,38,32060,6.652472732705812
"Larimore city, North Dakota",643,590,53,38,45020,8.242612752721618
"Lisbon city, North Dakota",1045,954,91,38,47100,8.708133971291867
"Sheldon city, North Dakota",67,59,8,38,72180,11.940298507462686
"Petersburg city, North Dakota",95,76,19,38,61860,20.0
"Arthur city, North Dakota",156,147,9,38,03300,5.769230769230769
"Burlington city, North Dakota",568,515,53,38,10940,9.330985915492958
"Leonard city, North Dakota",121,121,0,38,45980,0.0
"West Fargo city, North Dakota",14058,13389,669,38,84780,4.758856167306871
"Zap city, North Dakota",106,67,39,38,88140,36.79245283018868
"Mylo city, North Dakota",10,5,5,38,55220,50.0
"Berthold city, North Dakota",207,189,18,38,06460,8.695652173913043
"Makoti city, North Dakota",81,53,28,38,49820,34.5679012345679
"Ryder city, North Dakota",72,43,29,38,69460,40.27777777777778
"Regan city, North Dakota",33,23,10,38,65980,30.303030303030305
"Sentinel Butte city, North Dakota",60,41,19,38,71780,31.666666666666664
"Glenfield city, North Dakota",77,60,17,38,30660,22.07792207792208
"Hillsboro city, North Dakota",785,710,75,38,38100,9.554140127388536
"Hurdsfield city, North Dakota",53,21,32,38,39580,60.37735849056604
"Grand Forks AFB CDP, North Dakota",753,728,25,38,32140,3.3200531208499333
"Northwood city, North Dakota",419,334,85,38,58300,20.286396181384248
"Elliott city, North Dakota",13,13,0,38,23340,0.0
"Fargo city, North Dakota",58215,53359,4856,38,25700,8.341492742420337
"Frontier city, North Dakota",222,222,0,38,28720,0.0
"Harwood city, North Dakota",274,274,0,38,35940,0.0
"Kindred city, North Dakota",333,310,23,38,42780,6.906906906906906
"Reile's Acres city, North Dakota",164,158,6,38,66040,3.6585365853658534
"Wheatland CDP, North Dakota",20,20,0,38,85180,0.0
"Carpio city, North Dakota",81,58,23,38,12260,28.39506172839506
"Des Lacs city, North Dakota",79,75,4,38,19300,5.063291139240507
"Pisek city, North Dakota",58,43,15,38,62780,25.862068965517242
"Center city, North Dakota",331,258,73,38,13180,22.054380664652566
"Harvey city, North Dakota",1052,809,243,38,35900,23.098859315589355
"Bisbee city, North Dakota",99,51,48,38,07180,48.484848484848484
"Sarles city, North Dakota",18,7,11,38,70780,61.111111111111114
"Enderlin city, North Dakota",541,433,108,38,24260,19.963031423290204
"Rocklake city, North Dakota",87,59,28,38,67500,32.18390804597701
"Finley city, North Dakota",294,258,36,38,26420,12.244897959183673
"Oxbow city, North Dakota",117,105,12,38,60480,10.256410256410255
"Hazen city, North Dakota",1157,1081,76,38,36780,6.568712186689715
"St. John city, North Dakota",146,111,35,38,69980,23.972602739726025
"Douglas city, North Dakota",37,24,13,38,20020,35.13513513513514
"Hankinson city, North Dakota",503,392,111,38,34900,22.067594433399602
"Valley City city, North Dakota",3361,3164,197,38,81180,5.861350788455817
"Leith city, North Dakota",20,15,5,38,45860,25.0
"Abercrombie city, North Dakota",100,94,6,38,00100,6.0
"Haynes city, North Dakota",20,15,5,38,36540,25.0
"Glen Ullin city, North Dakota",414,364,50,38,30860,12.077294685990339
"Reeder city, North Dakota",132,79,53,38,65900,40.15151515151515
"Courtenay city, North Dakota",21,21,0,38,16380,0.0
"Watford City city, North Dakota",3351,2179,1172,38,83860,34.97463443748135
"Verona city, North Dakota",33,33,0,38,81900,0.0
"White Earth city, North Dakota",47,29,18,38,85540,38.297872340425535
"Maxbass city, North Dakota",56,47,9,38,51420,16.071428571428573
"Steele city, North Dakota",415,364,51,38,75780,12.289156626506024
"Balfour city, North Dakota",21,16,5,38,04460,23.809523809523807
"Napoleon city, North Dakota",463,397,66,38,55420,14.254859611231103
"Bantry city, North Dakota",6,5,1,38,04740,16.666666666666664
"Kief city, North Dakota",16,11,5,38,42660,31.25
"Selfridge city, North Dakota",89,72,17,38,71660,19.101123595505616
"Bowbells city, North Dakota",229,155,74,38,08500,32.314410480349345
"Lignite city, North Dakota",99,74,25,38,46540,25.252525252525253
"Alsen city, North Dakota",30,23,7,38,01740,23.333333333333332
"Scranton city, North Dakota",195,155,40,38,71500,20.51282051282051
"Fort Yates city, North Dakota",62,52,10,38,27860,16.129032258064516
"Balta city, North Dakota",55,44,11,38,04580,20.0
"Calio city, North Dakota",13,3,10,38,11580,76.92307692307693
"Cayuga city, North Dakota",23,23,0,38,13020,0.0
"Havana city, North Dakota",53,26,27,38,36140,50.943396226415096
"Medina city, North Dakota",161,127,34,38,51860,21.11801242236025
"Montpelier city, North Dakota",50,39,11,38,53980,22.0
"Streeter city, North Dakota",83,56,27,38,76620,32.53012048192771
"Woodworth city, North Dakota",41,27,14,38,87580,34.146341463414636
"Edgeley city, North Dakota",299,238,61,38,22140,20.401337792642142
"Jud city, North Dakota",60,45,15,38,41180,25.0
"Kulm city, North Dakota",263,211,52,38,43580,19.771863117870723
"Drayton city, North Dakota",406,333,73,38,20340,17.980295566502463
"Sheyenne city, North Dakota",116,93,23,38,72580,19.82758620689655
"Lehr city, North Dakota",119,48,71,38,45740,59.66386554621849
"Wishek city, North Dakota",575,493,82,38,87020,14.26086956521739
"Zeeland city, North Dakota",96,56,40,38,88180,41.66666666666667
"Mandaree CDP, North Dakota",210,125,85,38,49980,40.476190476190474
"Bergen city, North Dakota",11,4,7,38,06180,63.63636363636363
"Granville city, North Dakota",151,145,6,38,32660,3.9735099337748347
"Tolley city, North Dakota",40,20,20,38,79140,50.0
"Lidgerwood city, North Dakota",436,337,99,38,46460,22.706422018348622
"Ashley city, North Dakota",491,338,153,38,03540,31.160896130346234
"Arnegard city, North Dakota",31,23,8,38,03220,25.806451612903224
"Pillsbury city, North Dakota",10,7,3,38,62540,30.0
"Four Bears Village CDP, North Dakota",158,103,55,38,27950,34.810126582278485
"Velva city, North Dakota",573,535,38,38,81620,6.631762652705062
"Cannon Ball CDP, North Dakota",229,197,32,38,12020,13.973799126637553
"Litchville city, North Dakota",114,87,27,38,47140,23.684210526315788
"Nome city, North Dakota",22,20,2,38,57180,9.090909090909092
"Rogers city, North Dakota",26,24,2,38,67620,7.6923076923076925
"Christine city, North Dakota",80,74,6,38,14100,7.5
"Fairmount city, North Dakota",187,146,41,38,25300,21.92513368983957
"Mantador city, North Dakota",25,22,3,38,50380,12.0
"Pingree city, North Dakota",22,19,3,38,62620,13.636363636363635
"Spiritwood Lake city, North Dakota",98,54,44,38,74740,44.89795918367347
"Halliday city, North Dakota",211,144,67,38,34340,31.753554502369667
"Mocksville town, North Carolina",2366,2084,282,37,43720,11.918850380388841
"Hamlet city, North Carolina",2866,2411,455,37,29160,15.875785066294487
"Pleasant Hill CDP, North Carolina",479,397,82,37,52920,17.118997912317326
"Stokesdale town, North Carolina",2024,1860,164,37,65040,8.102766798418973
"Severn town, North Carolina",136,117,19,37,60560,13.970588235294118
"Creedmoor city, North Carolina",2018,1575,443,37,15320,21.952428146679882
"Calypso town, North Carolina",241,202,39,37,09760,16.182572614107883
"Boonville town, North Carolina",618,516,102,37,07140,16.50485436893204
"Piney Green CDP, North Carolina",5802,4899,903,37,52260,15.563598759048606
"Granite Falls town, North Carolina",1972,1846,126,37,27420,6.389452332657202
"Buies Creek CDP, North Carolina",694,509,185,37,08760,26.65706051873199
"Pollocksville town, North Carolina",210,169,41,37,53200,19.523809523809526
"Dunn city, North Carolina",4578,4079,499,37,18320,10.899956312800349
"Belville town, North Carolina",994,897,97,37,04950,9.758551307847082
"Belwood town, North Carolina",427,351,76,37,04960,17.798594847775178
"Barker Heights CDP, North Carolina",705,648,57,37,03640,8.085106382978724
"Jamestown town, North Carolina",1785,1721,64,37,34300,3.5854341736694675
"Marietta town, North Carolina",79,63,16,37,41380,20.253164556962027
"Minnesott Beach town, North Carolina",345,233,112,37,43440,32.463768115942024
"Hendersonville city, North Carolina",8340,7294,1046,37,30720,12.541966426858513
"Fallston town, North Carolina",280,217,63,37,22720,22.5
"Matthews town, North Carolina",12265,11725,540,37,41960,4.4027721157766
"Morganton city, North Carolina",7572,6443,1129,37,44400,14.910195456946646
"Walstonburg town, North Carolina",97,74,23,37,70860,23.711340206185564
"St. Stephens CDP, North Carolina",3696,3466,230,37,58730,6.222943722943723
"Kill Devil Hills town, North Carolina",6319,3016,3303,37,35720,52.27092894445323
"Mint Hill town, North Carolina",9736,9364,372,37,43480,3.820870994248151
"Dover town, North Carolina",137,123,14,37,17660,10.218978102189782
"Maysville town, North Carolina",525,423,102,37,42100,19.428571428571427
"Faith town, North Carolina",360,315,45,37,22600,12.5
"Milton town, North Carolina",107,90,17,37,43300,15.887850467289718
"Boiling Springs town, North Carolina",1346,1166,180,37,06800,13.37295690936107
"Earl town, North Carolina",121,107,14,37,19140,11.570247933884298
"Cofield village, North Carolina",221,150,71,37,13460,32.126696832579185
"Maiden town, North Carolina",1041,1012,29,37,40660,2.785782901056676
"Franklinton town, North Carolina",994,786,208,37,24720,20.92555331991952
"Youngsville town, North Carolina",798,725,73,37,76200,9.147869674185463
"Cashiers CDP, North Carolina",182,49,133,37,10800,73.07692307692307
"Candor town, North Carolina",381,317,64,37,10120,16.79790026246719
"Marshall town, North Carolina",489,334,155,37,41580,31.697341513292432
"Carthage town, North Carolina",1187,1003,184,37,10680,15.501263689974726
"Black Mountain town, North Carolina",4313,3860,453,37,06140,10.503130071875724
"Fairview CDP, North Carolina",1203,987,216,37,22440,17.955112219451372
"Cajah's Mountain town, North Carolina",1192,1096,96,37,09530,8.053691275167784
"Lenoir city, North Carolina",8509,7438,1071,37,37760,12.5866729345399
"Westport CDP, North Carolina",1676,1512,164,37,72755,9.785202863961814
"Marion city, North Carolina",3262,2919,343,37,41420,10.515021459227468
"Bunn town, North Carolina",170,134,36,37,08860,21.176470588235293
"Mount Holly city, North Carolina",6413,5991,422,37,44960,6.580383595820989
"Stanley town, North Carolina",1491,1386,105,37,64500,7.042253521126761
"Star town, North Carolina",414,320,94,37,64580,22.705314009661837
"Pinebluff town, North Carolina",646,598,48,37,51840,7.430340557275541
"Seven Lakes CDP, North Carolina",2578,2068,510,37,60515,19.78277734678045
"Snow Hill town, North Carolina",837,726,111,37,62760,13.261648745519713
"Hookerton town, North Carolina",241,191,50,37,32540,20.74688796680498
"Kernersville town, North Carolina",11352,10504,848,37,35600,7.470049330514447
"Tobaccoville village, North Carolina",1251,1112,139,37,67720,11.11111111111111
"Toast CDP, North Carolina",711,598,113,37,67700,15.89310829817159
"Upper Sandusky city, Ohio",3200,2890,310,39,79044,9.6875
"Canton town, North Carolina",2028,1724,304,37,10240,14.990138067061142
"Indian Trail town, North Carolina",12835,12520,315,37,33560,2.454226723802104
"JAARS CDP, North Carolina",238,176,62,37,33993,26.05042016806723
"Wesley Chapel village, North Carolina",2843,2644,199,37,71940,6.9996482588814635
"Waynesville town, North Carolina",5590,4689,901,37,71500,16.118067978533094
"Ocracoke CDP, North Carolina",896,217,679,37,48740,75.78125
"Bowmore CDP, North Carolina",79,43,36,37,07400,45.56962025316456
"Taylorsville town, North Carolina",992,828,164,37,66960,16.532258064516128
"Leggett town, North Carolina",33,22,11,37,37640,33.33333333333333
"Speed town, North Carolina",48,44,4,37,63720,8.333333333333332
"Alamance village, North Carolina",450,418,32,37,00640,7.111111111111111
"Swepsonville town, North Carolina",793,749,44,37,66460,5.548549810844893
"Peachland town, North Carolina",214,166,48,37,50820,22.429906542056074
"Jefferson town, North Carolina",768,596,172,37,34440,22.395833333333336
"Elk Park town, North Carolina",375,312,63,37,20700,16.8
"Aurora town, North Carolina",368,257,111,37,02620,30.16304347826087
"Bath town, North Carolina",172,118,54,37,03840,31.3953488372093
"River Road CDP, North Carolina",2237,1634,603,37,56815,26.955744300402323
"Wilmington city, North Carolina",58114,51316,6798,37,74440,11.697697628798569
"Wrightsville Beach town, North Carolina",2756,1165,1591,37,75820,57.72859216255443
"Garysburg town, North Carolina",500,395,105,37,25540,21.0
"Lasker town, North Carolina",80,69,11,37,37000,13.750000000000002
"Mayodan town, North Carolina",1275,1208,67,37,42060,5.254901960784314
"Reidsville city, North Carolina",7334,6078,1256,37,55900,17.12571584401418
"Raeford city, North Carolina",2190,1883,307,37,54580,14.018264840182649
"Bethlehem CDP, North Carolina",2013,1771,242,37,05530,12.021857923497267
"Maggie Valley town, North Carolina",1706,783,923,37,40600,54.1031652989449
"Kure Beach town, North Carolina",2236,989,1247,37,36220,55.769230769230774
"Green Level town, North Carolina",886,790,96,37,27870,10.835214446952596
"Woodlawn CDP, North Carolina",309,297,12,37,75375,3.8834951456310676
"Morven town, North Carolina",274,222,52,37,44560,18.97810218978102
"Chocowinity town, North Carolina",493,409,84,37,12580,17.038539553752535
"Myrtle Grove CDP, North Carolina",4195,3909,286,37,45840,6.817640047675805
"Sea Breeze CDP, North Carolina",1278,901,377,37,60000,29.49921752738654
"Silver Lake CDP, North Carolina",2513,2320,193,37,61950,7.6800636689216075
"Jackson town, North Carolina",246,229,17,37,34000,6.910569105691057
"Granite Quarry town, North Carolina",1227,1027,200,37,27440,16.299918500407497
"Kannapolis city, North Carolina",19288,17137,2151,37,35200,11.152011613438408
"Bostic town, North Carolina",186,147,39,37,07220,20.967741935483872
"Clinton city, North Carolina",3680,3382,298,37,13240,8.097826086956522
"Ingold CDP, North Carolina",102,102,0,37,33640,0.0
"Highlands town, North Carolina",2218,646,1572,37,31360,70.8746618575293
"Newton city, North Carolina",5575,5065,510,37,47000,9.147982062780269
"Fairfield Harbour CDP, North Carolina",2008,1437,571,37,22305,28.436254980079685
"Kitty Hawk town, North Carolina",3361,1512,1849,37,36060,55.013388872359414
"Huntersville town, North Carolina",20850,19852,998,37,33120,4.786570743405276
"Askewville town, North Carolina",98,82,16,37,02320,16.3265306122449
"Boiling Spring Lakes city, North Carolina",2548,2261,287,37,06760,11.263736263736265
"Oak Island town, North Carolina",9291,3630,5661,37,48345,60.929932192444305
"Sunset Beach town, North Carolina",5231,1932,3299,37,65900,63.06633530873638
"Rutherford College town, North Carolina",620,546,74,37,58440,11.935483870967742
"Bogue town, North Carolina",334,285,49,37,06740,14.67065868263473
"Emerald Isle town, North Carolina",6796,1760,5036,37,21160,74.10241318422601
"Edenton town, North Carolina",2621,2055,566,37,20120,21.59481114078596
"East Flat Rock CDP, North Carolina",2247,1961,286,37,19420,12.728081886960391
"Casar town, North Carolina",125,101,24,37,10760,19.2
"Kingstown town, North Carolina",249,214,35,37,35890,14.056224899598394
"Mooresboro town, North Carolina",211,154,57,37,44160,27.014218009478675
"Etowah CDP, North Carolina",3705,3328,377,37,21880,10.175438596491228
"Mooresville town, North Carolina",14604,13676,928,37,44220,6.354423445631334
"Pine Level town, North Carolina",873,813,60,37,52020,6.872852233676976
"Dublin town, North Carolina",163,116,47,37,18040,28.834355828220858
"Carolina Shores town, North Carolina",2428,1839,589,37,10550,24.258649093904445
"St. James town, North Carolina",3140,2557,583,37,58630,18.56687898089172
"Glen Alpine town, North Carolina",676,580,96,37,26200,14.201183431952662
"Valdese town, North Carolina",1882,1557,325,37,69520,17.268862911795964
"Grover town, North Carolina",334,285,49,37,28400,14.67065868263473
"Ahoskie town, North Carolina",2289,1872,417,37,00500,18.2175622542595
"Balfour CDP, North Carolina",759,644,115,37,03220,15.151515151515152
"Flat Rock village, North Carolina",2251,1663,588,37,23600,26.12172367836517
"Lincolnton city, North Carolina",5179,4358,821,37,38320,15.852481173971809
"Belmont city, North Carolina",4849,4307,542,37,04840,11.177562383996701
"Gastonia city, North Carolina",32311,28524,3787,37,25580,11.720466714122125
"McAdenville town, North Carolina",302,281,21,37,39880,6.95364238410596
"Cullowhee CDP, North Carolina",1611,1205,406,37,15880,25.20173805090006
"Webster town, North Carolina",227,183,44,37,71600,19.383259911894275
"Mount Gilead town, North Carolina",620,467,153,37,44900,24.677419354838708
"Asheville city, North Carolina",45441,40757,4684,37,02140,10.307871745780242
"Woodfin town, North Carolina",2950,2433,517,37,75280,17.52542372881356
"Mount Pleasant town, North Carolina",761,676,85,37,45140,11.169513797634691
"Lake Norman of Catawba CDP, North Carolina",4241,3283,958,37,36511,22.589012025465692
"Goldston town, North Carolina",134,108,26,37,26920,19.402985074626866
"Siler City town, North Carolina",3182,2885,297,37,61860,9.333752357008171
"Hamilton town, North Carolina",197,147,50,37,29120,25.380710659898476
"Cornelius town, North Carolina",13027,12094,933,37,14700,7.162048054041606
"Butters CDP, North Carolina",133,133,0,37,09380,0.0
"Red Oak town, North Carolina",1500,1408,92,37,55640,6.133333333333333
"Lilesville town, North Carolina",201,170,31,37,38200,15.422885572139302
"West Jefferson town, North Carolina",799,693,106,37,72540,13.266583229036296
"Nashville town, North Carolina",2672,2299,373,37,46000,13.959580838323355
"Rocky Mount city, North Carolina",26355,21968,4387,37,57500,16.645797761335608
"Wrightsboro CDP, North Carolina",2028,1933,95,37,75780,4.684418145956608
"Conway town, North Carolina",386,282,104,37,14400,26.94300518134715
"Gaston town, North Carolina",624,544,80,37,25560,12.82051282051282
"Forest City town, North Carolina",3931,3182,749,37,24080,19.053675909437803
"Wilson's Mills town, North Carolina",771,753,18,37,74580,2.3346303501945527
"Benson town, North Carolina",1600,1408,192,37,05040,12.0
"Four Oaks town, North Carolina",897,747,150,37,24520,16.722408026755854
"Kinston city, North Carolina",11176,8857,2319,37,35920,20.749821045096635
"Gamewell town, North Carolina",1727,1507,220,37,25380,12.738853503184714
"Long View town, North Carolina",2364,2047,317,37,39280,13.409475465313028
"Hayesville town, North Carolina",236,174,62,37,30280,26.27118644067797
"Rowland town, North Carolina",566,464,102,37,58140,18.021201413427562
"St. Pauls town, North Carolina",1013,860,153,37,58720,15.103652517275421
"Goldsboro city, North Carolina",16205,14339,1866,37,26880,11.514964517124344
"Greenville city, North Carolina",42791,36865,5926,37,28080,13.84870650370405
"Fairplains CDP, North Carolina",1010,968,42,37,22380,4.158415841584159
"Lake Waccamaw town, North Carolina",1033,604,429,37,36640,41.52952565343659
"Bermuda Run town, North Carolina",1579,1264,315,37,05135,19.94933502216593
"Pleasant Garden town, North Carolina",1833,1641,192,37,52760,10.474631751227497
"Tabor City town, North Carolina",1262,1052,210,37,66520,16.64025356576862
"Spring Lake town, North Carolina",5066,4351,715,37,64180,14.113699170943544
"Stem town, North Carolina",411,377,34,37,64940,8.27250608272506
"Stovall town, North Carolina",181,148,33,37,65320,18.23204419889503
"Clemmons village, North Carolina",8372,7764,608,37,12960,7.262302914476828
"Lewisville town, North Carolina",5667,5181,486,37,38040,8.575966119640022
"South Weldon CDP, North Carolina",371,324,47,37,63560,12.668463611859837
"Micro town, North Carolina",288,266,22,37,42620,7.638888888888889
"Pink Hill town, North Carolina",239,196,43,37,52400,17.99163179916318
"Avery Creek CDP, North Carolina",962,913,49,37,02760,5.093555093555094
"Weaverville town, North Carolina",2018,1826,192,37,71560,9.514370664023787
"Cedar Rock village, North Carolina",113,101,12,37,11352,10.619469026548673
"Wendell town, North Carolina",2627,2502,125,37,71860,4.75827940616673
"Bonnetsville CDP, North Carolina",203,183,20,37,06980,9.852216748768473
"New London town, North Carolina",267,241,26,37,46820,9.737827715355806
"Raleigh city, North Carolina",199214,180046,19168,37,55000,9.621813727950848
"Brogden CDP, North Carolina",1125,901,224,37,08110,19.91111111111111
"Ashley Heights CDP, North Carolina",144,127,17,37,02240,11.805555555555555
"Beulaville town, North Carolina",855,748,107,37,05660,12.514619883040936
"Rose Hill town, North Carolina",972,854,118,37,57860,12.139917695473251
"Bethel town, North Carolina",862,719,143,37,05460,16.58932714617169
"Shannon CDP, North Carolina",97,75,22,37,60940,22.68041237113402
"Ellerbe town, North Carolina",428,365,63,37,20840,14.719626168224298
"Belhaven town, North Carolina",1109,854,255,37,04640,22.993688007213706
"Weldon town, North Carolina",816,649,167,37,71780,20.465686274509803
"Glen Raven CDP, North Carolina",1292,1120,172,37,26460,13.312693498452013
"Randleman city, North Carolina",2008,1759,249,37,55080,12.400398406374503
"Wilson city, North Carolina",22051,19761,2290,37,74540,10.3850165525373
"Gibson town, North Carolina",255,206,49,37,25940,19.215686274509807
"Stallings town, North Carolina",5741,5552,189,37,64420,3.2921093886082566
"Warrenton town, North Carolina",644,518,126,37,71100,19.565217391304348
"Hillsborough town, North Carolina",2949,2603,346,37,31620,11.732790776534419
"Lake Lure town, North Carolina",2274,742,1532,37,36500,67.37027264731749
"Delway CDP, North Carolina",37,23,14,37,16860,37.83783783783784
"Harrells town, North Carolina",84,61,23,37,29680,27.380952380952383
"Mount Olive town, North Carolina",2173,1713,460,37,45100,21.168890934192362
"Tarboro town, North Carolina",5170,4793,377,37,66700,7.292069632495164
"Sanford city, North Carolina",11561,10407,1154,37,59280,9.981835481359743
"Clyde town, North Carolina",577,492,85,37,13280,14.731369150779896
"Sugar Mountain village, North Carolina",1705,237,1468,37,65530,86.09970674486803
"Stoneville town, North Carolina",572,449,123,37,65100,21.503496503496503
"Faison town, North Carolina",412,375,37,37,22560,8.980582524271846
"Black Creek town, North Carolina",299,279,20,37,06080,6.688963210702341
"Eureka town, North Carolina",109,87,22,37,21960,20.18348623853211
"Fremont town, North Carolina",615,504,111,37,24900,18.048780487804876
"Pikeville town, North Carolina",327,266,61,37,51780,18.654434250764528
"Elm City town, North Carolina",589,521,68,37,20980,11.544991511035652
"Sharpsburg town, North Carolina",1014,905,109,37,61060,10.749506903353057
"Autryville town, North Carolina",90,90,0,37,02700,0.0
"Elizabeth City city, North Carolina",8054,6617,1437,37,20580,17.84206605413459
"Tryon town, North Carolina",1074,886,188,37,68580,17.50465549348231
"Spencer town, North Carolina",1464,1196,268,37,63760,18.30601092896175
"Locust city, North Carolina",1481,1454,27,37,38860,1.8230925050641458
"Ruth town, North Carolina",193,162,31,37,58420,16.06217616580311
"Keener CDP, North Carolina",258,164,94,37,35340,36.434108527131784
"Turkey town, North Carolina",131,96,35,37,68740,26.717557251908396
"King city, North Carolina",3115,2884,231,37,35760,7.415730337078652
"Mount Airy city, North Carolina",5441,4564,877,37,44800,16.118360595478773
"Macon town, North Carolina",66,50,16,37,40540,24.242424242424242
"Roper town, North Carolina",386,267,119,37,57740,30.82901554404145
"Apex town, North Carolina",17816,17093,723,37,01520,4.058149977548271
"Mebane city, North Carolina",6322,5858,464,37,42240,7.339449541284404
"Saluda city, North Carolina",565,355,210,37,58920,37.16814159292036
"Lumber Bridge town, North Carolina",42,35,7,37,39680,16.666666666666664
"Red Springs town, North Carolina",1731,1366,365,37,55660,21.086077411900636
"Morrisville town, North Carolina",9854,9219,635,37,44520,6.444083620864624
"Zebulon town, North Carolina",1813,1691,122,37,76220,6.729178157749587
"Elroy CDP, North Carolina",1614,1462,152,37,21130,9.417596034696405
"Mar-Mac CDP, North Carolina",1529,1406,123,37,41540,8.04447351209941
"Kenly town, North Carolina",844,760,84,37,35540,9.95260663507109
"Lucama town, North Carolina",515,398,117,37,39600,22.718446601941746
"Richfield town, North Carolina",223,192,31,37,56340,13.901345291479823
"Dobson town, North Carolina",694,634,60,37,17340,8.645533141210375
"Wingate town, North Carolina",1151,1065,86,37,74760,7.471763683753258
"Henderson city, North Carolina",6792,5664,1128,37,30660,16.607773851590103
"South Henderson CDP, North Carolina",478,388,90,37,63240,18.828451882845187
"Brevard city, North Carolina",4339,3421,918,37,07720,21.15694860566951
"Knightdale town, North Carolina",5966,5699,267,37,36080,4.475360375460945
"Fairmont town, North Carolina",1335,1115,220,37,22360,16.479400749063668
"McDonald town, North Carolina",47,40,7,37,40140,14.893617021276595
"Orrum town, North Carolina",41,24,17,37,49460,41.46341463414634
"Proctorville town, North Carolina",68,58,10,37,53900,14.705882352941178
"Rex CDP, North Carolina",0,0,0,37,56100,
"Seven Springs town, North Carolina",50,35,15,37,60540,30.0
"Jonesville town, North Carolina",1233,992,241,37,34840,19.54582319545823
"Farmville town, North Carolina",2037,1769,268,37,22820,13.156602847324498
"Chapel Hill town, North Carolina",21708,19863,1845,37,11800,8.499170812603648
"Creswell town, North Carolina",149,97,52,37,15420,34.899328859060404
"Cary town, North Carolina",64439,61548,2891,37,10740,4.4864135073480345
"Rolesville town, North Carolina",2420,2171,249,37,57640,10.289256198347108
"Roxboro city, North Carolina",3950,3326,624,37,58160,15.79746835443038
"Barker Ten Mile CDP, North Carolina",435,382,53,37,03665,12.183908045977011
"Raemon CDP, North Carolina",101,86,15,37,54600,14.85148514851485
"Raynham town, North Carolina",29,25,4,37,55340,13.793103448275861
"Falcon town, North Carolina",91,75,16,37,22620,17.582417582417584
"Laurinburg city, North Carolina",6928,5925,1003,37,37220,14.477482678983833
"Stedman town, North Carolina",555,511,44,37,64840,7.927927927927928
"Vann Crossroads CDP, North Carolina",80,64,16,37,69755,20.0
"Albemarle city, North Carolina",7122,6262,860,37,00680,12.075259758494806
"Flat Rock CDP, North Carolina",715,621,94,37,23640,13.146853146853147
"Pilot Mountain town, North Carolina",719,649,70,37,51820,9.735744089012517
"Ramseur town, North Carolina",825,660,165,37,55040,20.0
"Trinity city, North Carolina",2800,2551,249,37,68400,8.892857142857142
"Columbia town, North Carolina",522,386,136,37,13940,26.053639846743295
"Norlina town, North Carolina",574,518,56,37,47240,9.75609756097561
"Durham city, North Carolina",116651,107724,8927,37,19000,7.652741939631894
"Holly Springs town, North Carolina",10964,10598,366,37,32260,3.338197738051806
"Rennert town, North Carolina",139,122,17,37,55940,12.23021582733813
"Walnut Creek village, North Carolina",477,460,17,37,70820,3.563941299790356
"Carrboro town, North Carolina",9781,9202,579,37,10620,5.919640118597281
"Prospect CDP, North Carolina",333,305,28,37,53950,8.408408408408409
"Denton town, North Carolina",836,712,124,37,16980,14.832535885167463
"Macclesfield town, North Carolina",293,237,56,37,39960,19.112627986348123
"West Canton CDP, North Carolina",552,488,64,37,72150,11.594202898550725
"Ogden CDP, North Carolina",2973,2894,79,37,48790,2.6572485704675413
"Skippers Corner CDP, North Carolina",858,784,74,37,62190,8.624708624708624
"Rockwell town, North Carolina",830,732,98,37,57340,11.80722891566265
"Oxford city, North Carolina",3862,3427,435,37,49800,11.26359399274987
"Norman town, North Carolina",74,46,28,37,47260,37.83783783783784
"Whiteville city, North Carolina",2741,2227,514,37,73660,18.752280189711783
"Godwin town, North Carolina",54,43,11,37,26740,20.37037037037037
"Roanoke Rapids city, North Carolina",6986,6070,916,37,56900,13.111938162038362
"South Rosemary CDP, North Carolina",1292,1067,225,37,63470,17.414860681114554
"Smithfield town, North Carolina",5341,4704,637,37,62520,11.926605504587156
"Bent Creek CDP, North Carolina",619,598,21,37,05049,3.392568659127625
"Concord city, North Carolina",35057,32539,2518,37,14100,7.182588356105771
"Saratoga town, North Carolina",219,201,18,37,59340,8.21917808219178
"Ayden town, North Carolina",2374,2118,256,37,02840,10.783487784330244
"Falkland town, North Carolina",33,25,8,37,22640,24.242424242424242
"Archdale city, North Carolina",4832,4671,161,37,01720,3.3319536423841054
"Liberty town, North Carolina",1198,1037,161,37,38100,13.439065108514189
"Cricket CDP, North Carolina",909,816,93,37,15440,10.231023102310232
"Mulberry CDP, North Carolina",1084,964,120,37,45560,11.07011070110701
"North Wilkesboro town, North Carolina",1976,1724,252,37,47880,12.753036437246964
"Half Moon CDP, North Carolina",3003,2648,355,37,28900,11.821511821511821
"Holly Ridge town, North Carolina",1216,907,309,37,32180,25.411184210526315
"East Rockingham CDP, North Carolina",1657,1400,257,37,19800,15.50995775497888
"Hoffman town, North Carolina",295,242,53,37,31920,17.966101694915253
"Greensboro city, North Carolina",130208,115501,14707,37,28000,11.295004915212582
"Summerfield town, North Carolina",3961,3891,70,37,65580,1.7672304973491544
"Whitsett town, North Carolina",390,371,19,37,73760,4.871794871794872
"Bethania town, North Carolina",165,160,5,37,05340,3.0303030303030303
"Walkertown town, North Carolina",2248,2044,204,37,70660,9.07473309608541
"Enfield town, North Carolina",1150,952,198,37,21360,17.217391304347824
"Halifax town, North Carolina",130,78,52,37,28920,40.0
"Scotland Neck town, North Carolina",951,585,366,37,59780,38.48580441640379
"Littleton town, North Carolina",393,299,94,37,38680,23.918575063613233
"Clayton town, North Carolina",7352,6919,433,37,12860,5.88955386289445
"Princeton town, North Carolina",519,432,87,37,53820,16.76300578034682
"Selma town, North Carolina",2595,2197,398,37,60320,15.337186897880539
"Beech Mountain town, North Carolina",2403,282,2121,37,04510,88.26466916354558
"Ronda town, North Carolina",208,189,19,37,57700,9.134615384615383
"Wilkesboro town, North Carolina",1717,1560,157,37,74020,9.143855562026792
"Sneads Ferry CDP, North Carolina",1749,1200,549,37,62680,31.3893653516295
"Atkinson town, North Carolina",135,123,12,37,02460,8.88888888888889
"Surf City town, North Carolina",3911,1298,2613,37,66040,66.81155714650984
"Murphy town, North Carolina",979,782,197,37,45660,20.122574055158324
"Dillsboro town, North Carolina",148,116,32,37,17180,21.62162162162162
"Middlesex town, North Carolina",491,411,80,37,42700,16.293279022403258
"Five Points CDP, North Carolina",376,330,46,37,23520,12.23404255319149
"Teachey town, North Carolina",178,158,20,37,67000,11.235955056179774
"Polkton town, North Carolina",638,576,62,37,53140,9.717868338557993
"Castalia town, North Carolina",202,164,38,37,10860,18.81188118811881
"Saxapahaw CDP, North Carolina",685,661,24,37,59580,3.5036496350364965
"McFarlan town, North Carolina",68,51,17,37,40240,25.0
"Banner Elk town, North Carolina",619,330,289,37,03500,46.68820678513732
"Washington city, North Carolina",4436,3767,669,37,71220,15.081154192966636
"Hightsville CDP, North Carolina",195,162,33,37,31490,16.923076923076923
"Kings Grant CDP, North Carolina",3463,3425,38,37,35870,1.0973144672249495
"Woodland town, North Carolina",388,336,52,37,75340,13.402061855670103
"Madison town, North Carolina",1179,1013,166,37,40560,14.079728583545378
"Wentworth town, North Carolina",1064,945,119,37,71900,11.18421052631579
"East Spencer town, North Carolina",778,574,204,37,19860,26.221079691516707
"Salisbury city, North Carolina",14972,12742,2230,37,58860,14.894469676729896
"Spindale town, North Carolina",1840,1466,374,37,63880,20.32608695652174
"Garland town, North Carolina",396,334,62,37,25460,15.656565656565657
"Newton Grove town, North Carolina",291,253,38,37,47020,13.058419243986256
"Silver City CDP, North Carolina",480,368,112,37,61920,23.333333333333332
"Warsaw town, North Carolina",1426,1191,235,37,71160,16.479663394109398
"Lexington city, North Carolina",8578,7254,1324,37,38060,15.434833294474238
"Conetoe town, North Carolina",167,135,32,37,14200,19.16167664670659
"Pinetops town, North Carolina",652,549,103,37,52140,15.797546012269938
"Bailey town, North Carolina",230,190,40,37,03020,17.391304347826086
"Dortches town, North Carolina",495,402,93,37,17520,18.787878787878785
"Bayshore CDP, North Carolina",1694,1635,59,37,04015,3.4828807556080283
"Carolina Beach town, North Carolina",5856,2790,3066,37,10500,52.356557377049185
"Bolton town, North Carolina",318,245,73,37,06860,22.955974842767297
"Biltmore Forest town, North Carolina",718,631,87,37,05880,12.116991643454039
"Montreat town, North Carolina",644,81,563,37,44100,87.4223602484472
"Hudson town, North Carolina",1769,1504,265,37,32980,14.980214810627473
"Sawmills town, North Carolina",2408,2009,399,37,59540,16.569767441860463
"Cove City town, North Carolina",196,152,44,37,15020,22.448979591836736
"Havelock city, North Carolina",6602,5918,684,37,30120,10.360496819145713
"Dellview town, North Carolina",6,6,0,37,16820,0.0
"Elon town, North Carolina",3468,3322,146,37,21095,4.2099192618223755
"Fairview town, North Carolina",1609,1488,121,37,22500,7.520198881292728
"Grantsboro town, North Carolina",323,274,49,37,27520,15.170278637770899
"Midland town, North Carolina",1307,1205,102,37,42760,7.804131599081867
"Butner town, North Carolina",2767,2626,141,37,09360,5.095771593783882
"Eastover town, North Carolina",1605,1364,241,37,19740,15.01557632398754
"Midway town, North Carolina",2004,1929,75,37,42860,3.74251497005988
"Altamahaw CDP, North Carolina",139,139,0,37,01140,0.0
"Bear Grass town, North Carolina",43,38,5,37,04180,11.627906976744185
"Duck town, North Carolina",2875,293,2582,37,18060,89.80869565217391
"Mills River town, North Carolina",3142,2970,172,37,43260,5.47422024188415
"Misenheimer village, North Carolina",126,102,24,37,43580,19.047619047619047
"North Topsail Beach town, North Carolina",2525,518,2007,37,47845,79.48514851485149
"Ossipee town, North Carolina",224,181,43,37,49600,19.196428571428573
"Red Cross town, North Carolina",372,342,30,37,55460,8.064516129032258
"Wallburg town, North Carolina",1343,1197,146,37,70740,10.871183916604616
"Chimney Rock Village village, North Carolina",216,60,156,37,12460,72.22222222222221
"Advance CDP, North Carolina",418,391,27,37,00440,6.4593301435406705
"Aquadale CDP, North Carolina",157,110,47,37,01560,29.936305732484076
"Archer Lodge town, North Carolina",1685,1685,0,37,01760,0.0
"Atlantic CDP, North Carolina",338,217,121,37,02480,35.798816568047336
"Belvoir CDP, North Carolina",228,179,49,37,04955,21.49122807017544
"Avon CDP, North Carolina",1948,399,1549,37,02780,79.51745379876797
"Bayview CDP, North Carolina",302,96,206,37,04040,68.21192052980133
"Bell Arthur CDP, North Carolina",87,87,0,37,04680,0.0
"Bennett CDP, North Carolina",125,125,0,37,05020,0.0
"Blue Clay Farms CDP, North Carolina",5,5,0,37,06510,0.0
"Broad Creek CDP, North Carolina",1206,1023,183,37,08040,15.17412935323383
"Bunnlevel CDP, North Carolina",278,241,37,37,08880,13.309352517985612
"Buxton CDP, North Carolina",833,518,315,37,09400,37.81512605042017
"Camden CDP, North Carolina",305,278,27,37,09780,8.852459016393443
"Caroleen CDP, North Carolina",504,380,124,37,10460,24.6031746031746
"Cherokee CDP, North Carolina",1220,939,281,37,12140,23.0327868852459
"Cliffside CDP, North Carolina",163,78,85,37,13100,52.14723926380368
"Coinjock CDP, North Carolina",205,191,14,37,13500,6.829268292682928
"Cordova CDP, North Carolina",931,836,95,37,14600,10.204081632653061
"Cove Creek CDP, North Carolina",693,464,229,37,15040,33.04473304473304
"Dana CDP, North Carolina",1636,1515,121,37,16220,7.396088019559902
"Davis CDP, North Carolina",258,161,97,37,16480,37.5968992248062
"Deercroft CDP, North Carolina",181,168,13,37,16730,7.18232044198895
"Delco CDP, North Carolina",116,103,13,37,16780,11.206896551724139
"Denver CDP, North Carolina",1387,1315,72,37,17000,5.191059841384282
"Edneyville CDP, North Carolina",1075,824,251,37,20280,23.348837209302324
"Efland CDP, North Carolina",316,235,81,37,20420,25.63291139240506
"Engelhard CDP, North Carolina",181,181,0,37,21380,0.0
"Evergreen CDP, North Carolina",99,99,0,37,22080,0.0
"Fairfield CDP, North Carolina",54,54,0,37,22280,0.0
"Fearrington Village CDP, North Carolina",1681,1669,12,37,22982,0.7138607971445567
"Foscoe CDP, North Carolina",1566,778,788,37,24380,50.31928480204342
"Frisco CDP, North Carolina",330,103,227,37,25020,68.78787878787878
"Fruitland CDP, North Carolina",1124,981,143,37,25160,12.722419928825623
"Germanton CDP, North Carolina",445,404,41,37,25880,9.213483146067416
"Gerton CDP, North Carolina",433,169,264,37,25900,60.969976905311775
"Glenville CDP, North Carolina",238,43,195,37,26520,81.9327731092437
"Gloucester CDP, North Carolina",315,201,114,37,26680,36.19047619047619
"Gulf CDP, North Carolina",152,103,49,37,28600,32.23684210526316
"Hallsboro CDP, North Carolina",208,197,11,37,29000,5.288461538461538
"Hampstead CDP, North Carolina",2210,2010,200,37,29180,9.049773755656108
"Hatteras CDP, North Carolina",846,268,578,37,30100,68.32151300236407
"Henrietta CDP, North Carolina",113,72,41,37,30800,36.283185840707965
"Hiddenite CDP, North Carolina",148,148,0,37,31260,0.0
"Hobucken CDP, North Carolina",123,38,85,37,31880,69.10569105691057
"Hollister CDP, North Carolina",383,292,91,37,32100,23.759791122715406
"Hoopers Creek CDP, North Carolina",480,429,51,37,32580,10.625
"Horse Shoe CDP, North Carolina",1041,957,84,37,32740,8.069164265129682
"Iron Station CDP, North Carolina",368,368,0,37,33820,0.0
"Jackson Heights CDP, North Carolina",384,340,44,37,34038,11.458333333333332
"Lake Royale CDP, North Carolina",1809,1214,595,37,36513,32.89110005527916
"Lake Santeetlah town, North Carolina",204,23,181,37,36514,88.72549019607843
"Laurel Hill CDP, North Carolina",545,447,98,37,37120,17.98165137614679
"Lowgap CDP, North Carolina",161,146,15,37,39540,9.316770186335404
"Mamers CDP, North Carolina",396,306,90,37,40860,22.727272727272727
"Manns Harbor CDP, North Carolina",449,352,97,37,40980,21.603563474387528
"Marble CDP, North Carolina",166,158,8,37,41220,4.819277108433735
"Marshallberg CDP, North Carolina",293,145,148,37,41600,50.51194539249146
"Maury CDP, North Carolina",211,145,66,37,42000,31.27962085308057
"Northchase CDP, North Carolina",1834,1619,215,37,47485,11.723009814612869
"Millingport CDP, North Carolina",208,200,8,37,43200,3.8461538461538463
"Moncure CDP, North Carolina",280,280,0,37,43880,0.0
"Moyock CDP, North Carolina",1426,1304,122,37,45460,8.55539971949509
"Old Hundred CDP, North Carolina",131,131,0,37,48940,0.0
"Pinetown CDP, North Carolina",70,70,0,37,52160,0.0
"Pinnacle CDP, North Carolina",324,250,74,37,52500,22.839506172839506
"Porters Neck CDP, North Carolina",3256,3048,208,37,53475,6.388206388206388
"Potters Hill CDP, North Carolina",244,179,65,37,53580,26.639344262295083
"Riegelwood CDP, North Carolina",336,310,26,37,56600,7.738095238095238
"Robbins town, North Carolina",640,538,102,37,57000,15.937499999999998
"Rocky Point CDP, North Carolina",806,717,89,37,57540,11.042183622828784
"Rodanthe CDP, North Carolina",604,77,527,37,57580,87.25165562913907
"Rougemont CDP, North Carolina",303,287,16,37,58040,5.2805280528052805
"Ruffin CDP, North Carolina",197,146,51,37,58340,25.888324873096447
"Salvo CDP, North Carolina",476,44,432,37,58940,90.75630252100841
"Scotch Meadows CDP, North Carolina",186,186,0,37,59765,0.0
"South Mills CDP, North Carolina",251,213,38,37,63340,15.139442231075698
"Southmont CDP, North Carolina",554,433,121,37,63360,21.841155234657037
"Spivey's Corner CDP, North Carolina",226,158,68,37,63920,30.08849557522124
"Stokes CDP, North Carolina",262,262,0,37,65020,0.0
"Sunbury CDP, North Carolina",142,106,36,37,65700,25.352112676056336
"Swan Quarter CDP, North Carolina",197,177,20,37,66340,10.152284263959391
"Tyro CDP, North Carolina",1686,1506,180,37,69020,10.676156583629894
"Valle Crucis CDP, North Carolina",198,89,109,37,69600,55.05050505050505
"Wakulla CDP, North Carolina",30,18,12,37,70580,40.0
"Waves CDP, North Carolina",314,23,291,37,71440,92.67515923566879
"Centerville CDP, North Carolina",132,100,32,37,11560,24.242424242424242
"High Shoals city, North Carolina",339,278,61,37,31440,17.99410029498525
"Fontana Dam town, North Carolina",140,7,133,37,23980,95.0
"Valley Hill CDP, North Carolina",1179,988,191,37,69640,16.20016963528414
"Dickey city, North Dakota",20,15,5,38,19580,25.0
"Palermo city, North Dakota",92,59,33,38,60620,35.869565217391305
"Drake city, North Dakota",233,183,50,38,20300,21.45922746781116
"Dazey city, North Dakota",51,41,10,38,18340,19.607843137254903
"New Leipzig city, North Dakota",136,108,28,38,56420,20.588235294117645
"Wyndmere city, North Dakota",234,214,20,38,87740,8.547008547008547
"Medora city, North Dakota",130,60,70,38,51900,53.84615384615385
"LaMoure city, North Dakota",408,328,80,38,44540,19.607843137254903
"Flasher city, North Dakota",203,142,61,38,26660,30.049261083743843
"Hebron city, North Dakota",447,365,82,38,36860,18.344519015659955
"Ross city, North Dakota",80,45,35,38,68540,43.75
"Crystal city, North Dakota",65,65,0,38,17060,0.0
"Glenburn city, North Dakota",220,167,53,38,30580,24.09090909090909
"St. Thomas city, North Dakota",193,158,35,38,70260,18.134715025906736
"Walhalla city, North Dakota",509,473,36,38,82980,7.072691552062868
"Newburg city, North Dakota",57,45,12,38,56020,21.052631578947366
"Sherwood city, North Dakota",119,98,21,38,72540,17.647058823529413
"Wolford city, North Dakota",18,14,4,38,87180,22.22222222222222
"Loma city, North Dakota",16,7,9,38,47660,56.25
"Nekoma city, North Dakota",32,13,19,38,55740,59.375
"Ambrose city, North Dakota",16,9,7,38,01860,43.75
"Karlsruhe city, North Dakota",41,34,7,38,41380,17.073170731707318
"Upham city, North Dakota",97,75,22,38,80860,22.68041237113402
"Bucyrus city, North Dakota",16,9,7,38,10300,43.75
"Parshall city, North Dakota",465,324,141,38,60940,30.32258064516129
"Crosby city, North Dakota",706,516,190,38,16940,26.912181303116146
"Almont city, North Dakota",70,51,19,38,01700,27.142857142857142
"New Salem city, North Dakota",480,449,31,38,56700,6.458333333333334
"Plaza city, North Dakota",98,82,16,38,62980,16.3265306122449
"Bathgate city, North Dakota",28,21,7,38,05260,25.0
"Langdon city, North Dakota",1158,877,281,38,44780,24.265975820379964
"Turtle Lake city, North Dakota",373,304,69,38,79940,18.498659517426276
"Forbes city, North Dakota",25,15,10,38,26980,40.0
"Gladstone city, North Dakota",139,111,28,38,30460,20.14388489208633
"Mapleton city, North Dakota",343,336,7,38,50580,2.0408163265306123
"Rolette city, North Dakota",337,296,41,38,67780,12.166172106824925
"Shell Valley CDP, North Dakota",399,364,35,38,72250,8.771929824561402
"Hope city, North Dakota",179,159,20,38,38860,11.1731843575419
"Cleveland city, North Dakota",50,34,16,38,14660,32.0
"Great Bend city, North Dakota",42,32,10,38,32900,23.809523809523807
"Buchanan city, North Dakota",24,22,2,38,10060,8.333333333333332
"Dunn Center city, North Dakota",133,101,32,38,20940,24.06015037593985
"Killdeer city, North Dakota",431,355,76,38,42700,17.633410672853827
"Stanley city, North Dakota",1183,908,275,38,75380,23.24598478444632
"Pembina city, North Dakota",283,232,51,38,61580,18.021201413427562
"Bottineau city, North Dakota",1058,933,125,38,08460,11.814744801512287
"Tappen city, North Dakota",124,110,14,38,77980,11.29032258064516
"Anamoose city, North Dakota",185,128,57,38,02220,30.810810810810814
"Voltaire city, North Dakota",20,20,0,38,82380,0.0
"Gascoyne city, North Dakota",9,9,0,38,29540,0.0
"Auburn CDP, North Dakota",40,11,29,38,03740,72.5
"Barton CDP, North Dakota",10,0,10,38,05220,100.0
"Blanchard CDP, North Dakota",3,3,0,38,07620,0.0
"Brooktree Park CDP, North Dakota",30,30,0,38,09830,0.0
"Caledonia CDP, North Dakota",14,14,0,38,11500,0.0
"Dahlen CDP, North Dakota",29,15,14,38,17620,48.275862068965516
"De Lamere CDP, North Dakota",11,7,4,38,18820,36.36363636363637
"Denhoff CDP, North Dakota",17,11,6,38,19060,35.294117647058826
"Driscoll CDP, North Dakota",42,30,12,38,20500,28.57142857142857
"East Fairview CDP, North Dakota",30,18,12,38,21580,40.0
"Cleveland Heights city, Ohio",21548,18831,2717,39,16014,12.609058845368478
"Cuyahoga Heights village, Ohio",285,260,25,39,19806,8.771929824561402
"Euclid city, Ohio",26302,22627,3675,39,25704,13.972321496464147
"Independence city, Ohio",2929,2702,227,39,37240,7.7500853533629215
"Mayfield village, Ohio",1587,1531,56,39,48468,3.5286704473850032
"Middleburg Heights city, Ohio",7101,6878,223,39,49644,3.140402760174623
"North Randall village, Ohio",555,508,47,39,56924,8.468468468468467
"North Royalton city, Ohio",13231,12657,574,39,57008,4.338296425062354
"Strongsville city, Ohio",18693,17828,865,39,75098,4.62740063125234
"Elgin village, Ohio",47,43,4,39,24794,8.51063829787234
"West Alexandria village, Ohio",673,624,49,39,82880,7.280832095096583
"Hanoverton village, Ohio",178,153,25,39,33306,14.04494382022472
"New Waterford village, Ohio",586,526,60,39,55790,10.238907849829351
"Roseville village, Ohio",919,775,144,39,68560,15.669205658324264
"St. Marys city, Ohio",3727,3486,241,39,69680,6.466326804400321
"Northbrook CDP, Ohio",4491,4279,212,39,56280,4.720552215542195
"Grafton village, Ohio",929,844,85,39,31150,9.14962325080732
"Norwich village, Ohio",54,43,11,39,57372,20.37037037037037
"Bolindale CDP, Ohio",1106,957,149,39,07583,13.471971066907775
"Warren city, Ohio",20138,17145,2993,39,80892,14.862449101201708
"New Lebanon village, Ohio",1736,1528,208,39,54852,11.981566820276496
"Forestville CDP, Ohio",4658,4454,204,39,27776,4.37956204379562
"Lincoln Heights village, Ohio",1624,1387,237,39,43722,14.5935960591133
"Mariemont village, Ohio",1661,1468,193,39,47600,11.619506321493077
"Phillipsburg village, Ohio",253,200,53,39,62414,20.948616600790515
"Riverside city, Ohio",11442,10422,1020,39,67468,8.914525432616676
"Trotwood city, Ohio",12246,10440,1806,39,77504,14.74767270945615
"Logan city, Ohio",3245,2831,414,39,44632,12.75808936825886
"Glenmont village, Ohio",129,112,17,39,30506,13.178294573643413
"Portage village, Ohio",193,185,8,39,64108,4.145077720207254
"Rossford city, Ohio",2942,2692,250,39,68686,8.497620666213459
"Tontogany village, Ohio",226,200,26,39,77070,11.504424778761061
"Arlington village, Ohio",631,574,57,39,02400,9.033280507131538
"Toledo city, Ohio",138107,117864,20243,39,77000,14.657475725343394
"Clarington village, Ohio",196,158,38,39,15210,19.387755102040817
"Hiram village, Ohio",246,205,41,39,35658,16.666666666666664
"Streetsboro city, Ohio",7089,6694,395,39,75014,5.572012977853012
"Grand River village, Ohio",188,175,13,39,31234,6.914893617021277
"Attica village, Ohio",451,391,60,39,02820,13.303769401330376
"Bettsville village, Ohio",305,287,18,39,06194,5.901639344262295
"New Riegel village, Ohio",118,118,0,39,55398,0.0
"Christiansburg village, Ohio",231,192,39,39,14296,16.883116883116884
"Hunter CDP, Ohio",904,851,53,39,36806,5.8628318584070795
"Eaton Estates CDP, Ohio",473,456,17,39,24262,3.5940803382663846
"Kipton village, Ohio",105,88,17,39,40544,16.19047619047619
"Sheffield village, Ohio",1871,1704,167,39,72060,8.925708177445218
"South Amherst village, Ohio",795,726,69,39,73040,8.679245283018867
"Seven Hills city, Ohio",5174,4997,177,39,71416,3.4209509083880945
"Prospect village, Ohio",474,379,95,39,64780,20.042194092827003
"Athalia village, Ohio",138,109,29,39,02722,21.014492753623188
"Clayton city, Ohio",5339,4890,449,39,15644,8.409814572017233
"Owensville village, Ohio",504,461,43,39,59220,8.531746031746032
"Amelia village, Ohio",2005,1890,115,39,01742,5.7356608478802995
"Felicity village, Ohio",381,309,72,39,26880,18.89763779527559
"Mount Repose CDP, Ohio",1773,1647,126,39,53032,7.1065989847715745
"Summerside CDP, Ohio",2069,1876,193,39,75434,9.328177863702273
"Williamsburg village, Ohio",1103,967,136,39,85288,12.330009066183138
"Burbank village, Ohio",95,78,17,39,10254,17.894736842105264
"Blanchester village, Ohio",1720,1586,134,39,06908,7.790697674418605
"Deshler village, Ohio",749,647,102,39,21812,13.618157543391188
"McClure village, Ohio",326,287,39,39,45794,11.96319018404908
"New Bavaria village, Ohio",44,44,0,39,54110,0.0
"Embden CDP, North Dakota",11,11,0,38,24020,0.0
"Englevale CDP, North Dakota",39,39,0,38,24380,0.0
"Foxholm CDP, North Dakota",39,15,24,38,27980,61.53846153846154
"Green Acres CDP, North Dakota",136,126,10,38,33050,7.352941176470589
"Harmon CDP, North Dakota",90,90,0,38,35500,0.0
"Heil CDP, North Dakota",8,8,0,38,36980,0.0
"Heimdal CDP, North Dakota",15,3,12,38,37020,80.0
"Jessie CDP, North Dakota",31,16,15,38,40740,48.38709677419355
"Larson CDP, North Dakota",16,8,8,38,45220,50.0
"Logan CDP, North Dakota",68,68,0,38,47540,0.0
"McLeod CDP, North Dakota",5,5,0,38,49540,0.0
"Manning CDP, North Dakota",34,34,0,38,50220,0.0
"Menoken CDP, North Dakota",33,31,2,38,52180,6.0606060606060606
"Nash CDP, North Dakota",26,26,0,38,55500,0.0
"Orrin CDP, North Dakota",7,0,7,38,59820,100.0
"Porcupine CDP, North Dakota",58,49,9,38,63700,15.517241379310345
"Spiritwood CDP, North Dakota",4,4,0,38,74660,0.0
"Raleigh CDP, North Dakota",12,8,4,38,65100,33.33333333333333
"Ruthville CDP, North Dakota",116,75,41,38,69300,35.3448275862069
"Selz CDP, North Dakota",12,12,0,38,71700,0.0
"Sutton CDP, North Dakota",16,6,10,38,77260,62.5
"Ypsilanti CDP, North Dakota",51,44,7,38,88020,13.725490196078432
"Findlay city, Ohio",19553,18255,1298,39,27048,6.63836751393648
"Jenera village, Ohio",98,80,18,39,38948,18.367346938775512
"Mount Cory village, Ohio",84,79,5,39,52668,5.952380952380952
"Vanlue village, Ohio",134,116,18,39,79534,13.432835820895523
"Harbor View village, Ohio",31,24,7,39,33376,22.58064516129032
"Oregon city, Ohio",8842,8352,490,39,58730,5.541732639674281
"Midvale village, Ohio",286,276,10,39,49966,3.4965034965034967
"Swanton village, Ohio",1393,1345,48,39,75896,3.4458004307250536
"Sylvania city, Ohio",8057,7621,436,39,76022,5.411443465309668
"Dennison village, Ohio",1246,1102,144,39,21714,11.556982343499197
"Mineral City village, Ohio",334,280,54,39,50764,16.16766467065868
"New Philadelphia city, Ohio",7764,7127,637,39,55216,8.204533745492014
"Calcutta CDP, Ohio",1578,1523,55,39,10926,3.4854245880861847
"La Croft CDP, Ohio",492,467,25,39,41090,5.08130081300813
"Rogers village, Ohio",108,104,4,39,68084,3.7037037037037033
"Marble Cliff village, Ohio",317,291,26,39,47474,8.201892744479496
"Lucasville CDP, Ohio",582,582,0,39,45304,0.0
"Rosemount CDP, Ohio",748,722,26,39,68546,3.4759358288770055
"Carey village, Ohio",1626,1470,156,39,12112,9.59409594095941
"Springboro city, Ohio",6624,6342,282,39,74076,4.257246376811595
"Middletown city, Ohio",22842,19776,3066,39,49840,13.422642500656684
"Seven Mile village, Ohio",315,280,35,39,71444,11.11111111111111
"Jackson city, Ohio",3161,2781,380,39,37842,12.021512179689973
"Oak Hill village, Ohio",786,703,83,39,57596,10.559796437659033
"Newtown village, Ohio",1161,1068,93,39,55678,8.010335917312661
"Portage Lakes CDP, Ohio",3785,3374,411,39,64136,10.858652575957727
"Dellroy village, Ohio",183,153,30,39,21560,16.39344262295082
"North Bend village, Ohio",406,404,2,39,56182,0.49261083743842365
"Norwood city, Ohio",9808,8605,1203,39,57386,12.265497553017944
"Piketon village, Ohio",858,775,83,39,62708,9.673659673659674
"De Graff village, Ohio",593,538,55,39,21378,9.27487352445194
"West Liberty village, Ohio",786,736,50,39,83734,6.361323155216285
"Zanesfield village, Ohio",133,117,16,39,88070,12.030075187969924
"Grover Hill village, Ohio",183,150,33,39,32620,18.0327868852459
"Paulding village, Ohio",1729,1568,161,39,61252,9.31174089068826
"Bellbrook city, Ohio",3088,3057,31,39,05102,1.0038860103626943
"Amsterdam village, Ohio",221,180,41,39,01938,18.552036199095024
"Dillonvale village, Ohio",374,298,76,39,22022,20.32085561497326
"New Alexandria village, Ohio",124,115,9,39,54012,7.258064516129033
"Hamden village, Ohio",368,302,66,39,32956,17.934782608695652
"Coshocton city, Ohio",5328,4791,537,39,18868,10.07882882882883
"Warsaw village, Ohio",255,240,15,39,81032,5.88235294117647
"West Lafayette village, Ohio",1024,929,95,39,83608,9.27734375
"Melrose village, Ohio",113,87,26,39,49000,23.008849557522122
"Oakwood village (Paulding County), Ohio",284,242,42,39,57792,14.788732394366196
"Maple Ridge CDP, Ohio",318,318,0,39,47362,0.0
"Beloit village, Ohio",449,444,5,39,05410,1.1135857461024499
"Boardman CDP, Ohio",16488,15116,1372,39,07454,8.321203299369238
"Mentor-on-the-Lake city, Ohio",3414,3332,82,39,49098,2.401874633860574
"Antioch village, Ohio",51,48,3,39,02148,5.88235294117647
"Mutual village, Ohio",61,46,15,39,53480,24.59016393442623
"Zaleski village, Ohio",144,111,33,39,88028,22.916666666666664
"Xenia city, Ohio",12055,11021,1034,39,86772,8.577353795105765
"West Jefferson village, Ohio",1769,1645,124,39,83580,7.009609949123799
"Napoleon city, Ohio",4092,3812,280,39,53550,6.8426197458455515
"Cedarville village, Ohio",772,711,61,39,12784,7.901554404145078
"Mingo Junction village, Ohio",1781,1457,324,39,50904,18.19202695115104
"Fredericksburg village, Ohio",145,134,11,39,28616,7.586206896551724
"Shreve village, Ohio",691,635,56,39,72396,8.104196816208393
"Midland village, Ohio",129,94,35,39,49896,27.131782945736433
"Macedonia city, Ohio",4705,4647,58,39,45976,1.2327311370882041
"Mansfield city, Ohio",21913,17885,4028,39,47138,18.381782503536716
"Shelby city, Ohio",4392,4038,354,39,72102,8.060109289617486
"Devola CDP, Ohio",1130,1090,40,39,21868,3.5398230088495577
"Eastlake city, Ohio",8402,8013,389,39,23618,4.629850035705784
"East Liverpool city, Ohio",5277,4280,997,39,23730,18.893310593140043
"New Paris village, Ohio",781,672,109,39,55188,13.956466069142126
"West Manchester village, Ohio",181,154,27,39,83804,14.917127071823206
"Salineville village, Ohio",586,506,80,39,70100,13.651877133105803
"Grove City city, Ohio",16517,15607,910,39,32592,5.5094750862747475
"Hilliard city, Ohio",13496,13171,325,39,35476,2.4081209247184354
"Roaming Shores village, Ohio",887,566,321,39,67600,36.18940248027058
"Hollansburg village, Ohio",113,98,15,39,35896,13.274336283185843
"North Star village, Ohio",110,101,9,39,57064,8.181818181818182
"Palestine village, Ohio",112,96,16,39,59598,14.285714285714285
"Wayne Lakes village, Ohio",350,283,67,39,82348,19.142857142857142
"Celina city, Ohio",4986,4375,611,39,12868,12.254312073806659
"Rockford village, Ohio",466,399,67,39,67874,14.377682403433475
"Bloomdale village, Ohio",279,244,35,39,07062,12.544802867383511
"Fostoria city, Ohio",6544,5614,930,39,28014,14.211491442542787
"Millbury village, Ohio",491,475,16,39,50260,3.2586558044806515
"Milton Center village, Ohio",56,50,6,39,50708,10.714285714285714
"Dunkirk village, Ohio",399,320,79,39,22946,19.799498746867165
"Mount Vernon city, Ohio",7546,6996,550,39,53102,7.288629737609329
"Otway village, Ohio",57,35,22,39,59066,38.59649122807017
"Wheelersburg CDP, Ohio",2852,2508,344,39,84588,12.0617110799439
"Wharton village, Ohio",156,138,18,39,84574,11.538461538461538
"Pitsburg village, Ohio",151,138,13,39,62890,8.609271523178808
"Rossburg village, Ohio",85,84,1,39,68672,1.1764705882352942
"Chickasaw village, Ohio",151,147,4,39,14156,2.6490066225165565
"Edgewood CDP, Ohio",1856,1686,170,39,24542,9.159482758620689
"New Madison village, Ohio",404,371,33,39,54978,8.16831683168317
"Osgood village, Ohio",96,92,4,39,58912,4.166666666666666
"Yorkshire village, Ohio",35,35,0,39,87164,0.0
"Belmont village, Ohio",182,137,45,39,05312,24.725274725274726
"Yorkville village, Ohio",515,458,57,39,87178,11.067961165048544
"Vermilion city, Ohio",5319,4336,983,39,79716,18.48091746568904
"Glouster village, Ohio",834,660,174,39,30674,20.863309352517987
"Payne village, Ohio",543,525,18,39,61322,3.314917127071823
"Somerset village, Ohio",703,651,52,39,72977,7.396870554765292
"Port Jefferson village, Ohio",214,205,9,39,64262,4.205607476635514
"Brunswick city, Ohio",13960,13232,728,39,09680,5.214899713467049
"Choctaw Lake CDP, Ohio",548,537,11,39,14288,2.0072992700729926
"Medina city, Ohio",10986,10441,545,39,48790,4.9608592754414715
"Westfield Center village, Ohio",540,503,37,39,83468,6.851851851851852
"Lucas village, Ohio",300,252,48,39,45276,16.0
"Buckeye Lake village, Ohio",1648,1156,492,39,09890,29.85436893203883
"Richmond Heights city, Ohio",5311,4669,642,39,66894,12.088118998305404
"Burlington CDP, Ohio",1137,943,194,39,10352,17.06244503078276
"Centerville city, Ohio",11167,10620,547,39,13190,4.8983612429479715
"Cherry Grove CDP, Ohio",1601,1562,39,39,13848,2.4359775140537163
"Covedale CDP, Ohio",2647,2444,203,39,19008,7.669059312429165
"Lore City village, Ohio",147,115,32,39,44954,21.768707482993197
"Pleasant City village, Ohio",178,149,29,39,63436,16.292134831460675
"Elmwood Place village, Ohio",1089,861,228,39,25186,20.9366391184573
"Belpre city, Ohio",3182,2870,312,39,05424,9.805153991200504
"Beverly village, Ohio",618,544,74,39,06222,11.974110032362459
"Matamoras village, Ohio",416,344,72,39,48286,17.307692307692307
"Lakeline village, Ohio",128,118,10,39,41398,7.8125
"Mentor city, Ohio",20619,19534,1085,39,49056,5.262136864057423
"Waite Hill village, Ohio",188,174,14,39,80402,7.446808510638298
"Wickliffe city, Ohio",6100,5644,456,39,85036,7.475409836065573
"Willoughby Hills city, Ohio",5194,4581,613,39,85512,11.802079322294956
"Graysville village, Ohio",39,30,9,39,31542,23.076923076923077
"Miltonsburg village, Ohio",27,24,3,39,50722,11.11111111111111
"Miller City village, Ohio",79,74,5,39,50358,6.329113924050633
"Ottawa village, Ohio",2118,2016,102,39,58982,4.815864022662889
"Franklin city, Ohio",5103,4859,244,39,28476,4.781501077797374
"Harveysburg village, Ohio",267,232,35,39,34384,13.108614232209737
"Loveland Park CDP, Ohio",714,638,76,39,45122,10.644257703081232
"Maineville village, Ohio",449,405,44,39,46872,9.799554565701559
"South Lebanon village, Ohio",2015,1818,197,39,73446,9.77667493796526
"Fultonham village, Ohio",42,42,0,39,29064,0.0
"Sardinia village, Ohio",569,475,94,39,70534,16.520210896309315
"North Zanesville CDP, Ohio",1173,1050,123,39,57218,10.485933503836318
"Zanesville city, Ohio",12362,10876,1486,39,88084,12.02070862320013
"Cortland city, Ohio",3075,3030,45,39,18812,1.4634146341463417
"Hilltop CDP, Ohio",344,344,0,39,35613,0.0
"Hubbard city, Ohio",3506,3218,288,39,36582,8.214489446662864
"Girard city, Ohio",4887,4337,550,39,30198,11.254348270922856
"Howland Center CDP, Ohio",2805,2603,202,39,36557,7.201426024955437
"West Farmington village, Ohio",162,140,22,39,83384,13.580246913580247
"West Hill CDP, Ohio",1064,966,98,39,83541,9.210526315789473
"Youngstown city, Ohio",33800,27457,6343,39,88000,18.766272189349113
"St. Paris village, Ohio",948,835,113,39,69708,11.919831223628693
"Woodstock village, Ohio",96,88,8,39,86478,8.333333333333332
"Archbold village, Ohio",1860,1742,118,39,02344,6.344086021505377
"Fayette village, Ohio",623,583,40,39,26768,6.420545746388442
"Adena village, Ohio",368,280,88,39,00464,23.91304347826087
"Monroeville village, Ohio",557,501,56,39,51618,10.053859964093357
"Willard city, Ohio",2651,2357,294,39,85232,11.090154658619388
"Granville village, Ohio",1519,1387,132,39,31402,8.6899275839368
"Hartford village, Ohio",124,116,8,39,34202,6.451612903225806
"Ashtabula city, Ohio",9090,7561,1529,39,02638,16.82068206820682
"Jacksonville village, Ohio",213,186,27,39,38304,12.676056338028168
"The Plains CDP, Ohio",1450,1251,199,39,76568,13.724137931034482
"Sherwood village, Ohio",366,341,25,39,72256,6.830601092896176
"Fairview village, Ohio",52,29,23,39,26348,44.230769230769226
"Holloway village, Ohio",159,121,38,39,35924,23.89937106918239
"Martins Ferry city, Ohio",3446,2793,653,39,48104,18.949506674405107
"Shadyside village, Ohio",1719,1485,234,39,71640,13.612565445026178
"Berlin Heights village, Ohio",318,287,31,39,05900,9.748427672955975
"Castalia village, Ohio",363,321,42,39,12476,11.570247933884298
"Kelleys Island village, Ohio",927,103,824,39,39662,88.88888888888889
"Shiloh village, Ohio",274,224,50,39,72298,18.248175182481752
"Plainfield village, Ohio",75,58,17,39,63044,22.666666666666664
"Lakemore village, Ohio",1720,1487,233,39,41454,13.546511627906977
"Peninsula village, Ohio",263,247,16,39,61574,6.083650190114068
"Brady Lake village, Ohio",243,227,16,39,08168,6.584362139917696
"Delta village, Ohio",1371,1310,61,39,21616,4.449307075127644
"McArthur village, Ohio",717,625,92,39,45696,12.831241283124129
"Aurora city, Ohio",6482,6154,328,39,03086,5.060166615242209
"Magnetic Springs village, Ohio",131,124,7,39,46830,5.343511450381679
"Niles city, Ohio",9140,8294,846,39,55916,9.25601750547046
"Monroe city, Ohio",5236,5071,165,39,51310,3.1512605042016806
"Vienna Center CDP, Ohio",325,274,51,39,80066,15.692307692307692
"Georgetown village, Ohio",2028,1780,248,39,29778,12.22879684418146
"Elmore village, Ohio",653,602,51,39,25144,7.810107197549771
"Montrose-Ghent CDP, Ohio",2044,1904,140,39,51816,6.8493150684931505
"Arlington Heights village, Ohio",416,361,55,39,02428,13.221153846153847
"Old Washington village, Ohio",152,135,17,39,58226,11.18421052631579
"Boston Heights village, Ohio",433,417,16,39,07790,3.695150115473441
"Fairlawn city, Ohio",3525,3258,267,39,26166,7.574468085106383
"Munroe Falls city, Ohio",2104,2015,89,39,53312,4.230038022813688
"Pigeon Creek CDP, Ohio",302,302,0,39,62578,0.0
"Silver Lake village, Ohio",1042,978,64,39,72494,6.142034548944338
"Stow city, Ohio",15309,14467,842,39,74944,5.500032660526488
"Aquilla village, Ohio",135,131,4,39,02274,2.9629629629629632
"Plymouth village, Ohio",705,626,79,39,63800,11.205673758865247
"Macksburg village, Ohio",103,92,11,39,46158,10.679611650485436
"Marietta city, Ohio",6495,5750,745,39,47628,11.470361816782141
"Kirtland city, Ohio",2721,2617,104,39,40642,3.8221242190371187
"Madison village, Ohio",1318,1198,120,39,46480,9.104704097116842
"Perry village, Ohio",620,582,38,39,61882,6.129032258064516
"Philo village, Ohio",355,323,32,39,62442,9.014084507042254
"Pleasant Grove CDP, Ohio",763,763,0,39,63478,0.0
"Cridersville village, Ohio",862,814,48,39,19400,5.56844547563805
"Valley View village, Ohio",800,762,38,39,79268,4.75
"Warrensville Heights city, Ohio",6775,5979,796,39,80990,11.749077490774908
"Westlake city, Ohio",14455,13694,761,39,83622,5.264614320304393
"Minster village, Ohio",1099,1065,34,39,50918,3.0937215650591448
"New Bremen village, Ohio",1372,1333,39,39,54194,2.8425655976676385
"New Knoxville village, Ohio",416,393,23,39,54838,5.528846153846153
"Drexel CDP, Ohio",1002,730,272,39,22624,27.14570858283433
"Lockington village, Ohio",80,71,9,39,44352,11.25
"Union city, Ohio",2669,2417,252,39,78470,9.441738478831024
"Fayetteville village, Ohio",158,136,22,39,26796,13.924050632911392
"Russellville village, Ohio",310,286,24,39,69316,7.741935483870968
"Hamilton city, Ohio",28139,24817,3322,39,33012,11.805678950922207
"Hemlock village, Ohio",58,44,14,39,34888,24.137931034482758
"Savannah village, Ohio",130,125,5,39,70576,3.8461538461538463
"Beachwood city, Ohio",5094,4532,562,39,04500,11.032587357675697
"Bentleyville village, Ohio",337,331,6,39,05550,1.7804154302670623
"Brooklyn Heights village, Ohio",647,626,21,39,09274,3.2457496136012365
"Highland Heights city, Ohio",3311,3222,89,39,35252,2.6880096647538507
"Highland Hills village, Ohio",330,288,42,39,35255,12.727272727272727
"Maple Heights city, Ohio",10708,9440,1268,39,47306,11.841613746731417
"West Unity village, Ohio",736,709,27,39,84308,3.6684782608695654
"La Rue village, Ohio",373,293,80,39,41902,21.447721179624665
"Wapakoneta city, Ohio",4290,4107,183,39,80766,4.265734265734266
"Delaware city, Ohio",15073,14203,870,39,21434,5.771910037815962
"Galena village, Ohio",186,186,0,39,29148,0.0
"Peebles village, Ohio",880,741,139,39,61420,15.795454545454547
"Winchester village, Ohio",437,380,57,39,85876,13.043478260869565
"Hayesville village, Ohio",209,190,19,39,34636,9.090909090909092
"Yellow Springs village, Ohio",1919,1843,76,39,86940,3.9603960396039604
"Ithaca village, Ohio",39,32,7,39,37604,17.94871794871795
"Amesville village, Ohio",62,54,8,39,01784,12.903225806451612
"Andover village, Ohio",491,450,41,39,02050,8.350305498981669
"North Kingsville village, Ohio",1327,1066,261,39,56700,19.66842501883949
"Bremen village, Ohio",663,583,80,39,08392,12.066365007541478
"Lancaster city, Ohio",18155,16255,1900,39,41720,10.465436518865326
"Stoutsville village, Ohio",222,222,0,39,74916,0.0
"Russells Point village, Ohio",1098,574,524,39,69302,47.72313296903461
"West Mansfield village, Ohio",296,255,41,39,83818,13.85135135135135
"Baltic village, Ohio",265,258,7,39,03744,2.6415094339622645
"Conneaut city, Ohio",5722,4616,1106,39,18350,19.328905976931143
"Jefferson village, Ohio",1511,1311,200,39,38500,13.236267372600926
"Orwell village, Ohio",679,636,43,39,58856,6.332842415316642
"Arcanum village, Ohio",942,843,99,39,02330,10.509554140127388
"Gettysburg village, Ohio",222,212,10,39,29974,4.504504504504505
"Bentonville CDP, Ohio",176,88,88,39,05676,50.0
"Berlin CDP, Ohio",265,265,0,39,05816,0.0
"Beulah Beach CDP, Ohio",97,13,84,39,06208,86.5979381443299
"Bladensburg CDP, Ohio",93,58,35,39,06740,37.634408602150536
"Blue Jay CDP, Ohio",448,421,27,39,07377,6.026785714285714
"Bourneville CDP, Ohio",146,146,0,39,07888,0.0
"Brecon CDP, Ohio",194,194,0,39,08378,0.0
"Bridgetown CDP, Ohio",6001,5656,345,39,08602,5.749041826362273
"Canfield city, Ohio",3343,3042,301,39,11360,9.003888722704158
"Lowellville village, Ohio",523,503,20,39,45178,3.824091778202677
"New Middletown village, Ohio",732,668,64,39,55118,8.743169398907105
"Sebring village, Ohio",2167,1777,390,39,71220,17.99723119520074
"Camden village, Ohio",859,748,111,39,11024,12.922002328288706
"Eaton city, Ohio",3693,3414,279,39,24234,7.554833468724614
"Verona village, Ohio",180,168,12,39,79898,6.666666666666667
"Minerva village, Ohio",1724,1522,202,39,50834,11.7169373549884
"Salem city, Ohio",5739,4888,851,39,69834,14.828367311378287
"Washingtonville village, Ohio",426,391,35,39,81732,8.215962441314554
"Plain City village, Ohio",1834,1757,77,39,63030,4.198473282442748
"Loveland city, Ohio",5140,4974,166,39,45108,3.229571984435798
"Mulberry CDP, Ohio",1839,1728,111,39,53270,6.035889070146819
"Bailey Lakes village, Ohio",181,172,9,39,03562,4.972375690607735
"Loudonville village, Ohio",1226,1102,124,39,45066,10.114192495921696
"Brooklyn city, Ohio",5078,4788,290,39,09246,5.710909807010634
"Moreland Hills village, Ohio",1512,1368,144,39,52052,9.523809523809524
"Orange village, Ohio",1412,1294,118,39,58604,8.356940509915015
"Rocky River city, Ohio",9844,9155,689,39,68056,6.999187322226737
"South Euclid city, Ohio",9860,9002,858,39,73264,8.70182555780933
"University Heights city, Ohio",4910,4432,478,39,78932,9.735234215885948
"Woodmere village, Ohio",430,369,61,39,86394,14.186046511627906
"Coal Grove village, Ohio",900,781,119,39,16378,13.222222222222221
"South Point village, Ohio",1628,1561,67,39,73670,4.115479115479116
"Huber Heights city, Ohio",16064,15230,834,39,36610,5.191733067729084
"Botkins village, Ohio",538,503,35,39,07832,6.5055762081784385
"Hartville village, Ohio",1385,1293,92,39,34328,6.64259927797834
"Waynesfield village, Ohio",332,306,26,39,82390,7.83132530120482
"Bloomingburg village, Ohio",413,368,45,39,07188,10.895883777239709
"Jeffersonville village, Ohio",611,509,102,39,38920,16.693944353518823
"Marblehead village, Ohio",1018,388,630,39,47502,61.8860510805501
"Coalton village, Ohio",273,212,61,39,16434,22.344322344322347
"Nashville village, Ohio",68,61,7,39,53634,10.294117647058822
"Cloverdale village, Ohio",66,60,6,39,16266,9.090909090909092
"Columbus Grove village, Ohio",964,904,60,39,18014,6.224066390041494
"Landen CDP, Ohio",2794,2717,77,39,41755,2.7559055118110236
"Dupont village, Ohio",110,105,5,39,22974,4.545454545454546
"Leipsic village, Ohio",912,840,72,39,42602,7.894736842105263
"Five Points CDP, Ohio",622,622,0,39,27303,0.0
"Lodi village, Ohio",1389,1273,116,39,44604,8.351331893448524
"Bowersville village, Ohio",153,128,25,39,07930,16.33986928104575
"Shawnee Hills CDP, Ohio",917,867,50,39,71983,5.452562704471101
"Wilberforce CDP, Ohio",237,186,51,39,85092,21.518987341772153
"Empire village, Ohio",145,106,39,39,25368,26.89655172413793
"Toronto city, Ohio",2482,2337,145,39,77112,5.842062852538275
"Wintersville village, Ohio",2002,1765,237,39,86184,11.838161838161838
"Bellefontaine city, Ohio",6072,5474,598,39,05130,9.848484848484848
"Rushsylvania village, Ohio",250,229,21,39,69176,8.4
"Conesville village, Ohio",182,176,6,39,18266,3.296703296703297
"Nellie village, Ohio",48,46,2,39,53816,4.166666666666666
"Wakeman village, Ohio",575,546,29,39,80458,5.043478260869565
"Port William village, Ohio",107,88,19,39,64360,17.75700934579439
"Marysville city, Ohio",8452,8032,420,39,48160,4.969238050165641
"New Vienna village, Ohio",547,509,38,39,55748,6.946983546617916
"Malvern village, Ohio",649,565,84,39,46998,12.942989214175654
"Holgate village, Ohio",539,451,88,39,35854,16.3265306122449
"Malinta village, Ohio",123,116,7,39,46942,5.691056910569105
"Jamestown village, Ohio",897,831,66,39,38374,7.357859531772576
"Mount Healthy city, Ohio",2969,2612,357,39,52752,12.02425058942405
"North College Hill city, Ohio",4136,3795,341,39,56322,8.24468085106383
"Northgate CDP, Ohio",2924,2793,131,39,56553,4.480164158686731
"Northfield village, Ohio",1569,1523,46,39,56448,2.9318036966220524
"Cardington village, Ohio",821,711,110,39,12084,13.398294762484774
"Cuyahoga Falls city, Ohio",23505,21792,1713,39,19778,7.287811104020421
"Tallmadge city, Ohio",7380,7062,318,39,76106,4.308943089430894
"Pioneer village, Ohio",779,694,85,39,62834,10.911424903722722
"Convoy village, Ohio",511,432,79,39,18546,15.459882583170254
"Lithopolis village, Ohio",609,607,2,39,44086,0.3284072249589491
"Rushville village, Ohio",133,129,4,39,69204,3.007518796992481
"Versailles village, Ohio",1175,1041,134,39,79912,11.404255319148936
"Geneva city, Ohio",2670,2386,284,39,29610,10.636704119850188
"Castine village, Ohio",87,78,9,39,12504,10.344827586206897
"New Weston village, Ohio",52,42,10,39,55818,19.230769230769234
"Morristown village, Ohio",161,106,55,39,52346,34.161490683229815
"St. Clairsville city, Ohio",2608,2183,425,39,69526,16.29601226993865
"Wilson village, Ohio",70,49,21,39,85834,30.0
"Athens city, Ohio",7778,6733,1045,39,02736,13.435330419130882
"Buchtel village, Ohio",300,223,77,39,09834,25.666666666666664
"Van Buren village, Ohio",139,137,2,39,79394,1.4388489208633095
"Holland village, Ohio",716,694,22,39,35882,3.072625698324022
"Maumee city, Ohio",6292,5925,367,39,48342,5.832803560076287
"Batesville village, Ohio",36,36,0,39,04192,0.0
"Dover city, Ohio",5650,5236,414,39,22456,7.327433628318585
"Newcomerstown village, Ohio",1850,1633,217,39,54432,11.72972972972973
"Stone Creek village, Ohio",72,69,3,39,74804,4.166666666666666
"Zoar village, Ohio",89,85,4,39,88168,4.49438202247191
"Gordon village, Ohio",84,77,7,39,30912,8.333333333333332
"Walbridge village, Ohio",1615,1582,33,39,80486,2.043343653250774
"Wayne village, Ohio",437,408,29,39,82334,6.636155606407322
"Rock Creek village, Ohio",181,157,24,39,67846,13.259668508287293
"Greenville city, Ohio",6601,5988,613,39,32340,9.286471746705045
"Bethesda village, Ohio",683,493,190,39,06138,27.81844802342606
"Milan village, Ohio",533,493,40,39,50134,7.5046904315197
"Eldorado village, Ohio",239,212,27,39,24766,11.297071129707113
"Hicksville village, Ohio",1476,1375,101,39,35098,6.842818428184281
"Campbell city, Ohio",3946,3359,587,39,11066,14.875823618854536
"Poland village, Ohio",1231,1126,105,39,63954,8.529650690495533
"West Elkton village, Ohio",81,72,9,39,83216,11.11111111111111
"Grandview Heights city, Ohio",3637,3409,228,39,31304,6.268902941985152
"Huber Ridge CDP, Ohio",1646,1534,112,39,36624,6.804374240583232
"Lincoln Village CDP, Ohio",4217,3895,322,39,43792,7.635760018970833
"North Canton city, Ohio",7485,7074,411,39,56294,5.490981963927856
"Kirkersville village, Ohio",180,165,15,39,40572,8.333333333333332
"Lowell village, Ohio",296,256,40,39,45164,13.513513513513514
"Painesville city, Ohio",8068,7326,742,39,59416,9.196826970748637
"Willoughby city, Ohio",11556,10858,698,39,85484,6.040152301834545
"Jerusalem village, Ohio",75,62,13,39,39130,17.333333333333336
"Stafford village, Ohio",47,39,8,39,74300,17.02127659574468
"Cairo village, Ohio",205,184,21,39,10884,10.24390243902439
"Whitehouse village, Ohio",1782,1708,74,39,84770,4.1526374859708195
"Barnhill village, Ohio",147,127,20,39,03940,13.60544217687075
"Strasburg village, Ohio",1311,1241,70,39,74958,5.339435545385203
"Lafayette village, Ohio",176,158,18,39,41118,10.227272727272728
"Sugarcreek village, Ohio",964,907,57,39,75210,5.9128630705394185
"Uhrichsville city, Ohio",2434,2175,259,39,78176,10.640920295809368
"Rio Grande village, Ohio",202,168,34,39,67258,16.831683168316832
"Bexley city, Ohio",5033,4646,387,39,06278,7.6892509437711105
"Urbancrest village, Ohio",437,386,51,39,79100,11.670480549199084
"Racine village, Ohio",303,278,25,39,65256,8.25082508250825
"Doylestown village, Ohio",1336,1248,88,39,22568,6.58682634730539
"Marshallville village, Ohio",319,314,5,39,48048,1.5673981191222568
"Mount Eaton village, Ohio",75,69,6,39,52682,8.0
"Smithville village, Ohio",589,527,62,39,72788,10.526315789473683
"Broughton village, Ohio",63,53,10,39,09386,15.873015873015872
"Ridgeway village, Ohio",140,131,9,39,67118,6.428571428571428
"Spring Valley village, Ohio",267,242,25,39,74216,9.363295880149813
"Steubenville city, Ohio",9022,7111,1911,39,74608,21.181556195965417
"Belle Center village, Ohio",347,302,45,39,05116,12.968299711815561
"Valley Hi village, Ohio",118,80,38,39,79226,32.20338983050847
"Cecil village, Ohio",84,63,21,39,12700,25.0
"Latty village, Ohio",71,66,5,39,41986,7.042253521126761
"New London village, Ohio",1009,867,142,39,54908,14.073339940535185
"Terrace Park village, Ohio",803,788,15,39,76428,1.86799501867995
"Wyoming city, Ohio",3240,3186,54,39,86730,1.6666666666666667
"Upper Arlington city, Ohio",14465,13888,577,39,79002,3.988938817836156
"Chillicothe city, Ohio",10279,9099,1180,39,14184,11.479715925673704
"Coolville village, Ohio",216,192,24,39,18588,11.11111111111111
"Trimble village, Ohio",242,183,59,39,77406,24.380165289256198
"Delphos city, Ohio",3149,2835,314,39,21602,9.971419498253415
"Lima city, Ohio",16949,14396,2553,39,43554,15.06283556552009
"Tiro village, Ohio",95,60,35,39,76932,36.84210526315789
"Dexter City village, Ohio",43,35,8,39,21910,18.6046511627907
"Glenford village, Ohio",65,64,1,39,30436,1.5384615384615385
"Rendville village, Ohio",25,10,15,39,66222,60.0
"Piqua city, Ohio",9178,8484,694,39,62848,7.561560252778383
"West Portsmouth CDP, Ohio",1349,1141,208,39,84140,15.41882876204596
"Kirby village, Ohio",52,47,5,39,40558,9.615384615384617
"Geneva-on-the-Lake village, Ohio",1311,627,684,39,29652,52.17391304347826
"Bay Village city, Ohio",6403,6078,325,39,04416,5.075745744182415
"Hunting Valley village, Ohio",316,283,33,39,36918,10.443037974683545
"Arcadia village, Ohio",238,227,11,39,02316,4.621848739495799
"Oakwood village (Cuyahoga County), Ohio",1856,1595,261,39,57750,14.0625
"Leetonia village, Ohio",891,791,100,39,42560,11.22334455667789
"Shawnee Hills village, Ohio",284,272,12,39,71976,4.225352112676056
"Powhatan Point village, Ohio",855,738,117,39,64542,13.684210526315791
"Sparta village, Ohio",65,56,9,39,73950,13.846153846153847
"Grand Rapids village, Ohio",461,409,52,39,31206,11.279826464208242
"Neffs CDP, Ohio",394,281,113,39,53788,28.680203045685282
"Brimfield CDP, Ohio",1249,1249,0,39,08826,0.0
"Scott village, Ohio",130,108,22,39,71080,16.923076923076923
"McConnelsville village, Ohio",1004,900,104,39,45822,10.358565737051793
"Green Camp village, Ohio",147,140,7,39,31948,4.761904761904762
"Holmesville village, Ohio",128,119,9,39,35994,7.03125
"Antwerp village, Ohio",740,679,61,39,02204,8.243243243243244
"The Village of Indian Hill city, Ohio",2332,2150,182,39,76582,7.804459691252144
"Brewster village, Ohio",879,800,79,39,08504,8.987485779294653
"Union City village, Ohio",785,652,133,39,78624,16.94267515923567
"Forest Park city, Ohio",7473,6996,477,39,27706,6.382978723404255
"Grandview CDP, Ohio",615,434,181,39,31262,29.43089430894309
"Pleasant Run CDP, Ohio",1747,1533,214,39,63604,12.249570692615913
"Springdale city, Ohio",4620,4429,191,39,74104,4.134199134199134
"White Oak CDP, Ohio",8511,8012,499,39,84812,5.863000822465046
"Perrysville village, Ohio",386,283,103,39,62190,26.683937823834196
"New Bloomington village, Ohio",237,183,54,39,54152,22.78481012658228
"Ashland city, Ohio",8923,8057,866,39,02568,9.705256079793791
"Bedford city, Ohio",6929,5910,1019,39,04878,14.706306826381873
"Brecksville city, Ohio",5755,5462,293,39,08364,5.091225021720244
"East Cleveland city, Ohio",13354,8143,5211,39,23380,39.02201587539314
"Mayfield Heights city, Ohio",10285,9259,1026,39,48482,9.975692756441418
"Olmsted Falls city, Ohio",4223,3939,284,39,58422,6.725076959507459
"Parma Heights city, Ohio",9846,9192,654,39,61028,6.642291285801341
"Buckland village, Ohio",114,104,10,39,09974,8.771929824561402
"Dublin city, Ohio",16917,16114,803,39,22694,4.7467044984335285
"Middle Point village, Ohio",238,216,22,39,49728,9.243697478991598
"Thornville village, Ohio",480,426,54,39,76680,11.25
"Austintown CDP, Ohio",14453,12906,1547,39,03184,10.703660139763372
"Rochester village, Ohio",68,64,4,39,67762,5.88235294117647
"Lorain city, Ohio",29282,25460,3822,39,44856,13.052387132026503
"North Ridgeville city, Ohio",13073,12572,501,39,56966,3.832326168438767
"Oberlin city, Ohio",2834,2586,248,39,57834,8.75088214537756
"Dresden village, Ohio",746,703,43,39,22610,5.7640750670241285
"Maplewood Park CDP, Ohio",122,122,0,39,47445,0.0
"Bowerston village, Ohio",177,158,19,39,07916,10.734463276836157
"Deersville village, Ohio",48,19,29,39,21294,60.416666666666664
"Freeport village, Ohio",230,174,56,39,28798,24.347826086956523
"Pleasantville village, Ohio",464,380,84,39,63716,18.103448275862068
"Covington village, Ohio",1168,1002,166,39,19050,14.212328767123289
"Ansonia village, Ohio",511,496,15,39,02120,2.935420743639922
"Forest village, Ohio",666,586,80,39,27636,12.012012012012011
"Casstown village, Ohio",116,91,25,39,12462,21.551724137931032
"New Boston village, Ohio",1234,1157,77,39,54166,6.239870340356564
"Harpster village, Ohio",98,88,10,39,33656,10.204081632653061
"Mendon village, Ohio",289,262,27,39,49042,9.342560553633218
"Fremont city, Ohio",7606,6756,850,39,28826,11.17538785169603
"Stony Prairie CDP, Ohio",600,556,44,39,74832,7.333333333333333
"Woodville village, Ohio",890,850,40,39,86492,4.49438202247191
"Northwood city, Ohio",2238,2158,80,39,57190,3.5746201966041107
"Butlerville village, Ohio",72,63,9,39,10674,12.5
"Risingsun village, Ohio",249,225,24,39,67314,9.63855421686747
"Catawba village, Ohio",99,94,5,39,12560,5.05050505050505
"Circleville city, Ohio",6221,5576,645,39,15070,10.368108021218454
"Killbuck village, Ohio",424,375,49,39,40180,11.556603773584905
"Millersburg village, Ohio",1431,1337,94,39,50372,6.568832983927324
"Fort Jennings village, Ohio",200,198,2,39,27818,1.0
"Glandorf village, Ohio",406,378,28,39,30282,6.896551724137931
"Pleasant Plain village, Ohio",75,64,11,39,63576,14.666666666666666
"Miamisburg city, Ohio",8902,8184,718,39,49434,8.06560323522804
"Anna village, Ohio",578,505,73,39,02092,12.629757785467127
"Jackson Center village, Ohio",711,645,66,39,38220,9.282700421940929
"Highland village, Ohio",152,142,10,39,35210,6.578947368421052
"Lynchburg village, Ohio",586,536,50,39,45542,8.532423208191126
"Struthers city, Ohio",4702,4167,535,39,75126,11.37813696299447
"Bryan city, Ohio",4124,3851,273,39,09792,6.619786614936954
"Edon village, Ohio",349,312,37,39,24640,10.601719197707736
"Holiday City village, Ohio",15,11,4,39,35864,26.666666666666668
"Coldwater village, Ohio",1742,1742,0,39,16532,0.0
"St. Henry village, Ohio",859,848,11,39,69540,1.2805587892898718
"Bradford village, Ohio",789,701,88,39,08084,11.153358681875792
"Kenton city, Ohio",3826,3398,428,39,39886,11.186617877679037
"Englewood city, Ohio",6325,5745,580,39,25396,9.1699604743083
"Rocky Ridge village, Ohio",252,189,63,39,68042,25.0
"South Russell village, Ohio",1522,1496,26,39,73684,1.7082785808147174
"Meyers Lake village, Ohio",342,306,36,39,49294,10.526315789473683
"Millersport village, Ohio",515,415,100,39,50400,19.41747572815534
"Haviland village, Ohio",97,90,7,39,34552,7.216494845360824
"Lordstown village, Ohio",1435,1391,44,39,44912,3.0662020905923346
"West Rushville village, Ohio",76,74,2,39,84182,2.631578947368421
"Dry Run CDP, Ohio",2524,2495,29,39,22674,1.1489698890649762
"Irondale village, Ohio",176,127,49,39,37422,27.84090909090909
"North Hampton village, Ohio",188,171,17,39,56588,9.042553191489363
"Ross CDP, Ohio",1325,1164,161,39,68602,12.150943396226415
"Quaker City village, Ohio",216,200,16,39,65116,7.4074074074074066
"North Madison CDP, Ohio",3766,3252,514,39,56812,13.648433351035582
"New Athens village, Ohio",135,123,12,39,54068,8.88888888888889
"Madeira city, Ohio",3478,3287,191,39,46312,5.491661874640598
"Greenhills village, Ohio",1634,1486,148,39,32158,9.057527539779683
"Masury CDP, Ohio",848,816,32,39,48272,3.7735849056603774
"Laurelville village, Ohio",340,316,24,39,42084,7.0588235294117645
"McDonald village, Ohio",1440,1405,35,39,45934,2.430555555555556
"New Miami village, Ohio",954,862,92,39,55104,9.643605870020965
"West Salem village, Ohio",627,547,80,39,84196,12.759170653907494
"Bainbridge village, Ohio",341,308,33,39,03604,9.67741935483871
"Sugar Bush Knolls village, Ohio",82,80,2,39,75196,2.4390243902439024
"Bellaire village, Ohio",2391,1790,601,39,05074,25.135926390631536
"Brookville city, Ohio",2922,2836,86,39,09358,2.943189596167009
"Canal Fulton city, Ohio",2428,2367,61,39,11304,2.5123558484349258
"Carlisle city, Ohio",2331,2060,271,39,12168,11.625911625911627
"Chardon city, Ohio",2499,2321,178,39,13554,7.122849139655862
"Columbiana city, Ohio",3037,2901,136,39,17036,4.478103391504774
"Crestline city, Ohio",2161,1885,276,39,19330,12.771864877371586
"Gallipolis village, Ohio",1834,1582,252,39,29204,13.740458015267176
"LaGrange village, Ohio",867,820,47,39,41230,5.4209919261822375
"Newton Falls city, Ohio",2525,2258,267,39,55650,10.574257425742575
"Ontario city, Ohio",2893,2676,217,39,58520,7.50086415485655
"Powell city, Ohio",4389,4271,118,39,64486,2.688539530644794
"Washington Court House city, Ohio",6498,5973,525,39,81718,8.079409048938135
"Chippewa Lake village, Ohio",445,302,143,39,14254,32.13483146067416
"New Lexington village, Ohio",2078,1987,91,39,54866,4.379210779595765
"Sherwood CDP, Ohio",1365,1267,98,39,72258,7.179487179487179
"Brilliant CDP, Ohio",707,616,91,39,08812,12.871287128712872
"New Franklin city, Ohio",6053,5567,486,39,54562,8.0290764909962
"Austinburg CDP, Ohio",229,229,0,39,03142,0.0
"Bannock CDP, Ohio",97,69,28,39,03786,28.865979381443296
"Bascom CDP, Ohio",175,175,0,39,04094,0.0
"Massillon city, Ohio",14960,13193,1767,39,48244,11.81149732620321
"Farmersville village, Ohio",432,405,27,39,26656,6.25
"Carroll village, Ohio",210,187,23,39,12252,10.952380952380953
"Gloria Glens Park village, Ohio",261,189,72,39,30660,27.586206896551722
"Byesville village, Ohio",1115,1017,98,39,10716,8.789237668161435
"Sugar Grove village, Ohio",165,133,32,39,75252,19.393939393939394
"Hillsboro city, Ohio",3199,2780,419,39,35560,13.097843075961238
"Leesburg village, Ohio",770,629,141,39,42476,18.31168831168831
"Senecaville village, Ohio",195,156,39,39,71360,20.0
"Fairfax village, Ohio",778,721,57,39,25942,7.326478149100257
"Montgomery city, Ohio",4125,4006,119,39,51716,2.8848484848484848
"Pleasant Run Farm CDP, Ohio",1981,1818,163,39,63618,8.228167592125189
"Reading city, Ohio",4803,4484,319,39,65732,6.641682281907141
"Amherst city, Ohio",5115,4835,280,39,01798,5.474095796676441
"Elyria city, Ohio",24906,22682,2224,39,25256,8.929575202762386
"Wellington village, Ohio",2180,2162,18,39,82642,0.8256880733944955
"Helena village, Ohio",124,113,11,39,34860,8.870967741935484
"Bairdstown village, Ohio",59,48,11,39,03646,18.64406779661017
"Dent CDP, Ohio",4790,4508,282,39,21742,5.887265135699374
"Dillonvale CDP, Ohio",1543,1490,53,39,22008,3.434867141931303
"Craig Beach village, Ohio",644,532,112,39,19106,17.391304347826086
"Willshire village, Ohio",184,160,24,39,85736,13.043478260869565
"Wren village, Ohio",89,62,27,39,86632,30.337078651685395
"Glenmoor CDP, Ohio",746,746,0,39,30520,0.0
"New Richmond village, Ohio",1092,962,130,39,55384,11.904761904761903
"Yankee Lake village, Ohio",47,43,4,39,86856,8.51063829787234
"Batavia village, Ohio",790,664,126,39,04150,15.949367088607595
"Milford city, Ohio",3365,3177,188,39,50176,5.5869242199108475
"Clifton village, Ohio",95,72,23,39,16056,24.210526315789473
"Crystal Lakes CDP, Ohio",629,561,68,39,19596,10.81081081081081
"South Vienna village, Ohio",229,209,20,39,73796,8.73362445414847
"Springfield city, Ohio",28379,24357,4022,39,74118,14.172451460587055
"Darbyville village, Ohio",79,72,7,39,20212,8.860759493670885
"Williamsport village, Ohio",391,319,72,39,85414,18.414322250639387
"Edison village, Ohio",194,176,18,39,24598,9.278350515463918
"Fulton village, Ohio",103,92,11,39,29050,10.679611650485436
"Clinton village, Ohio",602,493,109,39,16182,18.106312292358805
"Green city, Ohio",10579,9694,885,39,31860,8.365630021741186
"Chesterland CDP, Ohio",983,905,78,39,14100,7.934893184130214
"Martinsburg village, Ohio",127,105,22,39,48090,17.322834645669293
"Alger village, Ohio",462,375,87,39,01210,18.83116883116883
"Fredericktown village, Ohio",1129,1052,77,39,28658,6.8201948627103635
"Gambier village, Ohio",454,385,69,39,29246,15.198237885462554
"Patterson village, Ohio",63,63,0,39,61182,0.0
"Danville village, Ohio",522,469,53,39,20114,10.153256704980842
"Laura village, Ohio",175,164,11,39,42028,6.2857142857142865
"Potsdam village, Ohio",128,118,10,39,64430,7.8125
"Gratiot village, Ohio",116,101,15,39,31458,12.931034482758621
"Brookfield Center CDP, Ohio",589,589,0,39,09200,0.0
"Lisbon village, Ohio",1239,1040,199,39,44030,16.06133979015335
"Thurston village, Ohio",220,199,21,39,76764,9.545454545454547
"Cambridge city, Ohio",5065,4293,772,39,10996,15.241855873642645
"Cumberland village, Ohio",158,128,30,39,19694,18.9873417721519
"Summitville village, Ohio",36,36,0,39,75574,0.0
"Centerville village, Ohio",34,26,8,39,13169,23.52941176470588
"Clarksburg village, Ohio",201,186,15,39,15336,7.462686567164178
"Marion city, Ohio",15147,12933,2214,39,47754,14.616755793226382
"Ironton city, Ohio",5051,4444,607,39,37464,12.017422292615324
"Proctorville village, Ohio",311,247,64,39,64766,20.578778135048232
"Manchester village, Ohio",970,792,178,39,47012,18.350515463917525
"Seaman village, Ohio",467,390,77,39,71206,16.488222698072803
"Linndale village, Ohio",59,51,8,39,43918,13.559322033898304
"North Olmsted city, Ohio",13765,13018,747,39,56882,5.426807119505994
"Solon city, Ohio",8813,8415,398,39,72928,4.516055826619766
"Hamersville village, Ohio",323,300,23,39,32984,7.120743034055728
"Fruit Hill CDP, Ohio",1387,1344,43,39,28966,3.1002162941600577
"Groesbeck CDP, Ohio",2929,2755,174,39,32536,5.9405940594059405
"Harrison city, Ohio",4891,4591,300,39,33838,6.1337149867102845
"Lockland village, Ohio",1681,1429,252,39,44366,14.991076740035695
"Turpin Hills CDP, Ohio",1965,1965,0,39,77840,0.0
"Woodlawn village, Ohio",1665,1464,201,39,86366,12.072072072072073
"South Charleston village, Ohio",882,785,97,39,73124,10.997732426303855
"Hudson city, Ohio",8315,8063,252,39,36651,3.030667468430547
"Richfield village, Ohio",1436,1402,34,39,66530,2.3676880222841223
"Twinsburg city, Ohio",8068,7817,251,39,78050,3.1110560237977194
"Wauseon city, Ohio",3134,2880,254,39,81928,8.104658583280152
"London city, Ohio",4521,4209,312,39,44674,6.901128069011281
"Midway village, Ohio",120,106,14,39,50008,11.666666666666666
"Bedford Heights city, Ohio",6091,5509,582,39,04920,9.55508126744377
"Adamsville village, Ohio",79,61,18,39,00380,22.78481012658228
"Bellevue city, Ohio",3531,3233,298,39,05228,8.43953554233928
"Obetz village, Ohio",1839,1762,77,39,57862,4.187058183795541
"Pomeroy village, Ohio",966,716,250,39,64024,25.87991718426501
"Adelphi village, Ohio",146,120,26,39,00450,17.80821917808219
"Nelsonville city, Ohio",2164,1743,421,39,53886,19.454713493530498
"Beaverdam village, Ohio",176,167,9,39,04752,5.113636363636364
"Bucyrus city, Ohio",6148,5307,841,39,10030,13.679245283018867
"New Washington village, Ohio",460,427,33,39,55776,7.173913043478261
"Blacklick Estates CDP, Ohio",3574,3365,209,39,06670,5.8477895914941245
"Brice village, Ohio",35,35,0,39,08532,0.0
"Riverlea village, Ohio",223,221,2,39,67440,0.8968609865470852
"Whitehall city, Ohio",8131,7137,994,39,84742,12.224818595498709
"Middleport village, Ohio",1254,952,302,39,49756,24.082934609250398
"Holiday Valley CDP, Ohio",558,558,0,39,35868,0.0
"Ashville village, Ohio",1483,1391,92,39,02680,6.203641267700607
"Kent city, Ohio",12915,10617,2298,39,39872,17.793263646922185
"Mantua village, Ohio",544,504,40,39,47180,7.352941176470589
"Beckett Ridge CDP, Ohio",3897,3755,142,39,04840,3.6438285860918658
"Fairfield city, Ohio",18159,16789,1370,39,25970,7.544468307726196
"Millville village, Ohio",332,286,46,39,50540,13.855421686746988
"Oxford city, Ohio",7310,6273,1037,39,59234,14.186046511627906
"Alliance city, Ohio",9824,8678,1146,39,01420,11.66530944625407
"Utica village, Ohio",900,703,197,39,79114,21.88888888888889
"Beach City village, Ohio",423,356,67,39,04458,15.839243498817968
"Spencer village, Ohio",256,246,10,39,73992,3.90625
"Lower Salem village, Ohio",52,35,17,39,45220,32.69230769230769
"Willowick city, Ohio",6471,6007,464,39,85638,7.17045278936795
"Scio village, Ohio",438,372,66,39,70814,15.068493150684931
"Tiffin city, Ohio",7668,6692,976,39,76778,12.728221178925402
"Hopedale village, Ohio",425,374,51,39,36260,12.0
"Jewett village, Ohio",351,264,87,39,39172,24.786324786324787
"Cleves village, Ohio",1283,1117,166,39,16028,12.93842556508184
"Cincinnati city, Ohio",162279,137281,24998,39,15000,15.404334510318648
"Lakeview village, Ohio",724,556,168,39,41608,23.204419889502763
"Mowrystown village, Ohio",162,120,42,39,53186,25.925925925925924
"Sinking Spring village, Ohio",69,61,8,39,72578,11.594202898550725
"South Salem village, Ohio",110,106,4,39,73698,3.6363636363636362
"Morral village, Ohio",190,162,28,39,52276,14.736842105263156
"Waldo village, Ohio",191,165,26,39,80500,13.612565445026178
"Kettlersville village, Ohio",71,64,7,39,40054,9.859154929577464
"Moraine city, Ohio",2832,2370,462,39,52010,16.3135593220339
"Oakwood city, Ohio",3573,3468,105,39,57764,2.938706968933669
"Vandalia city, Ohio",7198,6841,357,39,79492,4.9597110308419
"Russia village, Ohio",266,264,2,39,69344,0.7518796992481203
"Sidney city, Ohio",9348,8315,1033,39,72424,11.050492083868207
"Murray City village, Ohio",216,176,40,39,53410,18.51851851851852
"Kalida village, Ohio",592,577,15,39,39536,2.5337837837837838
"West Leipsic village, Ohio",89,81,8,39,83706,8.98876404494382
"Lebanon city, Ohio",8328,7681,647,39,42364,7.768972142170989
"Ashley village, Ohio",561,525,36,39,02582,6.417112299465241
"Ostrander village, Ohio",332,296,36,39,58940,10.843373493975903
"Westerville city, Ohio",15049,14536,513,39,83342,3.408864376370523
"Green Meadows CDP, Ohio",1074,1036,38,39,32207,3.5381750465549344
"Corwin village, Ohio",208,200,8,39,18840,3.8461538461538463
"Mason city, Ohio",12531,12222,309,39,48188,2.4658846061766817
"Waynesville village, Ohio",1208,1129,79,39,82418,6.539735099337748
"Mount Orab village, Ohio",1419,1419,0,39,52906,0.0
"Jacksonburg village, Ohio",18,18,0,39,38192,0.0
"Wetherington CDP, Ohio",540,529,11,39,84528,2.037037037037037
"Oak Harbor village, Ohio",1306,1188,118,39,57582,9.03522205206738
"Put-in-Bay village, Ohio",308,41,267,39,65032,86.68831168831169
"Ada village, Ohio",2024,1647,377,39,00198,18.626482213438734
"Gates Mills village, Ohio",1028,883,145,39,29498,14.105058365758754
"Bratenahl village, Ohio",859,735,124,39,08336,14.435389988358557
"Broadview Heights city, Ohio",7824,7449,375,39,09064,4.792944785276074
"Cleveland city, Ohio",212347,169365,42982,39,16000,20.241397335493318
"Glenwillow village, Ohio",350,328,22,39,30632,6.2857142857142865
"Worthington city, Ohio",5984,5827,157,39,86604,2.623663101604278
"South Canal CDP, Ohio",436,369,67,39,73118,15.36697247706422
"Day Heights CDP, Ohio",1030,994,36,39,20366,3.4951456310679614
"Neville village, Ohio",42,30,12,39,53956,28.57142857142857
"Withamsville CDP, Ohio",3273,3130,143,39,86254,4.36908035441491
"Apple Creek village, Ohio",448,422,26,39,02232,5.803571428571429
"Lyons village, Ohio",247,231,16,39,45626,6.477732793522267
"Metamora village, Ohio",286,273,13,39,49238,4.545454545454546
"Middlefield village, Ohio",1345,1289,56,39,49700,4.163568773234201
"Mechanicsburg village, Ohio",681,609,72,39,48706,10.572687224669604
"Mount Sterling village, Ohio",886,780,106,39,53046,11.963882618510159
"South Solon village, Ohio",150,122,28,39,73768,18.666666666666668
"Ravenna city, Ohio",5607,5073,534,39,65592,9.523809523809524
"St. Louisville village, Ohio",165,154,11,39,69652,6.666666666666667
"Lewisburg village, Ohio",748,710,38,39,42938,5.080213903743315
"Pleasant Hill village, Ohio",470,446,24,39,63534,5.106382978723404
"Higginsport village, Ohio",134,107,27,39,35168,20.149253731343283
"Mineral Ridge CDP, Ohio",1616,1507,109,39,50778,6.7450495049504955
"Lexington village, Ohio",2244,2081,163,39,42994,7.263814616755793
"Creston village, Ohio",806,768,38,39,19344,4.714640198511166
"Greenwich village, Ohio",606,554,52,39,32368,8.58085808580858
"Kirtland Hills village, Ohio",293,272,21,39,40670,7.167235494880546
"Dayton city, Ohio",73923,57704,16219,39,21000,21.94039744058006
"Aberdeen village, Ohio",913,765,148,39,00142,16.210295728368017
"College Corner village, Ohio",152,124,28,39,16700,18.421052631578945
"Wellston city, Ohio",2366,2141,225,39,82712,9.509721048182588
"Granville South CDP, Ohio",498,442,56,39,31434,11.244979919678714
"Hills and Dales village, Ohio",139,117,22,39,35532,15.827338129496402
"Uniontown CDP, Ohio",1295,1239,56,39,78736,4.324324324324325
"Baltimore village, Ohio",1308,1179,129,39,03758,9.862385321100918
"Columbus city, Ohio",389820,352543,37277,39,18000,9.56261864450259
"Fairfield Beach CDP, Ohio",711,513,198,39,26110,27.848101265822784
"Fort Loramie village, Ohio",595,559,36,39,27832,6.050420168067227
"McComb village, Ohio",715,666,49,39,45808,6.853146853146853
"Flushing village, Ohio",447,350,97,39,27552,21.700223713646533
"Albany village, Ohio",444,352,92,39,01042,20.72072072072072
"Elida village, Ohio",803,769,34,39,24808,4.2341220423412205
"Fletcher village, Ohio",162,152,10,39,27412,6.172839506172839
"Franklin Furnace CDP, Ohio",598,519,79,39,28532,13.210702341137123
"Ludlow Falls village, Ohio",109,95,14,39,45374,12.844036697247708
"Troy city, Ohio",11417,10566,851,39,77588,7.453796969431549
"West Milton village, Ohio",2188,2019,169,39,83902,7.7239488117001835
"Sciotodale CDP, Ohio",495,455,40,39,70912,8.080808080808081
"Clyde city, Ohio",2875,2439,436,39,16308,15.165217391304347
"Gibsonburg village, Ohio",988,912,76,39,30072,7.6923076923076925
"Bowling Green city, Ohio",12259,11314,945,39,07972,7.7086222367240405
"Bradner village, Ohio",417,398,19,39,08112,4.556354916067146
"Custar village, Ohio",99,82,17,39,19750,17.17171717171717
"Hoytville village, Ohio",143,112,31,39,36568,21.678321678321677
"Luckey village, Ohio",411,393,18,39,45332,4.37956204379562
"Pemberville village, Ohio",673,624,49,39,61504,7.280832095096583
"Sycamore village, Ohio",458,420,38,39,75980,8.296943231441048
"Tipp City city, Ohio",4395,4197,198,39,76876,4.505119453924915
"Portsmouth city, Ohio",10043,8629,1414,39,64304,14.079458329184508
"Rarden village, Ohio",86,75,11,39,65508,12.790697674418606
"Montezuma village, Ohio",109,78,31,39,51674,28.440366972477065
"Ballville CDP, Ohio",1270,1204,66,39,03716,5.196850393700787
"Centerburg village, Ohio",769,661,108,39,13036,14.044213263979193
"Parral village, Ohio",104,104,0,39,61056,0.0
"Ottawa Hills village, Ohio",1692,1546,146,39,59010,8.628841607565011
"Caldwell village, Ohio",1133,1012,121,39,10940,10.679611650485436
"Gnadenhutten village, Ohio",557,546,11,39,30702,1.9748653500897666
"Timberlake village, Ohio",346,325,21,39,76834,6.069364161849711
"Beallsville village, Ohio",187,165,22,39,04542,11.76470588235294
"Woodsfield village, Ohio",1254,1065,189,39,86436,15.07177033492823
"Bloomville village, Ohio",473,403,70,39,07286,14.799154334038056
"Green Springs village, Ohio",566,501,65,39,32256,11.484098939929329
"North Lewisburg village, Ohio",688,621,67,39,56770,9.738372093023257
"Wilkesville village, Ohio",82,73,9,39,85190,10.975609756097562
"Leavittsburg CDP, Ohio",657,599,58,39,42308,8.82800608828006
"Cadiz village, Ohio",1415,1222,193,39,10800,13.63957597173145
"Harrisville village, Ohio",109,87,22,39,34090,20.18348623853211
"Amanda village, Ohio",326,296,30,39,01630,9.202453987730062
"Reynoldsburg city, Ohio",15258,14291,967,39,66390,6.337658933018744
"Blue Ash city, Ohio",5240,4929,311,39,07300,5.935114503816794
"Cheviot city, Ohio",4300,3851,449,39,14128,10.441860465116278
"Cygnet village, Ohio",251,218,33,39,19820,13.147410358565736
"Deer Park city, Ohio",2666,2517,149,39,21266,5.588897224306077
"Beaver village, Ohio",229,202,27,39,04696,11.790393013100436
"Donnelsville village, Ohio",149,143,6,39,22288,4.026845637583892
"Perrysburg city, Ohio",9158,8679,479,39,62148,5.230399650578729
"West Millgrove village, Ohio",57,46,11,39,83888,19.298245614035086
"North Robinson village, Ohio",182,176,6,39,56994,3.296703296703297
"Bolivar village, Ohio",482,451,31,39,07594,6.431535269709543
"Port Washington village, Ohio",187,180,7,39,64346,3.7433155080213902
"Roswell village, Ohio",102,92,10,39,68742,9.803921568627452
"Gratis village, Ohio",398,354,44,39,31472,11.055276381909549
"Golf Manor village, Ohio",1706,1462,244,39,30786,14.302461899179367
"Addyston village, Ohio",524,415,109,39,00436,20.801526717557252
"Finneytown CDP, Ohio",5283,4933,350,39,27104,6.625023660798789
"Glendale village, Ohio",1063,957,106,39,30380,9.971777986829727
"Harrisburg village, Ohio",214,187,27,39,33740,12.616822429906541
"South Bloomfield village, Ohio",815,764,51,39,73068,6.257668711656442
"Marengo village, Ohio",146,126,20,39,47558,13.698630136986301
"Mount Gilead village, Ohio",1636,1389,247,39,52738,15.097799511002444
"Akron city, Ohio",96676,84761,11915,39,01000,12.324672100624767
"Milford Center village, Ohio",333,306,27,39,50218,8.108108108108109
"Unionville Center village, Ohio",156,146,10,39,78834,6.41025641025641
"Chilo village, Ohio",66,36,30,39,14226,45.45454545454545
"Mount Carmel CDP, Ohio",2072,1914,158,39,52612,7.625482625482626
"Rittman city, Ohio",2710,2550,160,39,67356,5.904059040590406
"Clarksville village, Ohio",297,241,56,39,15406,18.855218855218855
"Martinsville village, Ohio",172,155,17,39,48118,9.883720930232558
"Leesville village, Ohio",123,110,13,39,42518,10.569105691056912
"Amberley village, Ohio",1391,1340,51,39,01672,3.6664270309130123
"Evendale village, Ohio",1155,1110,45,39,25802,3.896103896103896
"Kenwood CDP, Ohio",3324,3105,219,39,39914,6.588447653429603
"East Sparta village, Ohio",378,338,40,39,24052,10.582010582010582
"Avon city, Ohio",8331,7957,374,39,03352,4.489256991957748
"South Zanesville village, Ohio",969,904,65,39,73894,6.707946336429309
"Champion Heights CDP, Ohio",2820,2708,112,39,13484,3.9716312056737593
"Tuscarawas village, Ohio",597,588,9,39,77924,1.507537688442211
"Ohio City village, Ohio",379,341,38,39,58002,10.026385224274406
"Venedocia village, Ohio",88,55,33,39,79632,37.5
"Wellsville village, Ohio",1706,1440,266,39,82740,15.59202813599062
"Crooksville village, Ohio",1137,976,161,39,19456,14.160070360598064
"Junction City village, Ohio",352,304,48,39,39508,13.636363636363635
"Rome village, Ohio",67,36,31,39,68196,46.26865671641791
"Chagrin Falls village, Ohio",1994,1816,178,39,13358,8.926780341023068
"Haskins village, Ohio",433,399,34,39,34412,7.852193995381063
"Montpelier village, Ohio",1879,1688,191,39,51772,10.164981373070782
"Chesterhill village, Ohio",200,170,30,39,14086,15.0
"Stockport village, Ohio",293,273,20,39,74748,6.825938566552901
"Blakeslee village, Ohio",35,31,4,39,06810,11.428571428571429
"Caledonia village, Ohio",336,291,45,39,10954,13.392857142857142
"Enon village, Ohio",1127,1102,25,39,25452,2.218278615794144
"Liberty Center village, Ohio",566,503,63,39,43414,11.130742049469964
"Congress village, Ohio",65,53,12,39,18308,18.461538461538463
"Mogadore village, Ohio",1362,1302,60,39,51058,4.405286343612335
"Fairport Harbor village, Ohio",1663,1524,139,39,26306,8.35838845460012
"Mount Victory village, Ohio",287,245,42,39,53144,14.634146341463413
"Burkettsville village, Ohio",122,111,11,39,10296,9.01639344262295
"Bay View village, Ohio",323,270,53,39,04402,16.408668730650156
"Huntsville village, Ohio",238,211,27,39,36988,11.344537815126051
"Ney village, Ohio",107,91,16,39,55874,14.953271028037381
"Burgoon village, Ohio",68,58,10,39,10282,14.705882352941178
"Bergholz village, Ohio",318,273,45,39,05718,14.150943396226415
"Bainbridge CDP, Ohio",1103,1103,0,39,03585,0.0
"Limaville village, Ohio",91,88,3,39,43596,3.296703296703297
"Norton city, Ohio",5040,4703,337,39,57260,6.686507936507937
"Magnolia village, Ohio",427,382,45,39,46844,10.53864168618267
"Smithfield village, Ohio",387,291,96,39,72760,24.8062015503876
"Richwood village, Ohio",999,907,92,39,66936,9.20920920920921
"Mount Healthy Heights CDP, Ohio",1178,1105,73,39,52780,6.196943972835315
"Quincy village, Ohio",293,247,46,39,65200,15.699658703071673
"Norwalk city, Ohio",7542,6952,590,39,57302,7.822858658180854
"Tiltonsville village, Ohio",693,600,93,39,76806,13.41991341991342
"Wadsworth city, Ohio",9887,9297,590,39,80304,5.967431981389703
"Walton Hills village, Ohio",985,950,35,39,80738,3.5532994923857872
"Logan Elm Village CDP, Ohio",411,388,23,39,44636,5.59610705596107
"McGuffey village, Ohio",221,189,32,39,46046,14.479638009049776
"Nevada village, Ohio",362,342,20,39,53942,5.524861878453039
"North Baltimore village, Ohio",1281,1182,99,39,56154,7.728337236533958
"Gilboa village, Ohio",70,62,8,39,30114,11.428571428571429
"Wright-Patterson AFB CDP, Ohio",520,520,0,39,86660,0.0
"Trenton city, Ohio",4559,4293,266,39,77322,5.834612853695987
"Beechwood Trails CDP, Ohio",1238,1238,0,39,05013,0.0
"Ottoville village, Ohio",379,370,9,39,59052,2.3746701846965697
"North Perry village, Ohio",316,280,36,39,56910,11.39240506329114
"Republic village, Ohio",268,230,38,39,66320,14.17910447761194
"Churchill CDP, Ohio",1085,1034,51,39,14324,4.700460829493087
"Pickerington city, Ohio",7388,6933,455,39,62498,6.158635625338387
"Van Wert city, Ohio",5094,4593,501,39,79562,9.83510011778563
"Benton Ridge village, Ohio",176,163,13,39,05662,7.386363636363637
"Berkey village, Ohio",131,120,11,39,05732,8.396946564885496
"Summerfield village, Ohio",160,108,52,39,75406,32.5
"Lewisville village, Ohio",100,79,21,39,42980,21.0
"Avon Lake city, Ohio",10088,9389,699,39,03464,6.929024583663759
"Belmore village, Ohio",63,37,26,39,05396,41.269841269841265
"Pandora village, Ohio",481,438,43,39,59738,8.93970893970894
"Morrow village, Ohio",634,592,42,39,52374,6.624605678233439
"Burton village, Ohio",611,555,56,39,10436,9.165302782324058
"North Fairfield village, Ohio",191,175,16,39,56420,8.37696335078534
"Fort Recovery village, Ohio",627,603,24,39,27902,3.827751196172249
"Lindsey village, Ohio",246,209,37,39,43904,15.040650406504067
"Weston village, Ohio",694,589,105,39,83972,15.129682997118154
"Mount Blanchard village, Ohio",192,159,33,39,52598,17.1875
"Marseilles village, Ohio",56,44,12,39,47992,21.428571428571427
"Defiance city, Ohio",7927,6922,1005,39,21308,12.678188469786805
"Gann village, Ohio",68,54,14,39,29288,20.588235294117645
"South Webster village, Ohio",335,298,37,39,73824,11.044776119402986
"Dotyville CDP, Oklahoma",70,63,7,40,21150,10.0
"Stratford town, Oklahoma",678,545,133,40,70800,19.616519174041297
"Hunter town, Oklahoma",100,83,17,40,36600,17.0
"Cowlington town, Oklahoma",64,39,25,40,17850,39.0625
"Redbird town, Oklahoma",42,32,10,40,62200,23.809523809523807
"Tipton town, Oklahoma",416,342,74,40,73850,17.78846153846154
"Madill city, Oklahoma",1540,1351,189,40,45750,12.272727272727273
"Paden town, Oklahoma",240,196,44,40,56800,18.333333333333332
"Taft town, Oklahoma",116,73,43,40,72050,37.06896551724138
"Calera town, Oklahoma",1029,946,83,40,10950,8.066083576287658
"Harrah city, Oklahoma",2616,2382,234,40,32750,8.944954128440367
"Adair town, Oklahoma",349,287,62,40,00250,17.765042979942695
"Foss town, Oklahoma",86,63,23,40,27450,26.744186046511626
"Kendrick town, Oklahoma",53,31,22,40,39150,41.509433962264154
"Peavine CDP, Oklahoma",174,156,18,40,57875,10.344827586206897
"Chandler city, Oklahoma",1399,1111,288,40,13500,20.58613295210865
"Mangum city, Oklahoma",1566,1162,404,40,46050,25.798212005108557
"Stilwell city, Oklahoma",1621,1335,286,40,70350,17.643429981492904
"Haileyville city, Oklahoma",398,293,105,40,31900,26.38190954773869
"Davenport town, Oklahoma",367,277,90,40,19350,24.52316076294278
"Phillips town, Oklahoma",56,48,8,40,58500,14.285714285714285
"Gene Autry town, Oklahoma",75,53,22,40,28950,29.333333333333332
"Carrier town, Oklahoma",14,13,1,40,12200,7.142857142857142
"Fargo town, Oklahoma",166,129,37,40,25450,22.289156626506024
"Watonga city, Oklahoma",979,805,174,40,78950,17.7732379979571
"Rosedale town, Oklahoma",25,20,5,40,64000,20.0
"Perry city, Oklahoma",2524,2065,459,40,58250,18.185419968304277
"Inola town, Oklahoma",752,698,54,40,37100,7.180851063829788
"Goldsby town, Oklahoma",825,782,43,40,29850,5.212121212121213
"Wyandotte town, Oklahoma",145,128,17,40,82250,11.724137931034482
"Copeland CDP, Oklahoma",1142,751,391,40,17110,34.23817863397548
"Council Hill town, Oklahoma",63,48,15,40,17550,23.809523809523807
"Porum town, Oklahoma",314,261,53,40,60250,16.878980891719745
"Summit town, Oklahoma",60,43,17,40,71450,28.333333333333332
"Cheyenne town, Oklahoma",368,305,63,40,13900,17.119565217391305
"Lone Grove city, Oklahoma",2202,1930,272,40,43750,12.352406902815623
"Newkirk city, Oklahoma",1063,873,190,40,51300,17.873941674506113
"Tushka town, Oklahoma",158,128,30,40,75250,18.9873417721519
"Thackerville town, Oklahoma",167,120,47,40,73200,28.143712574850298
"Hartshorne city, Oklahoma",1091,880,211,40,32850,19.34005499541705
"Kiowa town, Oklahoma",329,249,80,40,40000,24.316109422492403
"Bessie town, Oklahoma",89,74,15,40,05650,16.853932584269664
"New Cordell city, Oklahoma",1438,1208,230,40,51250,15.99443671766342
"Douglas town, Oklahoma",14,10,4,40,21250,28.57142857142857
"Renfrow town, Oklahoma",4,4,0,40,62900,0.0
"Cashion town, Oklahoma",308,277,31,40,12650,10.064935064935066
"McAlester city, Oklahoma",8052,6791,1261,40,44800,15.660705414803774
"Quinton town, Oklahoma",495,362,133,40,61550,26.86868686868687
"Nicoma Park city, Oklahoma",1091,939,152,40,51850,13.932172318973418
"Comanche city, Oklahoma",876,650,226,40,16450,25.799086757990867
"Empire City town, Oklahoma",386,327,59,40,23900,15.284974093264248
"Granite town, Oklahoma",569,455,114,40,30950,20.035149384885763
"Seminole city, Oklahoma",3079,2599,480,40,66350,15.589477102955504
"Canute town, Oklahoma",227,188,39,40,11650,17.180616740088105
"Wann town, Oklahoma",59,45,14,40,78250,23.728813559322035
"Maud city, Oklahoma",509,383,126,40,46900,24.75442043222004
"Wewoka city, Oklahoma",1805,1247,558,40,80550,30.914127423822713
"Erick city, Oklahoma",522,361,161,40,24200,30.842911877394634
"Horntown town, Oklahoma",45,40,5,40,36090,11.11111111111111
"Lamar town, Oklahoma",90,65,25,40,41250,27.77777777777778
"Hitchita town, Oklahoma",39,24,15,40,34900,38.46153846153847
"Rentiesville town, Oklahoma",107,80,27,40,62950,25.233644859813083
"Texanna CDP, Oklahoma",1980,1119,861,40,72950,43.484848484848484
"Drumright city, Oklahoma",1429,1172,257,40,21750,17.984604618614416
"Longdale town, Oklahoma",210,143,67,40,43950,31.9047619047619
"Paoli town, Oklahoma",298,244,54,40,57100,18.120805369127517
"Sasakwa town, Oklahoma",64,35,29,40,65500,45.3125
"Geary city, Oklahoma",674,531,143,40,28900,21.216617210682493
"Norge town, Oklahoma",65,55,10,40,52450,15.384615384615385
"Yukon city, Oklahoma",9274,8691,583,40,82950,6.286392063834375
"Cyril town, Oklahoma",429,351,78,40,19000,18.181818181818183
"Gracemont town, Oklahoma",155,116,39,40,30600,25.161290322580644
"Wister town, Oklahoma",491,421,70,40,81750,14.25661914460285
"Belfonte CDP, Oklahoma",124,95,29,40,05070,23.387096774193548
"Marble City town, Oklahoma",92,76,16,40,46450,17.391304347826086
"Moffett town, Oklahoma",56,49,7,40,49000,12.5
"Vici town, Oklahoma",339,272,67,40,77300,19.76401179941003
"Blackwell city, Oklahoma",3480,2728,752,40,06600,21.60919540229885
"Davis city, Oklahoma",1235,1003,232,40,19450,18.785425101214575
"Dougherty town, Oklahoma",107,87,20,40,21200,18.69158878504673
"Kansas town, Oklahoma",330,293,37,40,38600,11.212121212121213
"Twin Oaks CDP, Oklahoma",93,93,0,40,75600,0.0
"Bromide town, Oklahoma",66,55,11,40,09150,16.666666666666664
"Chouteau town, Oklahoma",943,809,134,40,14300,14.209968186638388
"Murphy CDP, Oklahoma",101,71,30,40,49950,29.7029702970297
"Snake Creek CDP, Oklahoma",105,81,24,40,68275,22.857142857142858
"Spavinaw town, Oklahoma",256,186,70,40,69050,27.34375
"Strang town, Oklahoma",48,38,10,40,70750,20.833333333333336
"Asher town, Oklahoma",163,138,25,40,03000,15.337423312883436
"Macomb town, Oklahoma",16,13,3,40,45500,18.75
"Binger town, Oklahoma",306,243,63,40,06200,20.588235294117645
"Bridgeport city, Oklahoma",51,35,16,40,08750,31.372549019607842
"Hydro town, Oklahoma",491,398,93,40,36700,18.94093686354379
"Cameron town, Oklahoma",133,106,27,40,11300,20.30075187969925
"Heavener city, Oklahoma",1384,1072,312,40,33400,22.54335260115607
"Temple town, Oklahoma",568,367,201,40,72750,35.38732394366197
"Hobart city, Oklahoma",1916,1431,485,40,35000,25.313152400835072
"Eldon CDP, Oklahoma",104,53,51,40,23300,49.03846153846153
"Keys CDP, Oklahoma",189,174,15,40,39625,7.936507936507936
"Zeb CDP, Oklahoma",262,224,38,40,83030,14.50381679389313
"Coweta city, Oklahoma",3735,3439,296,40,17800,7.925033467202142
"Durant city, Oklahoma",7627,6696,931,40,22050,12.20663432542284
"Francis town, Oklahoma",131,107,24,40,27650,18.3206106870229
"Agra town, Oklahoma",158,112,46,40,00700,29.11392405063291
"Midwest City city, Oklahoma",25331,23161,2170,40,48350,8.566578500651376
"Central High town, Oklahoma",490,430,60,40,13135,12.244897959183673
"The Village city, Oklahoma",4937,4615,322,40,73250,6.5221794612112625
"Duncan city, Oklahoma",11089,8959,2130,40,21900,19.20822436648931
"Willow town, Oklahoma",95,56,39,40,81300,41.05263157894737
"Mulhall town, Oklahoma",88,80,8,40,49900,9.090909090909092
"Orlando town, Oklahoma",57,47,10,40,56050,17.543859649122805
"Le Flore town, Oklahoma",75,56,19,40,42150,25.333333333333336
"Dwight Mission CDP, Oklahoma",25,17,8,40,22275,32.0
"Wapanucka town, Oklahoma",182,128,54,40,78300,29.67032967032967
"Oklahoma City city, Oklahoma",270236,240471,29765,40,55000,11.014446631832916
"Fort Supply town, Oklahoma",177,132,45,40,27350,25.423728813559322
"Wanette town, Oklahoma",151,109,42,40,78200,27.81456953642384
"Ponca City city, Oklahoma",11541,9698,1843,40,59850,15.969153452907028
"Chattanooga town, Oklahoma",194,155,39,40,13600,20.103092783505154
"Davidson town, Oklahoma",172,112,60,40,19400,34.883720930232556
"Sharon town, Oklahoma",39,30,9,40,66650,23.076923076923077
"Hammon town, Oklahoma",216,150,66,40,32250,30.555555555555557
"Taloga town, Oklahoma",221,156,65,40,72350,29.411764705882355
"Armstrong town, Oklahoma",53,47,6,40,02750,11.320754716981133
"Colbert town, Oklahoma",619,549,70,40,16050,11.308562197092083
"Sawyer town, Oklahoma",167,127,40,40,65650,23.952095808383234
"Cornish town, Oklahoma",70,53,17,40,17350,24.285714285714285
"Fitzhugh town, Oklahoma",126,122,4,40,26250,3.1746031746031744
"Webb City town, Oklahoma",25,18,7,40,79600,28.000000000000004
"Hugo city, Oklahoma",2576,2034,542,40,36300,21.040372670807454
"Fairfax town, Oklahoma",794,542,252,40,24850,31.738035264483628
"Osage town, Oklahoma",97,68,29,40,56150,29.896907216494846
"Salina town, Oklahoma",618,486,132,40,64950,21.35922330097087
"Arnett town, Oklahoma",289,253,36,40,02800,12.45674740484429
"Braggs town, Oklahoma",118,91,27,40,08400,22.88135593220339
"Hennessey town, Oklahoma",1061,965,96,40,33700,9.048067860508954
"Loyal town, Oklahoma",56,36,20,40,44300,35.714285714285715
"Tatums town, Oklahoma",73,46,27,40,72500,36.986301369863014
"Wilson city, Oklahoma",663,524,139,40,81500,20.96530920060332
"Iron Post CDP, Oklahoma",54,54,0,40,37275,0.0
"Texola town, Oklahoma",50,25,25,40,73150,50.0
"Big Cabin town, Oklahoma",119,96,23,40,05900,19.327731092436977
"Breckenridge town, Oklahoma",98,74,24,40,08600,24.489795918367346
"Strong City town, Oklahoma",17,11,6,40,70950,35.294117647058826
"Kiefer town, Oklahoma",892,831,61,40,39750,6.838565022421525
"Dewey city, Oklahoma",1692,1409,283,40,20550,16.725768321513
"Okeene town, Oklahoma",714,591,123,40,54150,17.22689075630252
"Laverne town, Oklahoma",672,482,190,40,41700,28.273809523809522
"Vera town, Oklahoma",78,69,9,40,76950,11.538461538461538
"Maysville town, Oklahoma",570,438,132,40,47150,23.157894736842106
"Hillsdale town, Oklahoma",50,45,5,40,34650,10.0
"Fairmont town, Oklahoma",95,91,4,40,24950,4.2105263157894735
"Olustee town, Oklahoma",267,194,73,40,55450,27.340823970037455
"Pink town, Oklahoma",829,692,137,40,59150,16.52593486127865
"Boynton town, Oklahoma",137,91,46,40,08150,33.57664233576642
"Ada city, Oklahoma",8040,6711,1329,40,00200,16.529850746268657
"Colony town, Oklahoma",79,51,28,40,16400,35.44303797468354
"Dustin town, Oklahoma",163,107,56,40,22200,34.355828220858896
"Shady Grove CDP (McIntosh County), Oklahoma",81,81,0,40,66520,0.0
"Bowlegs town, Oklahoma",176,137,39,40,07950,22.15909090909091
"Pryor Creek city, Oklahoma",4312,3719,593,40,61000,13.752319109461967
"Caney town, Oklahoma",93,88,5,40,11550,5.376344086021505
"Ralston town, Oklahoma",161,108,53,40,61650,32.91925465838509
"Burlington town, Oklahoma",61,52,9,40,10050,14.754098360655737
"Ninnekah town, Oklahoma",484,414,70,40,52100,14.46280991735537
"Seiling city, Oklahoma",406,283,123,40,66250,30.295566502463057
"Tonkawa city, Oklahoma",1472,1238,234,40,74150,15.896739130434783
"Dacoma town, Oklahoma",63,45,18,40,19050,28.57142857142857
"Soper town, Oklahoma",149,96,53,40,68500,35.57046979865772
"Terral town, Oklahoma",249,169,80,40,72900,32.1285140562249
"Bokoshe town, Oklahoma",195,156,39,40,07450,20.0
"Union City town, Oklahoma",550,504,46,40,75950,8.363636363636363
"Hinton town, Oklahoma",873,774,99,40,34750,11.34020618556701
"Jenks city, Oklahoma",7818,7338,480,40,37800,6.139677666922486
"Owasso city, Oklahoma",13723,13086,637,40,56650,4.6418421627923925
"Fort Towson town, Oklahoma",315,223,92,40,27400,29.20634920634921
"Cayuga CDP, Oklahoma",84,69,15,40,12915,17.857142857142858
"Cloud Creek CDP, Oklahoma",30,26,4,40,15625,13.333333333333334
"Jay city, Oklahoma",1058,864,194,40,37650,18.336483931947072
"New Eucha CDP, Oklahoma",138,138,0,40,51275,0.0
"Oaks town, Oklahoma",89,67,22,40,53550,24.719101123595504
"West Siloam Springs town, Oklahoma",355,266,89,40,80350,25.070422535211268
"Milburn town, Oklahoma",134,122,12,40,48400,8.955223880597014
"Disney town, Oklahoma",222,122,100,40,20900,45.04504504504504
"Muskogee city, Oklahoma",18102,15074,3028,40,50050,16.72743343276986
"Locust Grove town, Oklahoma",652,565,87,40,43500,13.34355828220859
"Piedmont city, Oklahoma",2414,2310,104,40,58700,4.308202154101077
"Fort Gibson town, Oklahoma",1811,1639,172,40,27200,9.497515184980672
"Oktaha town, Oklahoma",159,137,22,40,55200,13.836477987421384
"River Bottom CDP, Oklahoma",131,105,26,40,63537,19.84732824427481
"Sour John CDP, Oklahoma",44,32,12,40,68537,27.27272727272727
"Devol town, Oklahoma",81,60,21,40,20450,25.925925925925924
"Walters city, Oklahoma",1296,971,325,40,78150,25.07716049382716
"Jennings town, Oklahoma",151,119,32,40,37850,21.192052980132452
"Oak Grove town, Oklahoma",9,4,5,40,53210,55.55555555555556
"Skedee town, Oklahoma",15,8,7,40,67800,46.666666666666664
"Fair Oaks town, Oklahoma",41,35,6,40,25000,14.634146341463413
"Okay town, Oklahoma",232,192,40,40,54100,17.24137931034483
"Caddo town, Oklahoma",539,480,59,40,10800,10.946196660482375
"Silo town, Oklahoma",155,145,10,40,67550,6.451612903225806
"Allen town, Oklahoma",405,320,85,40,01400,20.98765432098765
"Carnegie town, Oklahoma",859,676,183,40,12050,21.303841676367867
"Ryan town, Oklahoma",453,292,161,40,64600,35.54083885209713
"Oakland town, Oklahoma",442,387,55,40,53400,12.44343891402715
"El Reno city, Oklahoma",6889,5939,950,40,23700,13.790100159674845
"Cement town, Oklahoma",246,152,94,40,13000,38.21138211382114
"Fort Coffee town, Oklahoma",212,187,25,40,27150,11.79245283018868
"Poteau city, Oklahoma",3668,3218,450,40,60350,12.26826608505998
"Shady Point town, Oklahoma",476,380,96,40,66550,20.168067226890756
"Castle town, Oklahoma",55,44,11,40,12750,20.0
"Gore town, Oklahoma",469,372,97,40,30300,20.68230277185501
"Short CDP, Oklahoma",147,125,22,40,67400,14.965986394557824
"Kingfisher city, Oklahoma",2007,1781,226,40,39850,11.260587942202292
"Ratliff City town, Oklahoma",58,45,13,40,61900,22.413793103448278
"Rattan town, Oklahoma",156,121,35,40,61950,22.435897435897438
"Stringtown town, Oklahoma",239,180,59,40,70850,24.686192468619247
"Achille town, Oklahoma",199,160,39,40,00100,19.597989949748744
"Bokchito town, Oklahoma",299,257,42,40,07350,14.046822742474916
"Mead town, Oklahoma",56,44,12,40,47250,21.428571428571427
"Dodge CDP, Oklahoma",38,38,0,40,21020,0.0
"Grove city, Oklahoma",4051,3188,863,40,31600,21.30338188101703
"Ravia town, Oklahoma",225,185,40,40,62000,17.77777777777778
"Ballou CDP, Oklahoma",96,96,0,40,04075,0.0
"Panama town, Oklahoma",637,489,148,40,56900,23.233908948194664
"Warner town, Oklahoma",623,484,139,40,78400,22.31139646869984
"Eakly town, Oklahoma",141,111,30,40,22400,21.27659574468085
"Alex town, Oklahoma",275,218,57,40,01250,20.727272727272727
"Chickasha city, Oklahoma",7654,6353,1301,40,13950,16.997648288476615
"Howe town, Oklahoma",328,261,67,40,36150,20.426829268292682
"Brushy CDP, Oklahoma",394,356,38,40,09650,9.644670050761421
"Flute Springs CDP, Oklahoma",55,30,25,40,26525,45.45454545454545
"Long CDP, Oklahoma",161,135,26,40,43900,16.149068322981368
"Vian town, Oklahoma",606,504,102,40,77250,16.831683168316832
"Cleora CDP, Oklahoma",1745,598,1147,40,15250,65.73065902578796
"Colcord town, Oklahoma",353,315,38,40,16100,10.764872521246458
"Dennis CDP, Oklahoma",204,60,144,40,20100,70.58823529411765
"Tagg Flats CDP, Oklahoma",15,15,0,40,72075,0.0
"Hollister town, Oklahoma",35,20,15,40,35550,42.857142857142854
"Loveland town, Oklahoma",2,2,0,40,44150,0.0
"Carmen town, Oklahoma",263,196,67,40,12000,25.475285171102662
"Cherokee city, Oklahoma",838,639,199,40,13750,23.74701670644391
"Freedom town, Oklahoma",151,109,42,40,27850,27.81456953642384
"Tishomingo city, Oklahoma",1380,1238,142,40,73900,10.289855072463768
"Old Eucha CDP, Oklahoma",13,7,6,40,55275,46.15384615384615
"Rocky Ford CDP, Oklahoma",18,16,2,40,63715,11.11111111111111
"Mannsville town, Oklahoma",412,321,91,40,46300,22.0873786407767
"Hoot Owl town, Oklahoma",0,0,0,40,36020,
"Langley town, Oklahoma",456,278,178,40,41500,39.03508771929825
"Sportsmen Acres town, Oklahoma",146,121,25,40,69400,17.123287671232877
"Bethel Acres town, Oklahoma",1231,1090,141,40,05800,11.454102355808287
"Tribbey town, Oklahoma",159,133,26,40,74400,16.352201257861633
"Weatherford city, Oklahoma",4986,4374,612,40,79450,12.274368231046932
"Waurika city, Oklahoma",1022,751,271,40,79250,26.516634050880626
"Kingston town, Oklahoma",764,634,130,40,39900,17.015706806282722
"Apache town, Oklahoma",723,546,177,40,02300,24.481327800829874
"Sayre city, Oklahoma",1671,1248,423,40,65700,25.314183123877914
"Bluejacket town, Oklahoma",126,100,26,40,06950,20.634920634920633
"Atwood town, Oklahoma",47,22,25,40,03350,53.191489361702125
"Stuart town, Oklahoma",94,53,41,40,71050,43.61702127659575
"Pensacola town, Oklahoma",42,36,6,40,58050,14.285714285714285
"Pump Back CDP, Oklahoma",92,70,22,40,61020,23.91304347826087
"Tecumseh city, Oklahoma",2897,2521,376,40,72650,12.978943734898172
"Lost City CDP, Oklahoma",325,287,38,40,44075,11.692307692307692
"Keota town, Oklahoma",232,189,43,40,39500,18.53448275862069
"Tamaha town, Oklahoma",89,67,22,40,72400,24.719101123595504
"Garvin town, Oklahoma",118,99,19,40,28700,16.101694915254235
"Bixby city, Oklahoma",9761,9141,620,40,06400,6.351808216371273
"Tullahassee town, Oklahoma",60,51,9,40,74650,15.0
"Liberty town, Oklahoma",77,68,9,40,42860,11.688311688311687
"Oakhurst CDP, Oklahoma",1155,948,207,40,53350,17.92207792207792
"Sand Springs city, Oklahoma",8507,7797,710,40,65300,8.34606794404608
"Boswell town, Oklahoma",366,274,92,40,07750,25.136612021857925
"Sugden town, Oklahoma",26,19,7,40,71250,26.923076923076923
"Tahlequah city, Oklahoma",7170,5822,1348,40,72100,18.800557880055788
"Tenkiller CDP, Oklahoma",269,202,67,40,72775,24.907063197026023
"Randlett town, Oklahoma",206,141,65,40,61850,31.55339805825243
"McCurtain town, Oklahoma",201,166,35,40,44950,17.412935323383085
"Valliant town, Oklahoma",399,340,59,40,76650,14.786967418546364
"Maramec town, Oklahoma",63,48,15,40,46400,23.809523809523807
"Broken Arrow city, Oklahoma",41016,38723,2293,40,09050,5.590501267797932
"Byng town, Oklahoma",508,450,58,40,10600,11.41732283464567
"Burbank town, Oklahoma",52,38,14,40,09950,26.923076923076923
"Pawhuska city, Oklahoma",1787,1423,364,40,57600,20.369334079462785
"Shattuck town, Oklahoma",737,479,258,40,66750,35.00678426051561
"Dover town, Oklahoma",152,134,18,40,21350,11.842105263157894
"Cole town, Oklahoma",272,257,15,40,16200,5.514705882352941
"Miami city, Oklahoma",5982,5099,883,40,48000,14.760949515212305
"Headrick town, Oklahoma",66,43,23,40,33300,34.84848484848485
"Fairview city, Oklahoma",1350,1040,310,40,25100,22.962962962962962
"Pocasset town, Oklahoma",84,64,20,40,59700,23.809523809523807
"Boise City city, Oklahoma",739,505,234,40,07300,31.66441136671177
"Byron town, Oklahoma",21,19,2,40,10650,9.523809523809524
"Lambert town, Oklahoma",7,3,4,40,41300,57.14285714285714
"Fanshawe town, Oklahoma",160,140,20,40,25400,12.5
"Spiro town, Oklahoma",1100,914,186,40,69350,16.90909090909091
"Roland town, Oklahoma",1527,1259,268,40,63800,17.550753110674524
"Goltry town, Oklahoma",158,102,56,40,29900,35.44303797468354
"Muldrow town, Oklahoma",1339,1092,247,40,49850,18.446601941747574
"Paradise Hill town, Oklahoma",109,24,85,40,57150,77.98165137614679
"Park Hill CDP, Oklahoma",1398,1189,209,40,57300,14.949928469241774
"Wright City town, Oklahoma",331,285,46,40,82200,13.897280966767372
"Pettit CDP, Oklahoma",493,302,191,40,58400,38.74239350912779
"Shady Grove CDP (Cherokee County), Oklahoma",165,150,15,40,66510,9.090909090909092
"Whitefield town, Oklahoma",197,165,32,40,80800,16.243654822335024
"Blackburn town, Oklahoma",50,36,14,40,06450,28.000000000000004
"Hallett town, Oklahoma",64,46,18,40,32050,28.125
"Terlton town, Oklahoma",50,33,17,40,72850,34.0
"Wagoner city, Oklahoma",4034,3452,582,40,77850,14.42736737729301
"Helena town, Oklahoma",233,178,55,40,33450,23.605150214592275
"Jet town, Oklahoma",182,120,62,40,38000,34.065934065934066
"Capron town, Oklahoma",0,0,0,40,11750,
"Waynoka city, Oklahoma",599,407,192,40,79350,32.053422370617696
"Gans town, Oklahoma",116,90,26,40,28350,22.413793103448278
"Sallisaw city, Oklahoma",4133,3527,606,40,65000,14.662472780062908
"Millerton town, Oklahoma",127,109,18,40,48600,14.173228346456693
"Smithville town, Oklahoma",44,35,9,40,68250,20.454545454545457
"Westport town, Oklahoma",217,186,31,40,80250,14.285714285714285
"Kenefic town, Oklahoma",66,55,11,40,39200,16.666666666666664
"Hollis city, Oklahoma",1050,840,210,40,35500,20.0
"Barnsdall city, Oklahoma",609,459,150,40,04250,24.63054187192118
"McCord CDP, Oklahoma",757,634,123,40,44925,16.248348745046233
"Shidler city, Oklahoma",218,138,80,40,67200,36.69724770642202
"Aline town, Oklahoma",101,63,38,40,01350,37.62376237623762
"Greasy CDP, Oklahoma",150,119,31,40,31165,20.666666666666668
"Crescent city, Oklahoma",663,526,137,40,18250,20.66365007541478
"Langston town, Oklahoma",178,101,77,40,41550,43.258426966292134
"Hoffman town, Oklahoma",52,44,8,40,35300,15.384615384615385
"Bell CDP, Oklahoma",146,136,10,40,05090,6.8493150684931505
"Chewey CDP, Oklahoma",70,31,39,40,13850,55.714285714285715
"Rocky Mountain CDP, Oklahoma",204,181,23,40,63720,11.27450980392157
"West Peavine CDP, Oklahoma",148,129,19,40,80230,12.837837837837837
"Zion CDP, Oklahoma",7,7,0,40,83125,0.0
"Bristow city, Oklahoma",1987,1644,343,40,08900,17.262204328132864
"Slick town, Oklahoma",72,59,13,40,68000,18.055555555555554
"Altus city, Oklahoma",9059,7415,1644,40,01700,18.14769842145932
"Jefferson town, Oklahoma",9,3,6,40,37750,66.66666666666666
"Nash town, Oklahoma",122,98,24,40,50300,19.672131147540984
"Tryon town, Oklahoma",267,183,84,40,74550,31.46067415730337
"Jones town, Oklahoma",1150,1022,128,40,38350,11.130434782608695
"Smith Village town, Oklahoma",45,36,9,40,68200,20.0
"Valley Brook town, Oklahoma",380,323,57,40,76500,15.0
"Woodlawn Park town, Oklahoma",84,79,5,40,82000,5.952380952380952
"Centrahoma city, Oklahoma",37,24,13,40,13100,35.13513513513514
"Guthrie city, Oklahoma",4793,3918,875,40,31700,18.25578969330273
"Dewar town, Oklahoma",368,311,57,40,20500,15.489130434782608
"Morris city, Oklahoma",581,505,76,40,49400,13.080895008605854
"Goodwell town, Oklahoma",484,378,106,40,30200,21.90082644628099
"Indiahoma town, Oklahoma",167,137,30,40,36850,17.964071856287426
"Washington town, Oklahoma",266,236,30,40,78700,11.278195488721805
"Glenpool city, Oklahoma",4883,4532,351,40,29600,7.188203972967439
"Indianola town, Oklahoma",70,54,16,40,36950,22.857142857142858
"Pittsburg town, Oklahoma",119,95,24,40,59350,20.168067226890756
"Savanna town, Oklahoma",319,254,65,40,65600,20.37617554858934
"Rocky town, Oklahoma",89,74,15,40,63700,16.853932584269664
"Delaware town, Oklahoma",192,153,39,40,19850,20.3125
"Nowata city, Oklahoma",1872,1551,321,40,52900,17.147435897435898
"Enid city, Oklahoma",21718,19338,2380,40,23950,10.95865180955889
"Garber city, Oklahoma",403,318,85,40,28500,21.09181141439206
"Turley CDP, Oklahoma",1224,944,280,40,75150,22.875816993464053
"Lone Wolf town, Oklahoma",231,170,61,40,43850,26.406926406926406
"Mountain View town, Oklahoma",477,318,159,40,49650,33.33333333333333
"Mountain Park town, Oklahoma",213,173,40,40,49600,18.779342723004692
"Covington town, Oklahoma",222,193,29,40,17700,13.063063063063062
"Lahoma town, Oklahoma",240,208,32,40,40700,13.333333333333334
"Roosevelt town, Oklahoma",187,140,47,40,63900,25.13368983957219
"Red Rock town, Oklahoma",155,131,24,40,62650,15.483870967741936
"Bushyhead CDP, Oklahoma",575,466,109,40,10400,18.956521739130437
"Arapaho town, Oklahoma",364,261,103,40,02500,28.296703296703296
"Thomas city, Oklahoma",671,521,150,40,73450,22.35469448584203
"Hastings town, Oklahoma",76,46,30,40,33000,39.473684210526315
"Bernice town, Oklahoma",374,238,136,40,05550,36.36363636363637
"Gage town, Oklahoma",275,192,83,40,28250,30.181818181818183
"Simms CDP, Oklahoma",115,84,31,40,67625,26.956521739130434
"Wainwright town, Oklahoma",52,48,4,40,77900,7.6923076923076925
"Dickson town, Oklahoma",517,464,53,40,20700,10.251450676982591
"Putnam town, Oklahoma",22,14,8,40,61250,36.36363636363637
"Sulphur city, Oklahoma",2285,1920,365,40,71350,15.973741794310722
"Addington town, Oklahoma",68,54,14,40,00450,20.588235294117645
"Ringling town, Oklahoma",512,370,142,40,63350,27.734375
"Mustang city, Oklahoma",7445,7165,280,40,50100,3.760913364674278
"Arkoma town, Oklahoma",900,768,132,40,02650,14.666666666666666
"Cache city, Oklahoma",1150,975,175,40,10700,15.217391304347828
"Webbers Falls town, Oklahoma",300,213,87,40,79650,28.999999999999996
"Ramona town, Oklahoma",269,212,57,40,61700,21.189591078066915
"Slaughterville town, Oklahoma",1697,1532,165,40,67950,9.723040659988214
"Elgin city, Oklahoma",1054,962,92,40,23450,8.72865275142315
"Sterling town, Oklahoma",329,260,69,40,70150,20.972644376899694
"May town, Oklahoma",37,20,17,40,47000,45.94594594594595
"Newcastle city, Oklahoma",3914,3733,181,40,51150,4.624425140521206
"Wayne town, Oklahoma",277,232,45,40,79300,16.24548736462094
"Narcissa CDP, Oklahoma",58,49,9,40,50200,15.517241379310345
"Lotsee town, Oklahoma",2,2,0,40,44100,0.0
"Mannford town, Oklahoma",1348,1152,196,40,46200,14.540059347181009
"Haskell town, Oklahoma",868,704,164,40,32900,18.89400921658986
"Reydon town, Oklahoma",98,61,37,40,63100,37.755102040816325
"Healdton city, Oklahoma",1528,1087,441,40,33350,28.861256544502616
"Springer town, Oklahoma",321,251,70,40,69500,21.806853582554517
"Braman town, Oklahoma",115,88,27,40,08450,23.47826086956522
"Kildare town, Oklahoma",39,34,5,40,39800,12.82051282051282
"Bartlesville city, Oklahoma",16744,14684,2060,40,04450,12.302914476827521
"Duchess Landing CDP, Oklahoma",42,42,0,40,21760,0.0
"Yale city, Oklahoma",668,451,217,40,82500,32.48502994011976
"Hitchcock town, Oklahoma",47,26,21,40,34850,44.680851063829785
"Lawton city, Oklahoma",40391,32994,7397,40,41850,18.313485677502413
"Commerce city, Oklahoma",1002,836,166,40,16500,16.56686626746507
"Quapaw town, Oklahoma",317,270,47,40,61400,14.826498422712934
"Dripping Springs CDP, Oklahoma",18,18,0,40,21672,0.0
"Flint Creek CDP, Oklahoma",466,314,152,40,26415,32.61802575107296
"Zena CDP, Oklahoma",100,54,46,40,83050,46.0
"Cedar Crest CDP, Oklahoma",134,109,25,40,12930,18.65671641791045
"Grand Lake Towne town, Oklahoma",81,39,42,40,30900,51.85185185185185
"Wynnewood city, Oklahoma",1032,808,224,40,82400,21.705426356589147
"Red Oak town, Oklahoma",293,237,56,40,62550,19.112627986348123
"Ketchum town, Oklahoma",260,180,80,40,39550,30.76923076923077
"Welch town, Oklahoma",272,222,50,40,79750,18.38235294117647
"Snyder city, Oklahoma",712,601,111,40,68400,15.589887640449437
"Drummond town, Oklahoma",176,147,29,40,21700,16.477272727272727
"North Enid town, Oklahoma",369,361,8,40,52600,2.168021680216802
"Gotebo town, Oklahoma",128,95,33,40,30350,25.78125
"Billings town, Oklahoma",229,170,59,40,06100,25.76419213973799
"Calvin town, Oklahoma",163,94,69,40,11100,42.331288343558285
"Gerty town, Oklahoma",39,22,17,40,29150,43.58974358974359
"Wetumka city, Oklahoma",623,405,218,40,80500,34.99197431781702
"Checotah city, Oklahoma",1414,1212,202,40,13650,14.285714285714285
"Valley Park town, Oklahoma",16,15,1,40,76600,6.25
"Marland town, Oklahoma",121,102,19,40,46550,15.702479338842975
"Sequoyah CDP, Oklahoma",299,277,22,40,66450,7.357859531772576
"Eufaula city, Oklahoma",1775,1287,488,40,24650,27.492957746478876
"Cushing city, Oklahoma",3610,2769,841,40,18850,23.29639889196676
"Glencoe town, Oklahoma",290,232,58,40,29400,20.0
"Stillwater city, Oklahoma",21642,18492,3150,40,70300,14.55503188245079
"Lindsay city, Oklahoma",1447,1235,212,40,43150,14.65100207325501
"Pauls Valley city, Oklahoma",3038,2297,741,40,57550,24.391046741277155
"New Alluwe town, Oklahoma",38,24,14,40,51050,36.84210526315789
"South Coffeyville town, Oklahoma",381,305,76,40,68600,19.94750656167979
"Konawa city, Oklahoma",634,435,199,40,40200,31.38801261829653
"Lima town, Oklahoma",41,36,5,40,43000,12.195121951219512
"Elk City city, Oklahoma",5684,4158,1526,40,23500,26.84729064039409
"Spaulding town, Oklahoma",69,45,24,40,69000,34.78260869565217
"Yeager town, Oklahoma",32,19,13,40,82650,40.625
"Hanna town, Oklahoma",64,36,28,40,32350,43.75
"Ripley town, Oklahoma",139,99,40,40,63500,28.776978417266186
"Copan town, Oklahoma",391,329,62,40,17100,15.856777493606138
"Etowah town, Oklahoma",56,50,6,40,24460,10.714285714285714
"Lexington city, Oklahoma",980,826,154,40,42700,15.714285714285714
"Noble city, Oklahoma",2595,2441,154,40,52150,5.934489402697495
"Faxon town, Oklahoma",54,26,28,40,25650,51.85185185185185
"Geronimo town, Oklahoma",489,399,90,40,29100,18.404907975460123
"Medicine Park town, Oklahoma",208,136,72,40,47350,34.61538461538461
"Rosston town, Oklahoma",28,17,11,40,64050,39.285714285714285
"Byars town, Oklahoma",107,78,29,40,10550,27.102803738317753
"Purcell city, Oklahoma",2613,2439,174,40,61150,6.659012629161882
"Minco city, Oklahoma",690,622,68,40,48750,9.855072463768117
"Tuttle city, Oklahoma",2507,2335,172,40,75450,6.860789788591942
"Bearden town, Oklahoma",71,50,21,40,04700,29.577464788732392
"Clearview town, Oklahoma",34,18,16,40,15050,47.05882352941176
"Akins CDP, Oklahoma",204,179,25,40,00900,12.254901960784313
"Evening Shade CDP, Oklahoma",280,160,120,40,24762,42.857142857142854
"Notchietown CDP, Oklahoma",118,77,41,40,52862,34.74576271186441
"Kinta town, Oklahoma",134,110,24,40,39950,17.91044776119403
"Woodall CDP, Oklahoma",366,278,88,40,81912,24.043715846994534
"Butler town, Oklahoma",164,122,42,40,10450,25.609756097560975
"Pin Oak Acres CDP, Oklahoma",202,175,27,40,59175,13.366336633663368
"Sams Corner CDP, Oklahoma",112,67,45,40,65062,40.17857142857143
"Brooksville town, Oklahoma",28,21,7,40,09400,25.0
"Custer City town, Oklahoma",210,147,63,40,18950,30.0
"Talala town, Oklahoma",138,117,21,40,72200,15.217391304347828
"Gregory CDP, Oklahoma",66,55,11,40,31425,16.666666666666664
"Limestone CDP, Oklahoma",306,306,0,40,43057,0.0
"Carter town, Oklahoma",133,95,38,40,12300,28.57142857142857
"Hickory town, Oklahoma",39,37,2,40,34150,5.128205128205128
"Albion town, Oklahoma",49,33,16,40,01050,32.6530612244898
"Clayton town, Oklahoma",441,308,133,40,14900,30.158730158730158
"Woodward city, Oklahoma",5620,4638,982,40,82150,17.473309608540923
"Fairland town, Oklahoma",483,442,41,40,24900,8.488612836438923
"Tulsa city, Oklahoma",187701,164224,23477,40,75000,12.507658456800977
"Guymon city, Oklahoma",4150,3520,630,40,31750,15.180722891566264
"Atoka city, Oklahoma",1525,1253,272,40,03300,17.836065573770494
"Hendrix town, Oklahoma",47,36,11,40,33600,23.404255319148938
"Leon town, Oklahoma",55,39,16,40,42450,29.09090909090909
"Avant town, Oklahoma",153,115,38,40,03500,24.836601307189543
"Frederick city, Oklahoma",1976,1396,580,40,27800,29.352226720647774
"Catoosa city, Oklahoma",3205,2954,251,40,12900,7.831513260530422
"Keyes town, Oklahoma",237,102,135,40,39600,56.9620253164557
"Alva city, Oklahoma",2595,2041,554,40,01800,21.34874759152216
"Fort Cobb town, Oklahoma",314,246,68,40,27100,21.656050955414013
"Lookeba town, Oklahoma",69,52,17,40,44000,24.637681159420293
"Boley town, Oklahoma",131,75,56,40,07500,42.74809160305343
"Rush Springs town, Oklahoma",602,478,124,40,64300,20.59800664451827
"Verden town, Oklahoma",269,231,38,40,77000,14.12639405204461
"Pocola town, Oklahoma",1699,1508,191,40,59750,11.24190700412007
"Rock Island town, Oklahoma",323,290,33,40,63600,10.21671826625387
"Anadarko city, Oklahoma",2745,2182,563,40,02050,20.51001821493625
"Bradley town, Oklahoma",62,46,16,40,08300,25.806451612903224
"Roff town, Oklahoma",286,244,42,40,63750,14.685314685314685
"Hominy city, Oklahoma",1305,1025,280,40,35850,21.455938697318008
"Prue town, Oklahoma",219,167,52,40,60850,23.74429223744292
"Wynona town, Oklahoma",210,156,54,40,82450,25.71428571428571
"Grandfield city, Oklahoma",529,378,151,40,30850,28.544423440453688
"Garrettsville village, Ohio",1164,1082,82,39,29442,7.0446735395189
"Windham village, Ohio",922,743,179,39,85946,19.414316702819956
"Navarre village, Ohio",840,729,111,39,53690,13.214285714285715
"Florida village, Ohio",119,119,0,39,27538,0.0
"Beavercreek city, Ohio",19801,19082,719,39,04720,3.631129740922175
"Fairborn city, Ohio",15941,14559,1382,39,25914,8.669468665704787
"Bloomingdale village, Ohio",98,81,17,39,07202,17.346938775510203
"Mount Pleasant village, Ohio",208,160,48,39,52976,23.076923076923077
"Rayland village, Ohio",199,178,21,39,65662,10.552763819095476
"Richmond village, Ohio",210,176,34,39,66824,16.19047619047619
"Stratton village, Ohio",192,168,24,39,75000,12.5
"Wooster city, Ohio",12181,11065,1116,39,86548,9.161809375256546
"Wilmington city, Ohio",5904,5095,809,39,85792,13.702574525745256
"Reminderville village, Ohio",1685,1593,92,39,66152,5.459940652818991
"Carrollton village, Ohio",1540,1299,241,39,12280,15.64935064935065
"Sherrodsville village, Ohio",127,116,11,39,72242,8.661417322834646
"Orangeville village, Ohio",82,70,12,39,58674,14.634146341463413
"Orrville city, Ohio",3675,3469,206,39,58828,5.605442176870748
"Urbana city, Ohio",5537,4876,661,39,79072,11.937872494130396
"Hebron village, Ohio",1082,910,172,39,34790,15.89648798521257
"Sabina village, Ohio",1204,1044,160,39,69400,13.2890365448505
"Olde West Chester CDP, Ohio",108,88,20,39,58149,18.51851851851852
"Milledgeville village, Ohio",56,56,0,39,50316,0.0
"Octa village, Ohio",30,24,6,39,57918,20.0
"Alexandria village, Ohio",257,236,21,39,01154,8.171206225680933
"Newark city, Ohio",22640,19866,2774,39,54040,12.252650176678445
"Pataskala city, Ohio",5748,5434,314,39,61112,5.462769659011831
"Canton city, Ohio",35339,30405,4934,39,12000,13.961911768867258
"East Canton village, Ohio",642,583,59,39,23324,9.190031152647975
"Greentown CDP, Ohio",1172,1157,15,39,32298,1.2798634812286689
"Perry Heights CDP, Ohio",3905,3517,388,39,62134,9.935979513444302
"Hamler village, Ohio",299,267,32,39,33096,10.702341137123746
"Genoa village, Ohio",1010,922,88,39,29722,8.712871287128712
"Ripley village, Ohio",1077,785,292,39,67272,27.112349117920147
"Sharonville city, Ohio",6668,6298,370,39,71892,5.548890221955609
"Clay Center village, Ohio",111,97,14,39,15588,12.612612612612612
"Port Clinton city, Ohio",3545,2650,895,39,64150,25.24682651622003
"Harbor Hills CDP, Ohio",744,656,88,39,33362,11.827956989247312
"Heath city, Ohio",4498,4079,419,39,34748,9.315251222765673
"Johnstown village, Ohio",2128,1936,192,39,39340,9.022556390977442
"Tremont City village, Ohio",150,137,13,39,77308,8.666666666666668
"Wilmot village, Ohio",149,135,14,39,85806,9.395973154362416
"New Carlisle city, Ohio",2169,2040,129,39,54334,5.94744121715076
"Park Layne CDP, Ohio",1640,1517,123,39,59920,7.5
"Commercial Point village, Ohio",625,581,44,39,18070,7.04
"New Holland village, Ohio",408,345,63,39,54726,15.441176470588236
"Tarlton village, Ohio",111,93,18,39,76148,16.216216216216218
"Lakewood city, Ohio",27261,24671,2590,39,41664,9.500751990022376
"Lyndhurst city, Ohio",6597,6180,417,39,45556,6.321055025011368
"Newburgh Heights village, Ohio",1050,866,184,39,54250,17.523809523809526
"Parma city, Ohio",35866,33551,2315,39,61000,6.454580940166174
"Jeromesville village, Ohio",262,225,37,39,39060,14.122137404580155
"Polk village, Ohio",126,115,11,39,63996,8.73015873015873
"Berea city, Ohio",7552,7149,403,39,05690,5.336334745762712
"Brook Park city, Ohio",7796,7544,252,39,09288,3.23242688558235
"Fairview Park city, Ohio",7512,7154,358,39,26446,4.765708200212993
"Garfield Heights city, Ohio",13444,11656,1788,39,29428,13.29961321035406
"Pepper Pike city, Ohio",2434,2180,254,39,61686,10.435497124075596
"Shaker Heights city, Ohio",12385,11092,1293,39,71682,10.440048445700443
"Chesapeake village, Ohio",392,337,55,39,13904,14.030612244897958
"Hanging Rock village, Ohio",107,105,2,39,33194,1.8691588785046727
"Dalton village, Ohio",718,647,71,39,19974,9.88857938718663
"Sunbury village, Ohio",1862,1796,66,39,75602,3.544575725026853
"Continental village, Ohio",515,461,54,39,18504,10.485436893203884
"Sheffield Lake city, Ohio",4020,3597,423,39,72088,10.522388059701493
"Frazeysburg village, Ohio",729,651,78,39,28574,10.699588477366255
"New Concord village, Ohio",655,585,70,39,54446,10.687022900763358
"Bethel village, Ohio",1227,1080,147,39,06068,11.98044009779951
"Moscow village, Ohio",52,46,6,39,52416,11.538461538461538
"Newtonsville village, Ohio",143,132,11,39,55664,7.6923076923076925
"Chesterville village, Ohio",64,58,6,39,14114,9.375
"Barberton city, Ohio",12182,10982,1200,39,03828,9.850599244787391
"Hanover village, Ohio",438,387,51,39,33292,11.643835616438356
"Malta village, Ohio",348,298,50,39,46970,14.367816091954023
"Louisville city, Ohio",4122,3926,196,39,45094,4.754973313925278
"Waynesburg village, Ohio",369,345,24,39,82376,6.504065040650407
"Seville village, Ohio",1058,1014,44,39,71486,4.158790170132325
"Bellville village, Ohio",1081,1031,50,39,05284,4.6253469010175765
"Butler village, Ohio",352,320,32,39,10632,9.090909090909092
"Bridgeport village, Ohio",921,660,261,39,08560,28.338762214983714
"Brookside village, Ohio",335,279,56,39,09316,16.716417910447763
"Minerva Park village, Ohio",539,510,29,39,50862,5.380333951762523
"Kettering city, Ohio",27000,25042,1958,39,40040,7.251851851851852
"Lake Darby CDP, Ohio",1466,1435,31,39,41363,2.1145975443383356
"Lockbourne village, Ohio",91,69,22,39,44310,24.175824175824175
"Valleyview village, Ohio",243,217,26,39,79282,10.699588477366255
"Rutland village, Ohio",218,189,29,39,69358,13.302752293577983
"Syracuse village, Ohio",394,318,76,39,76050,19.289340101522843
"Frankfort village, Ohio",531,472,59,39,28182,11.11111111111111
"Kingston village, Ohio",514,465,49,39,40376,9.53307392996109
"New Straitsville village, Ohio",327,270,57,39,55552,17.431192660550458
"Edgerton village, Ohio",904,867,37,39,24486,4.092920353982301
"Stryker village, Ohio",453,421,32,39,75140,7.06401766004415
"Corning village, Ohio",237,155,82,39,18770,34.59915611814346
"Shawnee village, Ohio",262,161,101,39,71962,38.54961832061068
"West Union village, Ohio",1606,1377,229,39,84294,14.259028642590286
"Mifflin village, Ohio",68,61,7,39,50036,10.294117647058822
"Jerry City village, Ohio",196,187,9,39,39074,4.591836734693878
"Bluffton village, Ohio",1702,1667,35,39,07426,2.056404230317274
"Harrod village, Ohio",138,134,4,39,34118,2.898550724637681
"Barnesville village, Ohio",1645,1419,226,39,03926,13.738601823708208
"Huron city, Ohio",3690,3078,612,39,37016,16.585365853658537
"Sandusky city, Ohio",13416,10913,2503,39,70380,18.656827668455573
"Chauncey village, Ohio",516,431,85,39,13778,16.472868217054263
"Spencerville village, Ohio",880,863,17,39,74034,1.9318181818181817
"Rawson village, Ohio",202,170,32,39,65634,15.841584158415841
"Belle Valley village, Ohio",144,137,7,39,05158,4.861111111111112
"Sarahsville village, Ohio",66,56,10,39,70520,15.151515151515152
"Chatfield village, Ohio",100,91,9,39,13694,9.0
"Galion city, Ohio",4973,4290,683,39,29162,13.734164488236477
"Cheshire village, Ohio",97,78,19,39,13932,19.587628865979383
"Crown City village, Ohio",176,146,30,39,19554,17.045454545454543
"Vinton village, Ohio",130,107,23,39,80178,17.692307692307693
"Gahanna city, Ohio",13799,13351,448,39,29106,3.246612073338648
"Brownsville CDP, Ohio",84,28,56,39,09596,66.66666666666666
"Buffalo CDP, Ohio",138,124,14,39,10128,10.144927536231885
"Buford CDP, Ohio",98,72,26,39,10156,26.53061224489796
"Camp Dennison CDP, Ohio",132,132,0,39,11150,0.0
"Canal Lewisville CDP, Ohio",200,155,45,39,11318,22.5
"Candlewood Lake CDP, Ohio",386,179,207,39,11334,53.626943005181346
"Carbon Hill CDP, Ohio",121,121,0,39,12056,0.0
"Celeryville CDP, Ohio",52,52,0,39,12854,0.0
"Chippewa Park CDP, Ohio",949,404,545,39,14280,57.428872497365646
"Cinnamon Lake CDP, Ohio",461,439,22,39,15008,4.772234273318872
"Clarktown CDP, Ohio",331,243,88,39,15434,26.586102719033235
"Coldstream CDP, Ohio",482,439,43,39,16521,8.921161825726141
"Collins CDP, Ohio",261,225,36,39,16784,13.793103448275861
"Concorde Hills CDP, Ohio",268,268,0,39,18244,0.0
"Crystal Rock CDP, Ohio",78,37,41,39,19615,52.56410256410257
"Curtice CDP, Ohio",534,534,0,39,19736,0.0
"Cynthiana CDP, Ohio",0,0,0,39,19848,
"Damascus CDP, Ohio",167,167,0,39,20030,0.0
"Darbydale CDP, Ohio",360,293,67,39,20198,18.61111111111111
"Darrtown CDP, Ohio",194,194,0,39,20268,0.0
"Delhi Hills CDP, Ohio",1917,1849,68,39,21518,3.5472091810119983
"Delshire CDP, Ohio",1158,1128,30,39,21610,2.5906735751295336
"Derby CDP, Ohio",161,161,0,39,21784,0.0
"Dola CDP, Ohio",59,59,0,39,22260,0.0
"Dry Ridge CDP, Ohio",1209,1198,11,39,22660,0.9098428453267163
"Duncan Falls CDP, Ohio",432,409,23,39,22820,5.324074074074074
"Dundee CDP, Ohio",97,97,0,39,22848,0.0
"Dunlap CDP, Ohio",701,657,44,39,22960,6.276747503566334
"East Fultonham CDP, Ohio",106,106,0,39,23534,0.0
"East Liberty CDP, Ohio",154,154,0,39,23702,0.0
"East Rochester CDP, Ohio",175,118,57,39,24024,32.57142857142858
"Elizabethtown CDP, Ohio",136,128,8,39,24850,5.88235294117647
"Etna CDP, Ohio",367,328,39,39,25676,10.626702997275205
"Flat Rock CDP, Ohio",30,30,0,39,27356,0.0
"Friendship CDP, Ohio",142,92,50,39,28896,35.2112676056338
"Fort Seneca CDP, Ohio",88,88,0,39,27930,0.0
"Four Bridges CDP, Ohio",1324,1264,60,39,28058,4.531722054380665
"Fresno CDP, Ohio",86,86,0,39,28882,0.0
"Glencoe CDP, Ohio",126,51,75,39,30352,59.523809523809526
"Good Hope CDP, Ohio",127,111,16,39,30828,12.598425196850393
"Hannibal CDP, Ohio",160,160,0,39,33222,0.0
"Haydenville CDP, Ohio",147,117,30,39,34594,20.408163265306122
"Hessville CDP, Ohio",86,86,0,39,35028,0.0
"Hide-A-Way Hills CDP, Ohio",568,204,364,39,35126,64.08450704225352
"Highland Holiday CDP, Ohio",212,164,48,39,35256,22.641509433962266
"Highpoint CDP, Ohio",537,537,0,39,35322,0.0
"Hockingport CDP, Ohio",128,106,22,39,35826,17.1875
"Holiday Lakes CDP, Ohio",381,249,132,39,35866,34.645669291338585
"Homeworth CDP, Ohio",249,249,0,39,36176,0.0
"Hooven CDP, Ohio",187,175,12,39,36232,6.417112299465241
"Howard CDP, Ohio",74,33,41,39,36512,55.4054054054054
"Iberia CDP, Ohio",215,215,0,39,37142,0.0
"Kanauga CDP, Ohio",78,71,7,39,39564,8.974358974358974
"Kansas CDP, Ohio",21,11,10,39,39578,47.61904761904761
"Kidron CDP, Ohio",330,312,18,39,40096,5.454545454545454
"Kilbourne CDP, Ohio",16,16,0,39,40124,0.0
"Kimbolton CDP, Ohio",48,48,0,39,40264,0.0
"Kings Mills CDP, Ohio",620,605,15,39,40348,2.4193548387096775
"Kinsman Center CDP, Ohio",224,224,0,39,40507,0.0
"Kunkle CDP, Ohio",142,142,0,39,40978,0.0
"Lafayette CDP, Ohio",94,88,6,39,41146,6.382978723404255
"Lafferty CDP, Ohio",104,104,0,39,41188,0.0
"Lake Buckhorn CDP, Ohio",394,217,177,39,41349,44.923857868020306
"Lake Lakengren CDP, Ohio",1405,1296,109,39,41373,7.758007117437722
"Lake Lorelei CDP, Ohio",647,467,180,39,41419,27.820710973724882
"Lake Mohawk CDP, Ohio",835,702,133,39,41443,15.92814371257485
"Lake Seneca CDP, Ohio",293,255,38,39,41500,12.969283276450511
"Lakeside CDP, Ohio",1357,435,922,39,41552,67.94399410464258
"Lake Tomahawk CDP, Ohio",317,296,21,39,41597,6.624605678233439
"Lake Waynoka CDP, Ohio",691,480,211,39,41657,30.535455861070908
"Lansing CDP, Ohio",389,307,82,39,41860,21.079691516709513
"Lewistown CDP, Ohio",96,96,0,39,42966,0.0
"Little Hocking CDP, Ohio",210,210,0,39,44128,0.0
"McCutchenville CDP, Ohio",110,110,0,39,45892,0.0
"McDermott CDP, Ohio",261,240,21,39,45906,8.045977011494253
"Mack CDP, Ohio",4003,3925,78,39,46088,1.9485385960529602
"McKinley Heights CDP, Ohio",316,293,23,39,46144,7.2784810126582276
"Marne CDP, Ohio",221,221,0,39,47950,0.0
"Melmore CDP, Ohio",62,53,9,39,48972,14.516129032258066
"Miami Heights CDP, Ohio",1869,1834,35,39,49420,1.8726591760299627
"Miamitown CDP, Ohio",588,588,0,39,49462,0.0
"Sardis CDP, Ohio",374,297,77,39,70548,20.588235294117645
"Sawyerwood CDP, Ohio",754,660,94,39,70618,12.46684350132626
"Shawnee CDP, Ohio",279,279,0,39,71958,0.0
"Sixteen Mile Stand CDP, Ohio",1277,1195,82,39,72620,6.421299921691465
"Skyline Acres CDP, Ohio",815,777,38,39,72648,4.662576687116564
"Sterling CDP, Ohio",181,165,16,39,74566,8.83977900552486
"Stewart CDP, Ohio",87,87,0,39,74622,0.0
"Stockdale CDP, Ohio",19,19,0,39,74734,0.0
"Stony Ridge CDP, Ohio",223,196,27,39,74846,12.10762331838565
"Sulphur Springs CDP, Ohio",48,48,0,39,75392,0.0
"Taylor Creek CDP, Ohio",1435,1367,68,39,76197,4.7386759581881535
"Tedrow CDP, Ohio",55,52,3,39,76358,5.454545454545454
"Tuppers Plains CDP, Ohio",239,130,109,39,77812,45.60669456066946
"Thornport CDP, Ohio",567,470,97,39,76666,17.10758377425044
"Tippecanoe CDP, Ohio",67,49,18,39,76890,26.865671641791046
"Trinway CDP, Ohio",189,135,54,39,77434,28.57142857142857
"Twinsburg Heights CDP, Ohio",268,250,18,39,78078,6.7164179104477615
"Vaughnsville CDP, Ohio",110,110,0,39,79590,0.0
"Vickery CDP, Ohio",101,16,85,39,79982,84.15841584158416
"Vincent CDP, Ohio",122,106,16,39,80150,13.114754098360656
"Walnut Creek CDP, Ohio",326,326,0,39,80612,0.0
"Waterford CDP, Ohio",238,208,30,39,81760,12.605042016806722
"West Carrollton city, Ohio",6246,5812,434,39,83090,6.948447006083894
"Whites Landing CDP, Ohio",283,202,81,39,84882,28.621908127208478
"Wightmans Grove CDP, Ohio",87,29,58,39,85085,66.66666666666666
"Williamsdale CDP, Ohio",340,306,34,39,85344,10.0
"Williston CDP, Ohio",157,123,34,39,85442,21.656050955414013
"Winesburg CDP, Ohio",99,92,7,39,86072,7.07070707070707
"Wolfhurst CDP, Ohio",601,555,46,39,86282,7.653910149750416
"Miamiville CDP, Ohio",79,79,0,39,49504,0.0
"Millfield CDP, Ohio",135,135,0,39,50456,0.0
"Minford CDP, Ohio",300,255,45,39,50876,15.0
"Monfort Heights CDP, Ohio",5044,4881,163,39,51212,3.2315622521808094
"Morgandale CDP, Ohio",483,392,91,39,52178,18.84057971014493
"Neapolis CDP, Ohio",169,120,49,39,53718,28.994082840236686
"Negley CDP, Ohio",105,79,26,39,53802,24.761904761904763
"New Baltimore CDP, Ohio",354,354,0,39,54082,0.0
"New Burlington CDP, Ohio",2053,1929,124,39,54264,6.039941548952752
"New California CDP, Ohio",481,481,0,39,54320,0.0
"New Hampshire CDP, Ohio",81,70,11,39,54628,13.580246913580247
"New Haven CDP (Hamilton County), Ohio",222,222,0,39,54684,0.0
"New Haven CDP (Huron County), Ohio",147,107,40,39,54698,27.2108843537415
"New Marshfield CDP, Ohio",209,156,53,39,55062,25.358851674641148
"New Pittsburg CDP, Ohio",114,114,0,39,55244,0.0
"Newport CDP (Shelby County), Ohio",90,90,0,39,55314,0.0
"Newport CDP (Washington County), Ohio",466,399,67,39,55342,14.377682403433475
"North Lawrence CDP, Ohio",138,97,41,39,56756,29.71014492753623
"Northridge CDP, Ohio",3347,3276,71,39,56938,2.1213026590976996
"Oceola CDP, Ohio",58,31,27,39,57876,46.55172413793103
"Old Fort CDP, Ohio",87,67,20,39,58156,22.988505747126435
"Pancoastburg CDP, Ohio",57,57,0,39,59724,0.0
"Pettisville CDP, Ohio",183,183,0,39,62344,0.0
"Pheasant Run CDP, Ohio",595,498,97,39,62404,16.30252100840336
"Plainville CDP, Ohio",128,81,47,39,63072,36.71875
"Pleasant Hills CDP, Ohio",371,324,47,39,63548,12.668463611859837
"Plumwood CDP, Ohio",177,160,17,39,63758,9.6045197740113
"Pottery Addition CDP, Ohio",110,83,27,39,64472,24.545454545454547
"Pulaski CDP, Ohio",58,58,0,39,64906,0.0
"Radnor CDP, Ohio",94,94,0,39,65298,0.0
"Raymond CDP, Ohio",50,50,0,39,65676,0.0
"Remington CDP, Ohio",139,139,0,39,66180,0.0
"Reno CDP, Ohio",646,626,20,39,66250,3.0959752321981426
"Richmond Dale CDP, Ohio",138,138,0,39,66880,0.0
"Richville CDP, Ohio",1439,1330,109,39,66922,7.574704656011119
"Ridgeville Corners CDP, Ohio",235,200,35,39,67104,14.893617021276595
"Robertsville CDP, Ohio",126,90,36,39,67664,28.57142857142857
"Rockbridge CDP, Ohio",43,17,26,39,67804,60.46511627906976
"Rocky Fork Point CDP, Ohio",456,316,140,39,68004,30.701754385964914
"Rosewood CDP, Ohio",182,94,88,39,68574,48.35164835164835
"Rossmoyne CDP, Ohio",946,924,22,39,68714,2.3255813953488373
"Alvordton CDP, Ohio",89,77,12,39,01588,13.48314606741573
"Rudolph CDP, Ohio",218,218,0,39,68938,0.0
"Salem Heights CDP, Ohio",1503,1405,98,39,70050,6.520292747837658
"Sandyville CDP, Ohio",199,128,71,39,70464,35.678391959798994
"Andersonville CDP, Ohio",335,322,13,39,02022,3.880597014925373
"Apple Valley CDP, Ohio",2809,2219,590,39,02266,21.003915984336064
"Atwater CDP, Ohio",321,275,46,39,02848,14.330218068535824
"Cherry Fork CDP, Ohio",111,90,21,39,13834,18.91891891891892
"Salesville CDP, Ohio",51,50,1,39,70072,1.9607843137254901
"Somerville CDP, Ohio",137,111,26,39,72998,18.97810218978102
"Uniopolis CDP, Ohio",89,85,4,39,78848,4.49438202247191
"St. Johns CDP, Ohio",63,39,24,39,69596,38.095238095238095
"Canal Winchester city, Ohio",3072,3010,62,39,11332,2.018229166666667
"East Palestine village, Ohio",2133,1886,247,39,23940,11.579934364744492
"Germantown city, Ohio",2251,2143,108,39,29932,4.797867614393603
"Greenfield village, Ohio",2275,1989,286,39,32088,12.571428571428573
"Groveport city, Ohio",2186,2092,94,39,32606,4.300091491308326
"New Albany city, Ohio",3372,3235,137,39,53970,4.062870699881376
"St. Bernard village, Ohio",2200,1903,297,39,69470,13.5
"St. Martin CDP, Ohio",119,119,0,39,69666,0.0
"Silverton village, Ohio",2625,2329,296,39,72522,11.276190476190475
"Waterville city, Ohio",2226,2059,167,39,81858,7.502246181491465
"Waverly village, Ohio",2380,2019,361,39,81935,15.168067226890756
"Fort Shawnee CDP, Ohio",2786,2495,291,39,27944,10.44508255563532
"Connorville CDP, Ohio",100,95,5,39,18420,5.0
"East Springfield CDP, Ohio",154,154,0,39,24066,0.0
"Goshen CDP, Ohio",197,197,0,39,30996,0.0
"Lake Milton CDP, Ohio",442,335,107,39,41440,24.20814479638009
"Marlboro CDP, Ohio",143,124,19,39,47922,13.286713286713287
"Mitiwanga CDP, Ohio",377,149,228,39,50974,60.47745358090185
"Nettle Lake CDP, Ohio",359,135,224,39,53914,62.39554317548747
"Parkman CDP, Ohio",99,99,0,39,59934,0.0
"Rose Farm CDP, Ohio",87,60,27,39,68448,31.03448275862069
"Valley City CDP, Ohio",224,224,0,39,79184,0.0
"Westminster CDP, Ohio",224,170,54,39,83930,24.107142857142858
"Orient CDP, Ohio",89,82,7,39,58800,7.865168539325842
"Talihina town, Oklahoma",528,390,138,40,72250,26.136363636363637
"Weleetka town, Oklahoma",430,284,146,40,79800,33.95348837209302
"Depew town, Oklahoma",217,167,50,40,20300,23.04147465437788
"Cherry Tree CDP, Oklahoma",316,281,35,40,13775,11.075949367088606
"Forgan town, Oklahoma",257,194,63,40,26900,24.5136186770428
"Lawrence Creek town, Oklahoma",53,45,8,40,41760,15.09433962264151
"Mounds town, Oklahoma",513,412,101,40,49550,19.68810916179337
"Burns Flat town, Oklahoma",859,675,184,40,10250,21.42025611175786
"Cleo Springs town, Oklahoma",156,133,23,40,15300,14.743589743589745
"East Duke town, Oklahoma",209,155,54,40,22550,25.837320574162682
"Elmer town, Oklahoma",57,50,7,40,23550,12.280701754385964
"Ames town, Oklahoma",132,105,27,40,01950,20.454545454545457
"Canadian town, Oklahoma",78,64,14,40,11450,17.94871794871795
"Cimarron City town, Oklahoma",55,47,8,40,14500,14.545454545454545
"Beggs city, Oklahoma",653,515,138,40,05000,21.133231240428792
"Grayson town, Oklahoma",77,61,16,40,31150,20.77922077922078
"Okmulgee city, Oklahoma",5838,4535,1303,40,55150,22.319287427201097
"Schulter town, Oklahoma",214,159,55,40,65900,25.70093457943925
"Hooker city, Oklahoma",811,640,171,40,36000,21.085080147965474
"Tyrone town, Oklahoma",320,230,90,40,75750,28.125
"Wakita town, Oklahoma",223,135,88,40,77950,39.46188340807175
"Fallis town, Oklahoma",28,28,0,40,25250,0.0
"Spencer city, Oklahoma",1888,1724,164,40,69200,8.686440677966102
"Prague city, Oklahoma",1047,850,197,40,60500,18.815663801337156
"Sparks town, Oklahoma",74,55,19,40,68950,25.675675675675674
"Forest Park town, Oklahoma",502,442,60,40,26850,11.952191235059761
"Bray town, Oklahoma",484,380,104,40,08550,21.487603305785125
"Marlow city, Oklahoma",1966,1692,274,40,46600,13.936927772126145
"Meridian CDP, Oklahoma",729,639,90,40,47810,12.345679012345679
"Cedar Valley city, Oklahoma",225,208,17,40,12960,7.555555555555555
"Henryetta city, Oklahoma",2849,2274,575,40,33750,20.182520182520182
"Winchester town, Oklahoma",215,183,32,40,81575,14.883720930232558
"Watts town, Oklahoma",130,109,21,40,79100,16.153846153846153
"Warwick town, Oklahoma",82,82,0,40,78650,0.0
"Lehigh city, Oklahoma",130,110,20,40,42200,15.384615384615385
"Coyle town, Oklahoma",186,125,61,40,17950,32.795698924731184
"Marshall town, Oklahoma",123,81,42,40,46650,34.146341463414636
"Wellston town, Oklahoma",406,336,70,40,79900,17.24137931034483
"Arcadia town, Oklahoma",134,114,20,40,02550,14.925373134328357
"Del City city, Oklahoma",9908,8785,1123,40,19900,11.334275333064191
"Luther town, Oklahoma",502,465,37,40,44500,7.370517928286853
"Loco town, Oklahoma",66,51,15,40,43450,22.727272727272727
"Meridian town, Oklahoma",26,22,4,40,47800,15.384615384615385
"Optima town, Oklahoma",134,121,13,40,55850,9.701492537313433
"Alderson town, Oklahoma",124,89,35,40,01150,28.225806451612907
"Meno town, Oklahoma",76,64,12,40,47750,15.789473684210526
"Crowder town, Oklahoma",189,159,30,40,18550,15.873015873015872
"Longtown CDP, Oklahoma",2778,1338,1440,40,43975,51.83585313174947
"Lenapah town, Oklahoma",120,87,33,40,42300,27.500000000000004
"Deer Creek town, Oklahoma",92,70,22,40,19650,23.91304347826087
"Lamont town, Oklahoma",226,133,93,40,41350,41.150442477876105
"Medford city, Oklahoma",570,477,93,40,47300,16.315789473684212
"Bethany city, Oklahoma",8335,7394,941,40,05700,11.289742051589682
"Choctaw city, Oklahoma",4794,4593,201,40,14200,4.192740926157698
"Edmond city, Oklahoma",35768,33604,2164,40,23200,6.050100648624468
"Warr Acres city, Oklahoma",4071,3671,400,40,78500,9.825595676737903
"Peoria town, Oklahoma",67,55,12,40,58100,17.91044776119403
"Dibble town, Oklahoma",355,327,28,40,20650,7.887323943661972
"Afton town, Oklahoma",490,412,78,40,00600,15.918367346938775
"North Miami town, Oklahoma",165,134,31,40,52700,18.787878787878785
"Kremlin town, Oklahoma",117,106,11,40,40400,9.401709401709402
"Cooperton town, Oklahoma",9,7,2,40,17050,22.22222222222222
"Claremore city, Oklahoma",8401,7740,661,40,14700,7.868110939173908
"Foyil town, Oklahoma",137,115,22,40,27600,16.05839416058394
"Remy CDP, Oklahoma",259,250,9,40,62875,3.474903474903475
"Gould town, Oklahoma",80,58,22,40,30400,27.500000000000004
"Marietta city, Oklahoma",1070,812,258,40,46500,24.11214953271028
"Foraker town, Oklahoma",10,9,1,40,26750,10.0
"Brent CDP, Oklahoma",389,338,51,40,08650,13.110539845758353
"Redbird Smith CDP, Oklahoma",254,185,69,40,62275,27.165354330708663
"Manitou town, Oklahoma",65,53,12,40,46150,18.461538461538463
"Porter town, Oklahoma",272,243,29,40,60150,10.661764705882353
"Amorita town, Oklahoma",12,10,2,40,02000,16.666666666666664
"Kaw City city, Oklahoma",243,141,102,40,38800,41.9753086419753
"Leedey town, Oklahoma",225,168,57,40,42050,25.333333333333336
"Oakwood town, Oklahoma",32,16,16,40,53600,50.0
"Westville town, Oklahoma",755,619,136,40,80450,18.013245033112582
"Ashland town, Oklahoma",32,19,13,40,03050,40.625
"Kellyville town, Oklahoma",486,434,52,40,39000,10.699588477366255
"Clinton city, Oklahoma",3642,3102,540,40,15400,14.827018121911037
"Cromwell town, Oklahoma",119,85,34,40,18450,28.57142857142857
"Sentinel town, Oklahoma",393,329,64,40,66400,16.28498727735369
"Erin Springs town, Oklahoma",59,54,5,40,24300,8.47457627118644
"Wilburton city, Oklahoma",1244,1043,201,40,81000,16.157556270096464
"Waukomis town, Oklahoma",617,576,41,40,79200,6.645056726094004
"Vinita city, Oklahoma",2770,2213,557,40,77550,20.108303249097474
"Stidham town, Oklahoma",8,5,3,40,70200,37.5
"Ochelata town, Oklahoma",200,160,40,40,53700,20.0
"Stonewall town, Oklahoma",181,140,41,40,70500,22.65193370165746
"Canton town, Oklahoma",328,219,109,40,11600,33.23170731707317
"Greenfield town, Oklahoma",84,70,14,40,31250,16.666666666666664
"Moore city, Oklahoma",24110,22980,1130,40,49200,4.686851928660307
"Norman city, Oklahoma",52355,47135,5220,40,52500,9.970394422691243
"Buffalo town, Oklahoma",654,458,196,40,09850,29.96941896024465
"Blanchard city, Oklahoma",3301,3055,246,40,06700,7.452287185701302
"Morrison town, Oklahoma",340,311,29,40,49450,8.529411764705882
"Hardesty town, Oklahoma",111,83,28,40,32550,25.225225225225223
"Christie CDP, Oklahoma",116,61,55,40,14350,47.41379310344828
"Lyons Switch CDP, Oklahoma",124,111,13,40,44775,10.483870967741936
"Knowles town, Oklahoma",16,7,9,40,40100,56.25
"Sapulpa city, Oklahoma",8685,7784,901,40,65400,10.374208405296487
"Shamrock town, Oklahoma",51,4,47,40,66600,92.15686274509804
"Martha town, Oklahoma",79,55,24,40,46700,30.37974683544304
"Corn town, Oklahoma",245,199,46,40,17300,18.775510204081634
"Manchester town, Oklahoma",40,20,20,40,46000,50.0
"Carney town, Oklahoma",251,233,18,40,12100,7.171314741035857
"Stroud city, Oklahoma",1310,1040,270,40,71000,20.610687022900763
"Lake Aluma town, Oklahoma",33,31,2,40,40800,6.0606060606060606
"Nichols Hills city, Oklahoma",1775,1619,156,40,51800,8.788732394366198
"Velma town, Oklahoma",302,240,62,40,76900,20.52980132450331
"Coalgate city, Oklahoma",964,800,164,40,15800,17.012448132780083
"Tupelo city, Oklahoma",156,118,38,40,75050,24.358974358974358
"Texhoma town, Oklahoma",387,267,120,40,73100,31.007751937984494
"Fairfield CDP, Oklahoma",254,216,38,40,24875,14.960629921259844
"Salem CDP, Oklahoma",35,26,9,40,64875,25.71428571428571
"Gate town, Oklahoma",57,46,11,40,28800,19.298245614035086
"Oilton city, Oklahoma",473,360,113,40,54000,23.890063424947147
"Blair town, Oklahoma",390,307,83,40,06650,21.28205128205128
"Eldorado town, Oklahoma",254,185,69,40,23350,27.165354330708663
"Krebs city, Oklahoma",1062,877,185,40,40300,17.419962335216574
"Dill City town, Oklahoma",226,173,53,40,20850,23.451327433628318
"Elmore City town, Oklahoma",380,314,66,40,23600,17.36842105263158
"Pond Creek city, Oklahoma",470,409,61,40,59950,12.978723404255318
"Meeker town, Oklahoma",532,426,106,40,47450,19.924812030075188
"Fletcher town, Oklahoma",414,355,59,40,26350,14.251207729468598
"Ardmore city, Oklahoma",11102,9561,1541,40,02600,13.880381913168799
"Camargo town, Oklahoma",73,45,28,40,11150,38.35616438356164
"Grainola town, Oklahoma",17,12,5,40,30750,29.411764705882355
"Okemah city, Oklahoma",1525,1134,391,40,54200,25.639344262295083
"Scraper CDP, Oklahoma",229,143,86,40,66050,37.55458515283843
"Kemp town, Oklahoma",84,62,22,40,39050,26.190476190476193
"Mutual town, Oklahoma",46,38,8,40,50150,17.391304347826086
"Bennington town, Oklahoma",128,102,26,40,05400,20.3125
"Justice CDP, Oklahoma",561,516,45,40,38475,8.02139037433155
"Antlers city, Oklahoma",1270,1049,221,40,02250,17.401574803149604
"Sperry town, Oklahoma",571,479,92,40,69300,16.112084063047284
"Mill Creek town, Oklahoma",136,114,22,40,48500,16.176470588235293
"Mooreland town, Oklahoma",634,498,136,40,49250,21.451104100946374
"Mount Gretna Heights CDP, Pennsylvania",340,176,164,42,51576,48.23529411764706
"Amber town, Oklahoma",186,150,36,40,01900,19.35483870967742
"Holdenville city, Oklahoma",2263,1471,792,40,35400,34.99779054352629
"Beaver Meadows borough, Pennsylvania",399,351,48,42,04816,12.030075187969924
"South Temple CDP, Pennsylvania",613,597,16,42,72520,2.6101141924959217
"Bradford Woods borough, Pennsylvania",508,476,32,42,08064,6.299212598425196
"Glen Osborne borough, Pennsylvania",224,198,26,42,29732,11.607142857142858
"Aspers CDP, Pennsylvania",127,104,23,42,03312,18.11023622047244
"Forestville CDP, Pennsylvania",205,181,24,42,26704,11.707317073170733
"West Lawn CDP, Pennsylvania",745,673,72,42,83280,9.664429530201343
"Bethel Park municipality, Pennsylvania",14099,13562,537,42,06064,3.8087807645932337
"Fairview CDP, Pennsylvania",1075,1003,72,42,24856,6.6976744186046515
"Monroeville municipality, Pennsylvania",13567,12509,1058,42,50528,7.798334193263065
"Murrysville municipality, Pennsylvania",8558,8119,439,42,52432,5.129703201682636
"Rockhill borough, Pennsylvania",189,170,19,42,65496,10.052910052910052
"Temple CDP, Pennsylvania",732,633,99,42,76320,13.524590163934427
"West Fairview CDP, Pennsylvania",600,600,0,42,82920,0.0
"Prospect Park CDP, Pennsylvania",204,173,31,42,62784,15.196078431372548
"Queens Gate CDP, Pennsylvania",765,722,43,42,63116,5.620915032679739
"Ranshaw CDP, Pennsylvania",290,207,83,42,63416,28.620689655172416
"Raubsville CDP, Pennsylvania",546,465,81,42,63488,14.835164835164836
"Rauchtown CDP, Pennsylvania",265,242,23,42,63496,8.679245283018867
"Refton CDP, Pennsylvania",147,97,50,42,64032,34.01360544217687
"Rehrersburg CDP, Pennsylvania",83,83,0,42,64056,0.0
"Reinerton CDP, Pennsylvania",225,205,20,42,64104,8.88888888888889
"Fallston borough, Pennsylvania",114,100,14,42,25152,12.280701754385964
"Bryn Athyn borough, Pennsylvania",451,407,44,42,09696,9.75609756097561
"Warrior Run borough, Pennsylvania",287,244,43,42,81080,14.982578397212542
"Yardley borough, Pennsylvania",1290,1177,113,42,86920,8.759689922480622
"South Renovo borough, Pennsylvania",251,182,69,42,72448,27.490039840637447
"Wayne Heights CDP, Pennsylvania",1142,991,151,42,81808,13.222416812609458
"Middleport borough, Pennsylvania",244,197,47,42,49048,19.262295081967213
"Oneida CDP, Pennsylvania",64,55,9,42,56816,14.0625
"Palo Alto borough, Pennsylvania",452,384,68,42,57752,15.04424778761062
"Tamaqua borough, Pennsylvania",3621,3051,570,42,76032,15.741507870753935
"Edgewood CDP, Pennsylvania",1259,1072,187,42,22528,14.853057982525813
"Marion Heights borough, Pennsylvania",326,278,48,42,47480,14.723926380368098
"Northumberland borough, Pennsylvania",1871,1631,240,42,55456,12.82736504543025
"Shamokin city, Pennsylvania",4845,3327,1518,42,69600,31.331269349845204
"Snydertown borough, Pennsylvania",177,156,21,42,71688,11.864406779661017
"Watsontown borough, Pennsylvania",1210,1107,103,42,81616,8.512396694214877
"Bowmanstown borough, Pennsylvania",491,435,56,42,07880,11.405295315682281
"Palmerton borough, Pennsylvania",2254,1983,271,42,57696,12.02307009760426
"Parryville borough, Pennsylvania",287,196,91,42,58304,31.70731707317073
"Weatherly borough, Pennsylvania",1064,947,117,42,81856,10.996240601503759
"Boalsburg CDP, Pennsylvania",1898,1780,118,42,07368,6.217070600632244
"Coburn CDP, Pennsylvania",70,40,30,42,14760,42.857142857142854
"Highland Park CDP, Pennsylvania",590,522,68,42,34592,11.525423728813559
"Juniata Terrace borough, Pennsylvania",223,203,20,42,38640,8.968609865470851
"Franklin city, Pennsylvania",3354,2797,557,42,27456,16.607036374478234
"Johnstown city, Pennsylvania",12313,9564,2749,42,38288,22.325996913830913
"Wilmore borough, Pennsylvania",93,82,11,42,85528,11.827956989247312
"Nuangola borough, Pennsylvania",414,301,113,42,55752,27.294685990338163
"Yatesville borough, Pennsylvania",244,217,27,42,86952,11.065573770491802
"Forty Fort borough, Pennsylvania",2037,1808,229,42,26880,11.242022582228769
"Galeton borough, Pennsylvania",625,462,163,42,28280,26.08
"Franklin Park borough, Pennsylvania",5491,5292,199,42,27552,3.6241121835731196
"Middletown CDP, Pennsylvania",2962,2837,125,42,49144,4.2201215395003375
"Midway borough, Pennsylvania",377,332,45,42,49240,11.936339522546419
"Centerville borough (Crawford County), Pennsylvania",107,93,14,42,12184,13.084112149532709
"Ford City borough, Pennsylvania",1591,1282,309,42,26512,19.421747328724074
"McSherrystown borough, Pennsylvania",1396,1345,51,42,46376,3.6532951289398286
"Geistown borough, Pennsylvania",1181,1081,100,42,28720,8.46740050804403
"Penn Lake Park borough, Pennsylvania",226,126,100,42,59054,44.24778761061947
"Hop Bottom borough, Pennsylvania",146,126,20,42,35624,13.698630136986301
"Mohnton borough, Pennsylvania",1197,1175,22,42,50272,1.8379281537176273
"Crafton borough, Pennsylvania",3009,2687,322,42,16848,10.701229644400133
"Sharon Hill borough, Pennsylvania",2299,2117,182,42,69752,7.916485428447151
"Canonsburg borough, Pennsylvania",4313,3922,391,42,11152,9.065615580802227
"Twilight borough, Pennsylvania",106,81,25,42,78008,23.58490566037736
"Ellport borough, Pennsylvania",501,465,36,42,23280,7.18562874251497
"Altoona city, Pennsylvania",20903,18742,2161,42,02184,10.338228962349902
"Norwood borough, Pennsylvania",2238,2055,183,42,55664,8.176943699731904
"East Berlin borough, Pennsylvania",673,650,23,42,20792,3.4175334323922733
"Colonial Park CDP, Pennsylvania",6053,5773,280,42,15328,4.6258053857591275
"Allentown city, Pennsylvania",45749,42151,3598,42,02000,7.864652779295723
"Homeacre-Lyndora CDP, Pennsylvania",3374,3109,265,42,35364,7.854179016004742
"Bessemer borough, Pennsylvania",581,490,91,42,05936,15.66265060240964
"Hummelstown borough, Pennsylvania",2227,2142,85,42,36232,3.816793893129771
"Venango borough, Pennsylvania",110,104,6,42,79912,5.454545454545454
"Old Forge borough, Pennsylvania",4261,3702,559,42,56576,13.118986153485098
"Belfast CDP, Pennsylvania",525,486,39,42,05152,7.428571428571429
"Daisytown borough, Pennsylvania",163,149,14,42,17976,8.588957055214724
"Kennett Square borough, Pennsylvania",2243,2095,148,42,39352,6.5983058403923325
"East Uniontown CDP, Pennsylvania",1267,1064,203,42,21960,16.022099447513813
"South Coatesville borough, Pennsylvania",598,546,52,42,72072,8.695652173913043
"Parker city, Pennsylvania",350,292,58,42,57976,16.57142857142857
"South Pottstown CDP, Pennsylvania",1131,1018,113,42,72432,9.991158267020337
"Shippensburg borough, Pennsylvania",3110,2777,333,42,70352,10.707395498392284
"Glenfield borough, Pennsylvania",97,80,17,42,29592,17.525773195876287
"Plum borough, Pennsylvania",11956,11387,569,42,61536,4.759116761458682
"Kutztown borough, Pennsylvania",2555,2122,433,42,40656,16.947162426614483
"Wilson borough, Pennsylvania",3456,2980,476,42,85592,13.773148148148149
"Ridgway borough, Pennsylvania",2061,1821,240,42,64784,11.644832605531295
"Brookville borough, Pennsylvania",1873,1702,171,42,09224,9.129738387613456
"Eastlawn Gardens CDP, Pennsylvania",1187,1187,0,42,21400,0.0
"Honey Brook borough, Pennsylvania",749,711,38,42,35528,5.07343124165554
"Thorndale CDP, Pennsylvania",1636,1623,13,42,76584,0.7946210268948656
"Williamsburg borough, Pennsylvania",542,464,78,42,85272,14.391143911439114
"Herndon borough, Pennsylvania",170,145,25,42,34080,14.705882352941178
"Lake Heritage CDP, Pennsylvania",1018,997,21,42,40981,2.06286836935167
"Midway CDP, Pennsylvania",935,924,11,42,49224,1.1764705882352942
"Orrtanna CDP, Pennsylvania",84,66,18,42,57120,21.428571428571427
"Clifton Heights borough, Pennsylvania",3072,2770,302,42,14264,9.830729166666668
"Folsom CDP, Pennsylvania",3178,3091,87,42,26432,2.737570799244808
"Linwood CDP, Pennsylvania",1240,1114,126,42,43720,10.161290322580644
"Rutledge borough, Pennsylvania",307,280,27,42,66928,8.794788273615636
"Hartleton borough, Pennsylvania",103,97,6,42,32936,5.825242718446602
"Nescopeck borough, Pennsylvania",791,690,101,42,52984,12.76864728192162
"West Wyoming borough, Pennsylvania",1239,1125,114,42,84272,9.200968523002421
"Luzerne borough, Pennsylvania",1773,1440,333,42,45568,18.781725888324875
"Nanticoke city, Pennsylvania",5321,4522,799,42,52584,15.015974440894569
"Hasson Heights CDP, Pennsylvania",662,611,51,42,33072,7.7039274924471295
"Polk borough, Pennsylvania",247,210,37,42,61936,14.979757085020243
"Woodbourne CDP, Pennsylvania",1501,1415,86,42,86112,5.7295136575616255
"Mifflin borough, Pennsylvania",260,226,34,42,49272,13.076923076923078
"Clymer borough, Pennsylvania",638,534,104,42,14520,16.30094043887147
"Saltsburg borough, Pennsylvania",423,349,74,42,67648,17.494089834515368
"Conyngham borough, Pennsylvania",899,858,41,42,15888,4.560622914349278
"Crabtree CDP, Pennsylvania",115,64,51,42,16816,44.34782608695652
"Hyde Park borough, Pennsylvania",252,236,16,42,36592,6.349206349206349
"Laurel Mountain borough, Pennsylvania",107,77,30,42,41834,28.037383177570092
"Manor borough, Pennsylvania",1289,1224,65,42,47000,5.04266873545384
"Sharpsville borough, Pennsylvania",2075,1840,235,42,69800,11.325301204819278
"Enon Valley borough, Pennsylvania",139,133,6,42,23768,4.316546762589928
"Houston borough, Pennsylvania",671,629,42,42,35896,6.259314456035768
"North Charleroi borough, Pennsylvania",713,568,145,42,54888,20.336605890603085
"Washington city, Pennsylvania",6813,5691,1122,42,81328,16.468516072214882
"Boiling Springs CDP, Pennsylvania",1383,1279,104,42,07472,7.519884309472162
"Lemoyne borough, Pennsylvania",2478,2271,207,42,42648,8.353510895883778
"Portage borough, Pennsylvania",1301,1127,174,42,62048,13.37432744043044
"Quakertown borough, Pennsylvania",3802,3612,190,42,63048,4.997369805365597
"Elim CDP, Pennsylvania",1665,1454,211,42,22976,12.672672672672672
"Lorain borough, Pennsylvania",403,337,66,42,44664,16.377171215880892
"Nanty-Glo borough, Pennsylvania",1310,1134,176,42,52616,13.435114503816795
"Johnsonburg borough, Pennsylvania",1263,1062,201,42,38248,15.914489311163896
"Sellersville borough, Pennsylvania",1776,1645,131,42,69248,7.376126126126126
"McAlisterville CDP, Pennsylvania",485,383,102,42,45848,21.030927835051546
"New Oxford borough, Pennsylvania",879,767,112,42,53920,12.741751990898747
"East Lansdowne borough, Pennsylvania",1001,872,129,42,21384,12.887112887112886
"Seneca CDP, Pennsylvania",543,512,31,42,69272,5.70902394106814
"Dupont borough, Pennsylvania",1384,1197,187,42,20424,13.51156069364162
"Howard borough, Pennsylvania",287,256,31,42,35960,10.801393728222997
"South Williamsport borough, Pennsylvania",2898,2622,276,42,72648,9.523809523809524
"Shade Gap borough, Pennsylvania",43,33,10,42,69456,23.25581395348837
"Telford borough, Pennsylvania",1967,1897,70,42,76304,3.558718861209965
"McMurray CDP, Pennsylvania",1594,1560,34,42,46344,2.132998745294856
"Bangor borough, Pennsylvania",2298,2020,278,42,04032,12.097476066144473
"Westfield borough, Pennsylvania",509,455,54,42,82968,10.609037328094303
"Emlenton borough, Pennsylvania",348,311,37,42,23568,10.632183908045976
"Glasgow borough, Pennsylvania",36,32,4,42,29392,11.11111111111111
"Collegeville borough, Pennsylvania",1346,1302,44,42,15192,3.268945022288262
"Donegal borough, Pennsylvania",97,81,16,42,19472,16.49484536082474
"Baden borough, Pennsylvania",1990,1811,179,42,03736,8.99497487437186
"Burgettstown borough, Pennsylvania",666,582,84,42,10224,12.612612612612612
"Farrell city, Pennsylvania",2620,2093,527,42,25360,20.114503816793892
"Bruin borough, Pennsylvania",241,198,43,42,09528,17.842323651452283
"New Columbus borough, Pennsylvania",107,79,28,42,53448,26.168224299065418
"Carnegie borough, Pennsylvania",4252,3891,361,42,11336,8.490122295390405
"Garrett borough, Pennsylvania",200,166,34,42,28520,17.0
"Falls Creek borough, Pennsylvania",497,432,65,42,25136,13.078470824949697
"Mount Oliver borough, Pennsylvania",1823,1395,428,42,51744,23.477783872737245
"Reinholds CDP, Pennsylvania",796,769,27,42,64112,3.391959798994975
"South Bethlehem borough, Pennsylvania",211,190,21,42,71976,9.95260663507109
"Jamestown borough, Pennsylvania",322,289,33,42,37696,10.248447204968944
"Cherry Valley borough, Pennsylvania",34,30,4,42,13152,11.76470588235294
"Rennerdale CDP, Pennsylvania",490,490,0,42,64184,0.0
"Revloc CDP, Pennsylvania",252,209,43,42,64288,17.063492063492063
"Rew CDP, Pennsylvania",111,86,25,42,64296,22.52252252252252
"Reynolds Heights CDP, Pennsylvania",767,716,51,42,64368,6.6492829204693615
"Riverside CDP, Pennsylvania",140,140,0,42,65088,0.0
"Riverview Park CDP, Pennsylvania",1243,1100,143,42,65192,11.504424778761061
"Robinson CDP, Pennsylvania",248,217,31,42,65360,12.5
"Rogersville CDP, Pennsylvania",106,106,0,42,65848,0.0
"Ronco CDP, Pennsylvania",92,92,0,42,65976,0.0
"Ronks CDP, Pennsylvania",57,57,0,42,65984,0.0
"Rote CDP, Pennsylvania",250,234,16,42,66384,6.4
"Roulette CDP, Pennsylvania",422,319,103,42,66408,24.407582938388625
"Rowes Run CDP, Pennsylvania",258,239,19,42,66472,7.3643410852713185
"Russell CDP, Pennsylvania",698,612,86,42,66808,12.320916905444127
"St. Michael CDP, Pennsylvania",298,171,127,42,67352,42.61744966442953
"St. Vincent College CDP, Pennsylvania",0,0,0,42,67416,
"Salix CDP, Pennsylvania",558,510,48,42,67608,8.60215053763441
"Salunga CDP, Pennsylvania",1266,1226,40,42,67656,3.15955766192733
"Saw Creek CDP, Pennsylvania",2952,1575,1377,42,68036,46.646341463414636
"Saylorsburg CDP, Pennsylvania",416,239,177,42,68088,42.54807692307692
"Schoeneck CDP, Pennsylvania",394,394,0,42,68200,0.0
"Schubert CDP, Pennsylvania",101,101,0,42,68248,0.0
"Scotland CDP, Pennsylvania",465,357,108,42,68376,23.225806451612904
"Shartlesville CDP, Pennsylvania",269,244,25,42,69816,9.293680297397769
"Shavertown CDP, Pennsylvania",975,975,0,42,69832,0.0
"Sheatown CDP, Pennsylvania",330,260,70,42,69952,21.21212121212121
"Shippensburg University CDP, Pennsylvania",91,65,26,42,70362,28.57142857142857
"Sidman CDP, Pennsylvania",182,167,15,42,70640,8.241758241758241
"Sierra View CDP, Pennsylvania",2007,1603,404,42,70652,20.12954658694569
"Siglerville CDP, Pennsylvania",77,77,0,42,70664,0.0
"Silkworth CDP, Pennsylvania",486,361,125,42,70704,25.720164609053498
"Simpson CDP, Pennsylvania",692,534,158,42,70840,22.832369942196532
"Slatedale CDP, Pennsylvania",231,231,0,42,71080,0.0
"Slippery Rock University CDP, Pennsylvania",4,4,0,42,71210,0.0
"Slovan CDP, Pennsylvania",287,167,120,42,71232,41.81184668989547
"Smock CDP, Pennsylvania",251,251,0,42,71456,0.0
"Smoketown CDP, Pennsylvania",109,109,0,42,71504,0.0
"Soudersburg CDP, Pennsylvania",237,237,0,42,71848,0.0
"South Philipsburg CDP, Pennsylvania",138,138,0,42,72416,0.0
"South Uniontown CDP, Pennsylvania",722,651,71,42,72552,9.833795013850416
"Southview CDP, Pennsylvania",147,117,30,42,72576,20.408163265306122
"Spinnerstown CDP, Pennsylvania",642,642,0,42,72768,0.0
"Springmont CDP, Pennsylvania",304,268,36,42,73296,11.842105263157894
"Starbrick CDP, Pennsylvania",259,223,36,42,73704,13.8996138996139
"Star Junction CDP, Pennsylvania",245,164,81,42,73720,33.06122448979592
"State Line CDP, Pennsylvania",873,776,97,42,73848,11.11111111111111
"Stevens CDP, Pennsylvania",204,204,0,42,74040,0.0
"Stiles CDP, Pennsylvania",458,458,0,42,74160,0.0
"Stonerstown CDP, Pennsylvania",203,166,37,42,74360,18.226600985221676
"Stonybrook CDP, Pennsylvania",885,885,0,42,74416,0.0
"Stony Creek Mills CDP, Pennsylvania",390,354,36,42,74448,9.230769230769232
"Sturgeon CDP, Pennsylvania",699,649,50,42,74944,7.1530758226037205
"Stouchsburg CDP, Pennsylvania",199,175,24,42,74568,12.060301507537687
"Strodes Mills CDP, Pennsylvania",373,362,11,42,74848,2.949061662198391
"Strong CDP, Pennsylvania",0,0,0,42,74864,
"Sunrise Lake CDP, Pennsylvania",580,360,220,42,75381,37.93103448275862
"Sun Valley CDP, Pennsylvania",829,655,174,42,75432,20.989143546441497
"Swartzville CDP, Pennsylvania",872,872,0,42,75664,0.0
"Sweden Valley CDP, Pennsylvania",103,71,32,42,75728,31.06796116504854
"Table Rock CDP, Pennsylvania",25,25,0,42,75968,0.0
"Taylorstown CDP, Pennsylvania",73,68,5,42,76232,6.8493150684931505
"Templeton CDP, Pennsylvania",139,116,23,42,76336,16.546762589928058
"Tharptown (Uniontown) CDP, Pennsylvania",258,232,26,42,76432,10.077519379844961
"The Hideout CDP, Pennsylvania",3487,569,2918,42,76440,83.68224835101806
"Toftrees CDP, Pennsylvania",1889,1636,253,42,77016,13.39332980412917
"Towamensing Trails CDP, Pennsylvania",2286,788,1498,42,77163,65.52930883639544
"Trevose CDP, Pennsylvania",1360,1315,45,42,77456,3.308823529411765
"Trexlertown CDP, Pennsylvania",1059,955,104,42,77488,9.820585457979226
"Trucksville CDP, Pennsylvania",833,787,46,42,77656,5.5222088835534215
"Tyler Run CDP, Pennsylvania",939,810,129,42,78115,13.738019169329075
"Tylersburg CDP, Pennsylvania",45,37,8,42,78120,17.77777777777778
"Union Deposit CDP, Pennsylvania",142,142,0,42,78472,0.0
"Unionville CDP, Pennsylvania",492,428,64,42,78608,13.008130081300814
"University of Pittsburgh Johnstown CDP, Pennsylvania",0,0,0,42,78700,
"Upper Exeter CDP, Pennsylvania",309,280,29,42,79016,9.385113268608414
"Van Voorhis CDP, Pennsylvania",82,82,0,42,79872,0.0
"Vicksburg CDP, Pennsylvania",180,180,0,42,80144,0.0
"Virginville CDP, Pennsylvania",166,119,47,42,80336,28.313253012048197
"Vowinckel CDP, Pennsylvania",82,44,38,42,80384,46.34146341463415
"Strausstown CDP, Pennsylvania",160,135,25,42,74744,15.625
"Aaronsburg CDP (Centre County), Pennsylvania",253,218,35,42,00100,13.83399209486166
"Aaronsburg CDP (Washington County), Pennsylvania",47,47,0,42,00104,0.0
"Ackermanville CDP, Pennsylvania",230,230,0,42,00244,0.0
"Albrightsville CDP, Pennsylvania",67,59,8,42,00652,11.940298507462686
"Alfarata CDP, Pennsylvania",99,91,8,42,00764,8.080808080808081
"Alleghenyville CDP, Pennsylvania",408,387,21,42,00924,5.147058823529411
"Allenport CDP, Pennsylvania",320,280,40,42,00980,12.5
"Allensville CDP, Pennsylvania",168,145,23,42,01004,13.690476190476192
"Allenwood CDP, Pennsylvania",158,152,6,42,02016,3.79746835443038
"Allison CDP, Pennsylvania",372,240,132,42,02040,35.483870967741936
"Allison Park CDP, Pennsylvania",9353,9093,260,42,02056,2.7798567304608146
"Allport CDP, Pennsylvania",133,133,0,42,02072,0.0
"Alsace Manor CDP, Pennsylvania",200,200,0,42,02128,0.0
"Arcadia University CDP, Pennsylvania",0,0,0,42,02826,
"Arnold City CDP, Pennsylvania",298,218,80,42,03096,26.845637583892618
"Arnot CDP, Pennsylvania",188,143,45,42,03104,23.93617021276596
"Atkinson Mills CDP, Pennsylvania",49,44,5,42,03424,10.204081632653061
"Atlas CDP, Pennsylvania",519,456,63,42,03464,12.138728323699421
"Atlasburg CDP, Pennsylvania",195,140,55,42,03472,28.205128205128204
"Avella CDP, Pennsylvania",388,327,61,42,03616,15.721649484536082
"Baileyville CDP, Pennsylvania",71,71,0,42,03792,0.0
"Bainbridge CDP, Pennsylvania",603,585,18,42,03800,2.9850746268656714
"Bairdford CDP, Pennsylvania",399,399,0,42,03816,0.0
"Bakerstown CDP, Pennsylvania",1113,1069,44,42,03864,3.9532794249775383
"Barrville CDP, Pennsylvania",89,76,13,42,04344,14.606741573033707
"Baumstown CDP, Pennsylvania",205,205,0,42,04488,0.0
"Berwyn CDP, Pennsylvania",1555,1324,231,42,05904,14.855305466237942
"Bear Rocks CDP, Pennsylvania",462,410,52,42,04616,11.255411255411255
"Beaverdale CDP, Pennsylvania",489,359,130,42,04768,26.58486707566462
"Beech Mountain Lakes CDP, Pennsylvania",1047,838,209,42,05028,19.961795606494746
"Bethel CDP, Pennsylvania",211,211,0,42,06000,0.0
"Big Bass Lake CDP, Pennsylvania",1264,492,772,42,06236,61.07594936708861
"Bigler CDP, Pennsylvania",145,145,0,42,06280,0.0
"Birchwood Lakes CDP, Pennsylvania",842,438,404,42,06490,47.980997624703086
"Bird-in-Hand CDP, Pennsylvania",259,155,104,42,06496,40.15444015444015
"Blandburg CDP, Pennsylvania",157,142,15,42,06976,9.554140127388536
"Blandon CDP, Pennsylvania",3045,3019,26,42,06984,0.8538587848932676
"Wagner CDP, Pennsylvania",69,63,6,42,80432,8.695652173913043
"Wakefield CDP, Pennsylvania",181,165,16,42,80480,8.83977900552486
"Wallenpaupack Lake Estates CDP, Pennsylvania",1497,521,976,42,80652,65.19706078824315
"Walnuttown CDP, Pennsylvania",287,269,18,42,80808,6.2717770034843205
"Wanamie CDP, Pennsylvania",243,213,30,42,80896,12.345679012345679
"Washington Boro CDP, Pennsylvania",308,308,0,42,81360,0.0
"Waverly CDP, Pennsylvania",280,252,28,42,81664,10.0
"Webster CDP, Pennsylvania",112,53,59,42,81936,52.67857142857143
"Weedville CDP, Pennsylvania",301,238,63,42,81960,20.930232558139537
"Wescosville CDP, Pennsylvania",2489,2404,85,42,82320,3.4150261149055847
"West Alexander CDP, Pennsylvania",198,162,36,42,82376,18.181818181818183
"West Decatur CDP, Pennsylvania",254,203,51,42,82792,20.078740157480315
"West Falls CDP, Pennsylvania",223,173,50,42,82952,22.421524663677133
"Great Bend borough, Pennsylvania",426,387,39,42,30728,9.15492957746479
"Stockertown borough, Pennsylvania",429,399,30,42,74232,6.993006993006993
"East Brady borough, Pennsylvania",530,436,94,42,20840,17.735849056603772
"Flemington borough, Pennsylvania",638,596,42,42,26296,6.583072100313479
"Brownstown borough, Pennsylvania",367,350,17,42,09400,4.632152588555858
"Ferndale borough, Pennsylvania",783,676,107,42,25680,13.665389527458494
"Scalp Level borough, Pennsylvania",375,339,36,42,68104,9.6
"Burnside borough, Pennsylvania",109,93,16,42,10280,14.678899082568808
"Curwensville borough, Pennsylvania",1209,1059,150,42,17840,12.40694789081886
"Newburg borough (Clearfield County), Pennsylvania",39,29,10,42,53336,25.64102564102564
"Ramey borough, Pennsylvania",208,172,36,42,63360,17.307692307692307
"Royersford borough, Pennsylvania",2322,2182,140,42,66576,6.029285099052541
"Sanatoga CDP, Pennsylvania",3554,3295,259,42,67712,7.287563308947664
"Malvern borough, Pennsylvania",1547,1516,31,42,46792,2.0038784744667097
"Modena borough, Pennsylvania",303,270,33,42,50232,10.891089108910892
"Patterson Heights borough, Pennsylvania",258,224,34,42,58384,13.178294573643413
"Shippingport borough, Pennsylvania",83,65,18,42,70376,21.686746987951807
"Dunbar borough, Pennsylvania",537,470,67,42,20216,12.476722532588454
"Corry city, Pennsylvania",2869,2672,197,42,16296,6.866504008365284
"Waterford borough, Pennsylvania",672,600,72,42,81456,10.714285714285714
"Exton CDP, Pennsylvania",2215,2100,115,42,24440,5.191873589164786
"Schaefferstown CDP, Pennsylvania",433,380,53,42,68144,12.240184757505773
"Buffington CDP, Pennsylvania",86,49,37,42,10096,43.02325581395349
"Bulger CDP, Pennsylvania",174,174,0,42,10128,0.0
"Byrnedale CDP, Pennsylvania",231,205,26,42,10600,11.255411255411255
"Cairnbrook CDP, Pennsylvania",249,249,0,42,10720,0.0
"Caln CDP, Pennsylvania",604,556,48,42,10816,7.9470198675496695
"Calumet CDP, Pennsylvania",729,627,102,42,10832,13.991769547325102
"Cashtown CDP, Pennsylvania",92,92,0,42,11576,0.0
"Cedar Crest CDP, Pennsylvania",135,116,19,42,11836,14.074074074074074
"Cementon CDP, Pennsylvania",679,679,0,42,11976,0.0
"Chewton CDP, Pennsylvania",221,190,31,42,13408,14.027149321266968
"Chalkhill CDP, Pennsylvania",80,80,0,42,12512,0.0
"Chase CDP, Pennsylvania",395,345,50,42,12864,12.658227848101266
"Cherryville CDP, Pennsylvania",659,659,0,42,13168,0.0
"Cheyney University CDP, Pennsylvania",0,0,0,42,13418,
"Chinchilla CDP, Pennsylvania",1049,924,125,42,13480,11.916110581506196
"Church Hill CDP, Pennsylvania",740,723,17,42,13596,2.2972972972972974
"Churchtown CDP, Pennsylvania",165,165,0,42,13632,0.0
"Clay CDP, Pennsylvania",697,697,0,42,13952,0.0
"Clinton CDP, Pennsylvania",424,278,146,42,14296,34.43396226415094
"Cochranville CDP, Pennsylvania",295,286,9,42,14808,3.050847457627119
"Collinsburg CDP, Pennsylvania",493,493,0,42,15248,0.0
"Riceville CDP, Pennsylvania",14,14,0,42,64440,0.0
"Susquehanna Depot borough, Pennsylvania",779,637,142,42,75568,18.22849807445443
"Clarendon borough, Pennsylvania",199,164,35,42,13776,17.587939698492463
"Canadohta Lake CDP, Pennsylvania",1029,263,766,42,11072,74.44120505344995
"Meadowood CDP, Pennsylvania",1148,1116,32,42,48336,2.7874564459930316
"Greensboro borough, Pennsylvania",143,119,24,42,31192,16.783216783216783
"Kratzerville CDP, Pennsylvania",151,148,3,42,40432,1.9867549668874174
"Sandy Lake borough, Pennsylvania",303,270,33,42,67848,10.891089108910892
"New Castle city, Pennsylvania",11467,9817,1650,42,53368,14.389116595447806
"Chest Springs borough, Pennsylvania",69,53,16,42,13384,23.18840579710145
"St. Marys city, Pennsylvania",5997,5669,328,42,67344,5.469401367350342
"South Park Township CDP, Pennsylvania",5850,5549,301,42,72403,5.145299145299146
"Tipton CDP, Pennsylvania",582,582,0,42,76880,0.0
"Norristown borough, Pennsylvania",14439,12614,1825,42,54656,12.639379458411248
"Stormstown CDP, Pennsylvania",829,829,0,42,74544,0.0
"Mexico CDP, Pennsylvania",163,136,27,42,48904,16.56441717791411
"Blairsville borough, Pennsylvania",1710,1531,179,42,06904,10.46783625730994
"Dicksonville CDP, Pennsylvania",207,207,0,42,19161,0.0
"Sandy CDP, Pennsylvania",768,631,137,42,67784,17.838541666666664
"Chalfont borough, Pennsylvania",1661,1612,49,42,12504,2.9500301023479834
"Hulmeville borough, Pennsylvania",370,348,22,42,36192,5.9459459459459465
"Ivyland borough, Pennsylvania",339,332,7,42,37304,2.0648967551622417
"Richboro CDP, Pennsylvania",2285,2222,63,42,64464,2.7571115973741795
"Thompsontown borough, Pennsylvania",404,382,22,42,76536,5.445544554455446
"Indiana borough, Pennsylvania",4939,4038,901,42,36816,18.24255922251468
"Duryea borough, Pennsylvania",2250,2061,189,42,20512,8.4
"East Berwick CDP, Pennsylvania",1013,975,38,42,20800,3.751233958538993
"Exeter borough, Pennsylvania",2542,2280,262,42,24392,10.30684500393391
"Glen Lyon CDP, Pennsylvania",1032,753,279,42,29680,27.03488372093023
"Pittston city, Pennsylvania",4071,3352,719,42,61048,17.66150822893638
"Swoyersville borough, Pennsylvania",2535,2238,297,42,75832,11.715976331360947
"White Haven borough, Pennsylvania",567,485,82,42,84552,14.462081128747794
"Little Meadows borough, Pennsylvania",126,90,36,42,43928,28.57142857142857
"Thompson borough, Pennsylvania",163,126,37,42,76496,22.699386503067483
"Oil City city, Pennsylvania",5026,4240,786,42,56456,15.63867886987664
"Sugarcreek borough, Pennsylvania",2551,2276,275,42,75000,10.780086240689926
"Utica borough, Pennsylvania",114,76,38,42,79472,33.33333333333333
"Schlusser CDP, Pennsylvania",2126,2088,38,42,68188,1.7873941674506115
"Butler city, Pennsylvania",6855,5853,1002,42,10464,14.61706783369803
"Callery borough, Pennsylvania",197,182,15,42,10800,7.614213197969544
"East Butler borough, Pennsylvania",354,330,24,42,20904,6.779661016949152
"Mars borough, Pennsylvania",753,683,70,42,47672,9.296148738379815
"Eddystone borough, Pennsylvania",958,809,149,42,22296,15.553235908141962
"Shinglehouse borough, Pennsylvania",498,407,91,42,70304,18.27309236947791
"Prospect Park borough, Pennsylvania",2929,2665,264,42,62792,9.013315124615911
"Rose Valley borough, Pennsylvania",353,353,0,42,66192,0.0
"Village Green-Green Ridge CDP, Pennsylvania",3209,3127,82,42,80218,2.5553131816765347
"Bridgeville borough, Pennsylvania",2684,2556,128,42,08624,4.769001490312966
"Dravosburg borough, Pennsylvania",1036,909,127,42,19856,12.258687258687258
"Edgeworth borough, Pennsylvania",671,599,72,42,22576,10.730253353204173
"Glassport borough, Pennsylvania",2528,2097,431,42,29432,17.049050632911392
"Heidelberg borough, Pennsylvania",677,627,50,42,33592,7.385524372230429
"Liberty borough (Allegheny County), Pennsylvania",1182,1143,39,42,43064,3.2994923857868024
"Verona borough, Pennsylvania",1336,1239,97,42,80032,7.260479041916168
"West Elizabeth borough, Pennsylvania",214,162,52,42,82848,24.299065420560748
"Benson borough, Pennsylvania",84,76,8,42,05648,9.523809523809524
"Blain borough, Pennsylvania",104,92,12,42,06824,11.538461538461538
"Bloomfield borough, Pennsylvania",559,516,43,42,07040,7.6923076923076925
"New Buffalo borough, Pennsylvania",62,55,7,42,53320,11.29032258064516
"Westover borough, Pennsylvania",164,147,17,42,83736,10.365853658536585
"West Hamburg CDP, Pennsylvania",743,743,0,42,83120,0.0
"Westland CDP, Pennsylvania",84,57,27,42,83272,32.142857142857146
"West Milton CDP, Pennsylvania",500,500,0,42,83520,0.0
"West Nanticoke CDP, Pennsylvania",349,281,68,42,83656,19.484240687679083
"Weston CDP, Pennsylvania",146,146,0,42,83720,0.0
"West Pittsburg CDP, Pennsylvania",368,360,8,42,83848,2.1739130434782608
"West Waynesburg CDP, Pennsylvania",185,185,0,42,84176,0.0
"Westwood CDP, Pennsylvania",332,303,29,42,84248,8.734939759036145
"White Mills CDP, Pennsylvania",350,296,54,42,84696,15.428571428571427
"Wiconsico CDP, Pennsylvania",452,332,120,42,84968,26.548672566371685
"Wilcox CDP, Pennsylvania",216,151,65,42,85088,30.09259259259259
"Wind Ridge CDP, Pennsylvania",126,95,31,42,85712,24.6031746031746
"Winfield CDP, Pennsylvania",436,343,93,42,85792,21.3302752293578
"Witmer CDP, Pennsylvania",175,175,0,42,85968,0.0
"Wyano CDP, Pennsylvania",251,251,0,42,86672,0.0
"Wylandville CDP, Pennsylvania",116,116,0,42,86712,0.0
"Yorklyn CDP, Pennsylvania",683,683,0,42,87088,0.0
"Yukon CDP, Pennsylvania",223,223,0,42,87240,0.0
"Blue Ball CDP, Pennsylvania",259,259,0,42,07208,0.0
"Blue Ridge Summit CDP, Pennsylvania",461,365,96,42,07312,20.824295010845987
"Bobtown CDP, Pennsylvania",291,231,60,42,07384,20.618556701030926
"Boston CDP, Pennsylvania",183,183,0,42,07688,0.0
"Bowers CDP, Pennsylvania",84,84,0,42,07800,0.0
"Bowmansville CDP, Pennsylvania",873,873,0,42,07896,0.0
"Bradenville CDP, Pennsylvania",207,207,0,42,08024,0.0
"Brave CDP, Pennsylvania",86,77,9,42,08312,10.465116279069768
"Breinigsville CDP, Pennsylvania",2158,2118,40,42,08392,1.8535681186283595
"Bressler CDP, Pennsylvania",640,601,39,42,08432,6.09375
"Brittany Farms-The Highlands CDP, Pennsylvania",1597,1476,121,42,08819,7.576706324358172
"Brownstown CDP, Pennsylvania",879,879,0,42,09416,0.0
"Browntown CDP, Pennsylvania",708,689,19,42,09496,2.6836158192090394
"Ardmore CDP, Pennsylvania",5995,5736,259,42,02896,4.320266889074229
"Harleysville CDP, Pennsylvania",4039,3847,192,42,32616,4.753651894033176
"Drexel Hill CDP, Pennsylvania",11821,10934,887,42,19920,7.503595296506218
"Jefferson borough (York County), Pennsylvania",250,243,7,42,37944,2.8000000000000003
"Parkville CDP, Pennsylvania",3099,2770,329,42,58240,10.616327847692803
"Seven Valleys borough, Pennsylvania",209,191,18,42,69360,8.61244019138756
"Roaring Spring borough, Pennsylvania",1140,1028,112,42,65256,9.824561403508772
"Thompsonville CDP, Pennsylvania",1319,1247,72,42,76552,5.458680818802123
"Greenville borough, Pennsylvania",2243,1975,268,42,31328,11.948283548818546
"Yoe borough, Pennsylvania",444,420,24,42,87040,5.405405405405405
"Folcroft borough, Pennsylvania",2587,2393,194,42,26408,7.499033629686896
"Media borough, Pennsylvania",2826,2629,197,42,48480,6.970983722576079
"Forest Hills borough, Pennsylvania",3533,3162,371,42,26592,10.500990659496178
"Fox Chapel borough, Pennsylvania",1968,1821,147,42,27120,7.4695121951219505
"Green Tree borough, Pennsylvania",2319,2137,182,42,31256,7.8482104355325575
"Munhall borough, Pennsylvania",6112,5246,866,42,52320,14.168848167539267
"Oakdale borough, Pennsylvania",684,658,26,42,55840,3.8011695906432745
"Pleasant Hills borough, Pennsylvania",3785,3645,140,42,61328,3.6988110964332894
"Port Vue borough, Pennsylvania",2000,1793,207,42,62320,10.35
"Sewickley borough, Pennsylvania",1971,1738,233,42,69376,11.821410451547438
"Delano CDP, Pennsylvania",168,156,12,42,18664,7.142857142857142
"Upper St. Clair CDP, Pennsylvania",7310,7087,223,42,79277,3.0506155950752394
"New Philadelphia borough, Pennsylvania",539,431,108,42,53944,20.037105751391465
"Shenandoah Heights CDP, Pennsylvania",669,483,186,42,70064,27.802690582959645
"Elysburg CDP, Pennsylvania",991,926,65,42,23472,6.559031281533804
"Milton borough, Pennsylvania",3137,2811,326,42,50016,10.392094357666561
"Turbotville borough, Pennsylvania",333,304,29,42,77832,8.708708708708707
"Boyertown borough, Pennsylvania",1993,1884,109,42,07960,5.469141996989463
"Hamburg borough, Pennsylvania",2077,1922,155,42,32120,7.462686567164178
"Leesport borough, Pennsylvania",817,746,71,42,42352,8.69033047735618
"Mount Penn borough, Pennsylvania",1397,1270,127,42,51760,9.090909090909092
"Reiffton CDP, Pennsylvania",1697,1697,0,42,64072,0.0
"West Reading borough, Pennsylvania",1745,1688,57,42,83928,3.2664756446991405
"Womelsdorf borough, Pennsylvania",1133,1039,94,42,86056,8.296557811120918
"Tower City borough, Pennsylvania",620,498,122,42,77184,19.67741935483871
"Coalport borough, Pennsylvania",233,200,33,42,14656,14.163090128755366
"DuBois city, Pennsylvania",3757,3349,408,42,20136,10.85972850678733
"Fairless Hills CDP, Pennsylvania",3360,3240,120,42,24712,3.571428571428571
"Newtown Grant CDP, Pennsylvania",1593,1556,37,42,54268,2.322661644695543
"Riegelsville borough, Pennsylvania",386,355,31,42,64856,8.031088082901555
"Trumbauersville borough, Pennsylvania",411,384,27,42,77704,6.569343065693431
"Brush Creek CDP, Oklahoma",18,18,0,40,09612,0.0
"Bull Hollow CDP, Oklahoma",29,29,0,40,09887,0.0
"Leach CDP, Oklahoma",106,101,5,40,41900,4.716981132075472
"Cleveland city, Oklahoma",1460,1199,261,40,15350,17.876712328767123
"Collinsville city, Oklahoma",2656,2480,176,40,16350,6.626506024096386
"Briggs CDP, Oklahoma",145,119,26,40,08775,17.93103448275862
"Dry Creek CDP, Oklahoma",181,91,90,40,21755,49.72375690607735
"Hulbert town, Oklahoma",283,223,60,40,36400,21.20141342756184
"Welling CDP, Oklahoma",286,214,72,40,79850,25.174825174825177
"Stigler city, Oklahoma",1259,1065,194,40,70250,15.409054805401112
"Broken Bow city, Oklahoma",1601,1453,148,40,09100,9.24422236102436
"Haworth town, Oklahoma",144,126,18,40,33150,12.5
"Idabel city, Oklahoma",3324,2756,568,40,36750,17.087845968712394
"Pawnee city, Oklahoma",1080,787,293,40,57650,27.12962962962963
"Okarche town, Oklahoma",519,484,35,40,54050,6.74373795761079
"Gideon CDP, Oklahoma",5,5,0,40,29300,0.0
"Grandview CDP, Oklahoma",96,84,12,40,30915,12.5
"Grant CDP, Oklahoma",170,134,36,40,31000,21.176470588235293
"Indianola CDP, Oklahoma",15,15,0,40,36945,0.0
"Isabella CDP, Oklahoma",76,76,0,40,37350,0.0
"Lebanon CDP, Oklahoma",164,99,65,40,41950,39.63414634146341
"Kenton CDP, Oklahoma",47,16,31,40,39400,65.95744680851064
"Kenwood CDP, Oklahoma",424,370,54,40,39450,12.735849056603774
"Lane CDP, Oklahoma",156,113,43,40,41400,27.564102564102566
"Lucien CDP, Oklahoma",55,55,0,40,44350,0.0
"Mulberry CDP, Oklahoma",58,40,18,40,49825,31.03448275862069
"Nardin CDP, Oklahoma",48,21,27,40,50250,56.25
"Nescatunga CDP, Oklahoma",89,40,49,40,50975,55.0561797752809
"Nicut CDP, Oklahoma",137,108,29,40,51900,21.16788321167883
"Old Green CDP, Oklahoma",175,160,15,40,55285,8.571428571428571
"Peggs CDP, Oklahoma",372,319,53,40,57950,14.24731182795699
"Piney CDP, Oklahoma",25,25,0,40,59100,0.0
"Proctor CDP, Oklahoma",149,104,45,40,60750,30.201342281879196
"Rose CDP, Oklahoma",105,105,0,40,63950,0.0
"Steely Hollow CDP, Oklahoma",76,73,3,40,70037,3.9473684210526314
"Swink CDP, Oklahoma",51,31,20,40,71950,39.21568627450981
"Sycamore CDP, Oklahoma",45,45,0,40,71965,0.0
"Teresita CDP, Oklahoma",72,57,15,40,72800,20.833333333333336
"Titanic CDP, Oklahoma",150,127,23,40,73950,15.333333333333332
"Turpin CDP, Oklahoma",152,127,25,40,75200,16.447368421052634
"Tuskahoma CDP, Oklahoma",64,43,21,40,75300,32.8125
"Wauhillau CDP, Oklahoma",129,109,20,40,79150,15.503875968992247
"White Oak CDP, Oklahoma",122,114,8,40,80850,6.557377049180328
"Whitesboro CDP, Oklahoma",118,84,34,40,80900,28.8135593220339
"White Water CDP, Oklahoma",49,30,19,40,80912,38.775510204081634
"Burneyville CDP, Oklahoma",489,237,252,40,10150,51.533742331288344
"Clarita CDP, Oklahoma",57,46,11,40,14750,19.298245614035086
"Coleman CDP, Oklahoma",142,112,30,40,16250,21.12676056338028
"Connerville CDP, Oklahoma",73,73,0,40,16700,0.0
"Gowen CDP, Oklahoma",106,106,0,40,30500,0.0
"Latta CDP, Oklahoma",533,432,101,40,41680,18.94934333958724
"Lequire CDP, Oklahoma",77,68,9,40,42600,11.688311688311687
"Monroe CDP, Oklahoma",95,75,20,40,49050,21.052631578947366
"Panola CDP, Oklahoma",18,15,3,40,56950,16.666666666666664
"Platter CDP, Oklahoma",78,78,0,40,59500,0.0
"Wardville CDP, Oklahoma",27,21,6,40,78350,22.22222222222222
"Skiatook city, Oklahoma",3125,2896,229,40,67850,7.327999999999999
"Liberty CDP, Oklahoma",117,106,11,40,42850,9.401709401709402
"McLoud city, Oklahoma",1409,1157,252,40,45350,17.885024840312276
"Carlton Landing town, Oklahoma",11,5,6,40,11990,54.54545454545454
"Blanco CDP, Oklahoma",45,36,9,40,06750,20.0
"Mazie CDP, Oklahoma",67,67,0,40,47200,0.0
"Wickliffe CDP, Oklahoma",7,7,0,40,80975,0.0
"Earlsboro town, Oklahoma",306,233,73,40,22500,23.856209150326798
"Johnson town, Oklahoma",99,82,17,40,38200,17.17171717171717
"St. Louis town, Oklahoma",61,41,20,40,64850,32.78688524590164
"Shawnee city, Oklahoma",13635,11968,1667,40,66800,12.225889255592225
"Calumet town, Oklahoma",236,205,31,40,11050,13.135593220338984
"Bridge Creek town, Oklahoma",116,114,2,40,08725,1.7241379310344827
"Carlisle CDP, Oklahoma",227,187,40,40,11975,17.62114537444934
"Friendship town, Oklahoma",18,18,0,40,27900,0.0
"IXL town, Oklahoma",37,22,15,40,37410,40.54054054054054
"Marietta CDP, Oklahoma",48,33,15,40,46488,31.25
"Perkins city, Oklahoma",1291,1157,134,40,58150,10.37955073586367
"Pinhook Corner CDP, Oklahoma",50,50,0,40,59125,0.0
"Sand Hill CDP, Oklahoma",168,123,45,40,65240,26.785714285714285
"Stoney Point CDP, Oklahoma",105,79,26,40,70512,24.761904761904763
"Chelsea town, Oklahoma",996,802,194,40,13700,19.477911646586346
"Sweetwater town, Oklahoma",44,31,13,40,71900,29.545454545454547
"Foster town, Oklahoma",60,49,11,40,27500,18.333333333333332
"Katie town, Oklahoma",185,149,36,40,38700,19.45945945945946
"Oologah town, Oklahoma",492,445,47,40,55750,9.552845528455284
"Verdigris town, Oklahoma",1705,1593,112,40,77050,6.568914956011731
"Beaver town, Oklahoma",755,542,213,40,04750,28.211920529801326
"New Woodville town, Oklahoma",79,53,26,40,51750,32.91139240506329
"Ringwood town, Oklahoma",207,187,20,40,63450,9.66183574879227
"Tiawah CDP, Oklahoma",89,75,14,40,73600,15.730337078651685
"Albany CDP, Oklahoma",124,74,50,40,00950,40.32258064516129
"Arpelar CDP, Oklahoma",156,146,10,40,02900,6.41025641025641
"Badger Lee CDP, Oklahoma",20,20,0,40,03815,0.0
"Bee CDP, Oklahoma",111,68,43,40,04950,38.73873873873874
"Bison CDP, Oklahoma",27,22,5,40,06350,18.51851851851852
"Blackgum CDP, Oklahoma",33,24,9,40,06500,27.27272727272727
"Blue CDP, Oklahoma",107,92,15,40,06900,14.018691588785046
"Box CDP, Oklahoma",87,87,0,40,08050,0.0
"Butler CDP, Oklahoma",66,58,8,40,10460,12.121212121212121
"Cartwright CDP, Oklahoma",291,238,53,40,12550,18.213058419243985
"Chester CDP, Oklahoma",64,54,10,40,13800,15.625
"Dale CDP, Oklahoma",90,86,4,40,19150,4.444444444444445
"Deer Lick CDP, Oklahoma",0,0,0,40,19665,
"Drowning Creek CDP, Oklahoma",243,100,143,40,21676,58.8477366255144
"Eagletown CDP, Oklahoma",239,214,25,40,22350,10.460251046025103
"Elm Grove CDP, Oklahoma",86,69,17,40,23575,19.767441860465116
"Felt CDP, Oklahoma",73,53,20,40,25850,27.397260273972602
"Enterprise city, Oregon",937,883,54,41,23500,5.76307363927428
"Maupin city, Oregon",318,221,97,41,46500,30.50314465408805
"Dundee city, Oregon",1092,1081,11,41,21050,1.0073260073260073
"Island City city, Oregon",430,404,26,41,36750,6.046511627906977
"Union city, Oregon",997,840,157,41,75850,15.747241725175526
"Oakland city, Oregon",401,349,52,41,54000,12.967581047381547
"Riddle city, Oregon",557,503,54,41,61850,9.694793536804308
"Tri-City CDP, Oregon",1636,1551,85,41,74650,5.19559902200489
"Milton-Freewater city, Oregon",2687,2401,286,41,48600,10.643840714551544
"Pilot Rock city, Oregon",572,544,28,41,57650,4.895104895104895
"Weston city, Oregon",306,263,43,41,80350,14.052287581699346
"Johnson City city, Oregon",287,284,3,41,37650,1.0452961672473868
"Toledo city, Oregon",1586,1388,198,41,74000,12.484237074401008
"Waldport city, Oregon",1162,924,238,41,78000,20.481927710843372
"Yachats city, Oregon",879,335,544,41,84200,61.88850967007964
"Bandon city, Oregon",2216,1518,698,41,03800,31.498194945848372
"Oakridge city, Oregon",1791,1433,358,41,54100,19.988833054159688
"Dufur city, Oregon",264,233,31,41,20900,11.742424242424242
"Newberg city, Oregon",8711,8228,483,41,52100,5.544713580530364
"Chiloquin city, Oregon",415,337,78,41,13050,18.795180722891565
"Elgin city, Oregon",734,651,83,41,22550,11.307901907356948
"Seneca city, Oregon",186,111,75,41,66200,40.32258064516129
"Canby city, Oregon",6571,6412,159,41,10750,2.419723025414701
"Prineville city, Oregon",4415,4145,270,41,59850,6.115515288788222
"Irrigon city, Oregon",705,656,49,41,36500,6.950354609929079
"Cape Meares CDP, Oregon",131,46,85,41,11050,64.8854961832061
"Netarts CDP, Oregon",634,372,262,41,52050,41.32492113564668
"Pine Grove CDP, Oregon",80,65,15,41,57850,18.75
"Lebanon city, Oregon",7001,6795,206,41,41650,2.942436794743608
"Joseph city, Oregon",679,532,147,41,37900,21.649484536082475
"Chenoweth CDP, Oregon",772,754,18,41,12800,2.33160621761658
"Philomath city, Oregon",2022,1777,245,41,57450,12.11671612265084
"Canyon City town, Oregon",385,343,42,41,10950,10.909090909090908
"Lakeview town, Oregon",1383,1252,131,41,40700,9.472161966738973
"Paisley city, Oregon",176,152,24,41,56250,13.636363636363635
"La Grande city, Oregon",5993,5328,665,41,40350,11.096278992157517
"Granite city, Oregon",89,12,77,41,30500,86.51685393258427
"Monument city, Oregon",76,52,24,41,49750,31.57894736842105
"Rainier city, Oregon",895,802,93,41,60850,10.391061452513966
"Rose Lodge CDP, Oregon",862,662,200,41,63800,23.201856148491878
"Bunker Hill CDP, Oregon",714,636,78,41,09600,10.92436974789916
"Powers city, Oregon",489,409,80,41,59600,16.359918200409
"Lowell city, Oregon",458,444,14,41,44050,3.056768558951965
"Springfield city, Oregon",25494,24522,972,41,69600,3.8126618027771237
"Sodaville city, Oregon",188,168,20,41,68550,10.638297872340425
"Waterloo town, Oregon",95,92,3,41,79050,3.1578947368421053
"Wallowa city, Oregon",419,372,47,41,78150,11.217183770883054
"Mosier city, Oregon",278,203,75,41,50050,26.978417266187048
"Wamic CDP, Oregon",50,50,0,41,78300,0.0
"Lafayette city, Oregon",1379,1295,84,41,40300,6.091370558375635
"Yamhill city, Oregon",462,436,26,41,84250,5.627705627705628
"Adair Village city, Oregon",380,361,19,41,00275,5.0
"Corvallis city, Oregon",24576,22554,2022,41,15800,8.2275390625
"Glide CDP, Oregon",593,516,77,41,29750,12.984822934232715
"Elkton city, Oregon",134,116,18,41,22800,13.432835820895523
"Willamina city, Oregon",925,827,98,41,82350,10.594594594594595
"Gladstone city, Oregon",4811,4577,234,41,29000,4.863853668675951
"Canyonville city, Oregon",873,770,103,41,11000,11.798396334478808
"Hebo CDP, Oregon",103,71,32,41,33100,31.06796116504854
"Adams city, Oregon",162,149,13,41,00350,8.024691358024691
"Warm Springs CDP, Oregon",858,769,89,41,78600,10.372960372960373
"Stanfield city, Oregon",925,879,46,41,69900,4.972972972972973
"Sheridan city, Oregon",1709,1549,160,41,67050,9.362200117027502
"Cove city, Oregon",315,308,7,41,16250,2.2222222222222223
"Monroe city, Oregon",293,271,22,41,49600,7.508532423208192
"Culver city, Oregon",554,528,26,41,17300,4.693140794223827
"Greenhorn city, Oregon",7,4,3,41,31050,42.857142857142854
"John Day city, Oregon",1109,1030,79,41,37550,7.123534715960325
"Long Creek city, Oregon",98,64,34,41,43550,34.69387755102041
"Cottage Grove city, Oregon",4226,3968,258,41,15950,6.105063890203502
"Creswell city, Oregon",2191,2022,169,41,16950,7.7133728890917395
"Junction City city, Oregon",2382,2290,92,41,38000,3.8623005877413936
"Westfir city, Oregon",131,121,10,41,79950,7.633587786259542
"Halsey city, Oregon",354,328,26,41,31750,7.344632768361582
"Aumsville city, Oregon",1377,1333,44,41,03250,3.195352214960058
"Brooks CDP, Oregon",186,186,0,41,08750,0.0
"Detroit city, Oregon",396,43,353,41,19100,89.14141414141415
"Marion CDP, Oregon",174,174,0,41,45900,0.0
"Richland city, Oregon",114,96,18,41,61700,15.789473684210526
"Unity city, Oregon",61,42,19,41,76250,31.147540983606557
"Gold Hill city, Oregon",558,518,40,41,29950,7.168458781362006
"Oatfield CDP, Oregon",5354,5168,186,41,54325,3.4740381023533806
"Silverton city, Oregon",3965,3758,207,41,67650,5.220680958385877
"Oak Hills CDP, Oregon",4367,4183,184,41,53988,4.2134188229906115
"Tigard city, Oregon",21754,21016,738,41,73650,3.3924795439919095
"Tualatin city, Oregon",11338,10833,505,41,74950,4.454048333039337
"Phoenix city, Oregon",2413,2252,161,41,57500,6.672192291753004
"Rogue River city, Oregon",1290,1153,137,41,63450,10.620155038759691
"Seaside city, Oregon",4698,2890,1808,41,65950,38.48446147296722
"Lyons city, Oregon",495,430,65,41,44300,13.131313131313133
"Metolius city, Oregon",344,302,42,41,47750,12.209302325581394
"Columbia City city, Oregon",854,821,33,41,14750,3.864168618266979
"Antelope city, Oregon",42,36,6,41,02250,14.285714285714285
"Shaniko city, Oregon",14,9,5,41,66700,35.714285714285715
"Rowena CDP, Oregon",110,90,20,41,63950,18.181818181818183
"Yoncalla city, Oregon",520,486,34,41,84600,6.538461538461539
"Altamont CDP, Oregon",8450,7640,810,41,01850,9.585798816568047
"Summerville town, Oregon",71,61,10,41,70850,14.084507042253522
"Ione city, Oregon",157,122,35,41,36400,22.29299363057325
"Scappoose city, Oregon",2771,2697,74,41,65500,2.67051605918441
"Millersburg city, Oregon",661,626,35,41,48300,5.29500756429652
"Dayville town, Oregon",101,80,21,41,18300,20.792079207920793
"Boardman city, Oregon",1126,1075,51,41,07200,4.529307282415631
"Condon city, Oregon",453,347,106,41,15000,23.399558498896248
"Salem city, Oregon",64050,59693,4357,41,64900,6.802498048399689
"Mount Angel city, Oregon",1257,1203,54,41,50150,4.295942720763723
"Rivergrove city, Oregon",191,185,6,41,62250,3.1413612565445024
"Independence city, Oregon",3447,3232,215,41,36150,6.237307803887438
"Gearhart city, Oregon",1443,629,814,41,28450,56.41025641025641
"Prairie City city, Oregon",371,274,97,41,59650,26.1455525606469
"McMinnville city, Oregon",13181,12462,719,41,45000,5.454821333737956
"Madras city, Oregon",2659,2322,337,41,45250,12.673937570515232
"Coburg city, Oregon",456,421,35,41,14400,7.675438596491229
"Brownsville city, Oregon",773,736,37,41,09050,4.786545924967658
"Stayton city, Oregon",2995,2838,157,41,70200,5.242070116861436
"Aurora city, Oregon",423,404,19,41,03300,4.491725768321513
"Wasco city, Oregon",197,190,7,41,78950,3.5532994923857872
"Tangent city, Oregon",437,391,46,41,72600,10.526315789473683
"Forest Grove city, Oregon",8810,8320,490,41,26200,5.561861520998865
"Hayesville CDP, Oregon",7753,7243,510,41,32850,6.578098800464336
"Parkdale CDP, Oregon",96,96,0,41,56500,0.0
"Medford city, Oregon",33763,31655,2108,41,47000,6.243521014127892
"Imbler city, Oregon",140,137,3,41,36050,2.142857142857143
"Tygh Valley CDP, Oregon",121,105,16,41,75500,13.223140495867769
"Amity city, Oregon",643,584,59,41,02000,9.17573872472784
"Klamath Falls city, Oregon",10050,9015,1035,41,39700,10.298507462686567
"Port Orford city, Oregon",749,570,179,41,59250,23.89853137516689
"Huntington city, Oregon",229,180,49,41,35700,21.397379912663755
"Jacksonville city, Oregon",1665,1483,182,41,37000,10.93093093093093
"Shady Cove city, Oregon",1533,1397,136,41,66550,8.871493803000652
"White City CDP, Oregon",2839,2686,153,41,81450,5.389221556886228
"Astoria city, Oregon",5188,4534,654,41,03150,12.606013878180416
"Cannon Beach city, Oregon",2144,655,1489,41,10850,69.44962686567165
"Fairview city, Oregon",3792,3651,141,41,24250,3.7183544303797467
"Maywood Park city, Oregon",363,348,15,41,46730,4.132231404958678
"Rufus city, Oregon",128,103,25,41,64200,19.53125
"Grants Pass city, Oregon",16051,15158,893,41,30550,5.563516291819824
"Portland city, Oregon",282139,264428,17711,41,59000,6.277402273347535
"Raleigh Hills CDP, Oregon",2829,2740,89,41,60900,3.1459879816189464
"Terrebonne CDP, Oregon",616,567,49,41,72800,7.954545454545454
"Four Corners CDP, Oregon",5985,5591,394,41,26750,6.58312447786132
"Hubbard city, Oregon",1161,1078,83,41,35450,7.14900947459087
"Jefferson city, Oregon",1148,1057,91,41,37250,7.926829268292683
"Mill City city, Oregon",778,702,76,41,48150,9.768637532133676
"Butte Falls town, Oregon",203,162,41,41,10050,20.19704433497537
"Arlington city, Oregon",251,216,35,41,02800,13.94422310756972
"Rockcreek CDP, Oregon",3828,3621,207,41,63010,5.407523510971787
"West Haven-Sylvan CDP, Oregon",4254,3987,267,41,80025,6.276445698166431
"Idanha city, Oregon",107,73,34,41,35800,31.775700934579437
"Halfway city, Oregon",237,169,68,41,31650,28.691983122362867
"Lonerock city, Oregon",14,6,8,41,43400,57.14285714285714
"Sisters city, Oregon",1214,980,234,41,67950,19.27512355848435
"Keizer city, Oregon",14536,13850,686,41,38500,4.719317556411667
"Eola CDP, Oregon",0,0,0,41,23550,
"Sandy city, Oregon",4094,3969,125,41,65250,3.053248656570591
"Deschutes River Woods CDP, Oregon",2195,2118,77,41,19020,3.507972665148064
"Donald city, Oregon",460,436,24,41,20100,5.217391304347826
"Mehama CDP, Oregon",101,75,26,41,47300,25.742574257425744
"Sublimity city, Oregon",1236,1173,63,41,70700,5.097087378640777
"Woodburn city, Oregon",8269,7910,359,41,83750,4.341516507437417
"Gaston city, Oregon",215,205,10,41,28100,4.651162790697675
"Hillsboro city, Oregon",40108,38371,1737,41,34100,4.33080682158173
"Sherwood city, Oregon",6727,6498,229,41,67100,3.404192061840345
"Wilsonville city, Oregon",9887,9474,413,41,82800,4.177202386972793
"Gresham city, Oregon",42497,40051,2446,41,31250,5.755700402381344
"Dallas city, Oregon",6230,6116,114,41,17700,1.8298555377207062
"Monmouth city, Oregon",3685,3392,293,41,49550,7.951153324287652
"Wood Village city, Oregon",1228,1142,86,41,83950,7.0032573289902285
"Haines city, Oregon",207,172,35,41,31600,16.908212560386474
"Eagle Point city, Oregon",3943,3777,166,41,21550,4.209992391580015
"Nyssa city, Oregon",1125,1043,82,41,53750,7.28888888888889
"Mount Vernon city, Oregon",271,226,45,41,50250,16.605166051660518
"North Powder city, Oregon",201,186,15,41,53300,7.462686567164178
"Winston city, Oregon",2335,2294,41,41,83400,1.7558886509635976
"Clatskanie city, Oregon",702,652,50,41,13750,7.122507122507122
"Depoe Bay city, Oregon",1533,829,704,41,18850,45.92302674494455
"Barview CDP, Oregon",877,847,30,41,04400,3.4207525655644244
"Coos Bay city, Oregon",7655,6794,861,41,15250,11.24755062050947
"Harrisburg city, Oregon",1267,1183,84,41,32550,6.629834254143646
"Scio city, Oregon",323,307,16,41,65650,4.953560371517028
"Sweet Home city, Oregon",3836,3603,233,41,71950,6.074035453597498
"Gold Beach city, Oregon",1324,1107,217,41,29900,16.389728096676738
"Warrenton city, Oregon",2261,2044,217,41,78900,9.597523219814242
"Troutdale city, Oregon",5743,5700,43,41,74850,0.7487375935921992
"Umatilla city, Oregon",1968,1802,166,41,75650,8.434959349593496
"Redmond city, Oregon",11639,11292,347,41,61200,2.981355786579603
"Three Rivers CDP, Oregon",2229,1412,817,41,73225,36.65320771646478
"Gates city, Oregon",270,254,16,41,28200,5.9259259259259265
"Labish Village CDP, Oregon",136,136,0,41,40050,0.0
"Scotts Mills city, Oregon",162,157,5,41,65800,3.0864197530864197
"King City city, Oregon",1900,1900,0,41,39150,0.0
"Grand Ronde CDP, Oregon",794,696,98,41,30300,12.34256926952141
"Metzger CDP, Oregon",1667,1582,85,41,47800,5.098980203959208
"West Slope CDP, Oregon",3184,3126,58,41,80900,1.8216080402010049
"Falls City city, Oregon",427,394,33,41,24550,7.728337236533958
"Central Point city, Oregon",7311,6892,419,41,12400,5.731090138147996
"Cascade Locks city, Oregon",552,435,117,41,11600,21.195652173913043
"Milwaukie city, Oregon",9619,9101,518,41,48650,5.385175174134525
"Biggs Junction CDP, Oregon",14,14,0,41,06400,0.0
"Moro city, Oregon",171,140,31,41,50000,18.128654970760234
"La Pine city, Oregon",990,854,136,41,41050,13.737373737373737
"The Dalles city, Oregon",6608,6300,308,41,72950,4.661016949152542
"Crawfordsville CDP, Oregon",207,178,29,41,16650,14.009661835748794
"Days Creek CDP, Oregon",136,136,0,41,18150,0.0
"Deer Island CDP, Oregon",93,93,0,41,18450,0.0
"Dillard CDP, Oregon",127,127,0,41,19600,0.0
"Fort Hill CDP, Oregon",47,47,0,41,26400,0.0
"Eagle Crest CDP, Oregon",1811,1099,712,41,21450,39.31529541689674
"Fair Oaks CDP, Oregon",103,103,0,41,24100,0.0
"Foots Creek CDP, Oregon",237,237,0,41,26165,0.0
"Gardiner CDP, Oregon",229,158,71,41,27850,31.004366812227076
"Glasgow CDP, Oregon",352,352,0,41,29100,0.0
"Government Camp CDP, Oregon",846,93,753,41,30250,89.00709219858156
"Harper CDP, Oregon",65,57,8,41,32400,12.307692307692308
"Holley CDP, Oregon",137,114,23,41,34650,16.78832116788321
"Idaville CDP, Oregon",131,131,0,41,35850,0.0
"Juntura CDP, Oregon",51,23,28,41,38150,54.90196078431373
"Kerby CDP, Oregon",404,404,0,41,38900,0.0
"Kings Valley CDP, Oregon",81,81,0,41,39350,0.0
"Lacomb CDP, Oregon",205,205,0,41,40150,0.0
"Langlois CDP, Oregon",85,63,22,41,40950,25.882352941176475
"Lookingglass CDP, Oregon",342,317,25,41,43650,7.309941520467836
"Melrose CDP, Oregon",342,287,55,41,47350,16.08187134502924
"Merlin CDP, Oregon",750,750,0,41,47650,0.0
"Mount Hood CDP, Oregon",82,82,0,41,50200,0.0
"Mulino CDP, Oregon",868,753,115,41,50450,13.248847926267281
"Nesika Beach CDP, Oregon",349,192,157,41,51950,44.985673352435526
"New Hope CDP, Oregon",676,650,26,41,52275,3.8461538461538463
"New Pine Creek CDP, Oregon",51,51,0,41,52400,0.0
"O'Brien CDP, Oregon",446,237,209,41,54350,46.860986547085204
"Peoria CDP, Oregon",79,79,0,41,57300,0.0
"Pistol River CDP, Oregon",108,64,44,41,58050,40.74074074074074
"Plush CDP, Oregon",71,38,33,41,58550,46.478873239436616
"Pronghorn CDP, Oregon",65,27,38,41,60070,58.46153846153847
"Prospect CDP, Oregon",249,213,36,41,60100,14.457831325301203
"Ruch CDP, Oregon",316,281,35,41,64150,11.075949367088606
"Selma CDP, Oregon",398,301,97,41,66150,24.371859296482413
"Seventh Mountain CDP, Oregon",246,160,86,41,66385,34.959349593495936
"Shedd CDP, Oregon",125,125,0,41,66900,0.0
"Silver Lake CDP, Oregon",53,38,15,41,67600,28.30188679245283
"Stafford CDP, Oregon",856,804,52,41,69800,6.074766355140187
"Summit CDP, Oregon",44,44,0,41,70870,0.0
"Sunriver CDP, Oregon",4821,581,4240,41,71250,87.94855839037544
"Takilma CDP, Oregon",132,132,0,41,72400,0.0
"Tetherow CDP, Oregon",189,173,16,41,72820,8.465608465608465
"Trail CDP, Oregon",390,305,85,41,74400,21.794871794871796
"Alpine CDP, Oregon",74,74,0,41,01700,0.0
"Alsea CDP, Oregon",103,80,23,41,01800,22.330097087378643
"Annex CDP, Oregon",123,101,22,41,02200,17.88617886178862
"Bayside Gardens CDP, Oregon",689,386,303,41,04925,43.97677793904209
"Beavercreek CDP, Oregon",1728,1652,76,41,05250,4.398148148148148
"Bellfountain CDP, Oregon",32,8,24,41,05700,75.0
"Bethany CDP, Oregon",8745,8375,370,41,05950,4.230989136649514
"Black Butte Ranch CDP, Oregon",1406,170,1236,41,06650,87.90896159317212
"Blodgett CDP, Oregon",30,30,0,41,06950,0.0
"Brogan CDP, Oregon",72,42,30,41,08600,41.66666666666667
"Bull Mountain CDP, Oregon",3187,3170,17,41,09535,0.5334170065892689
"Camp Sherman CDP, Oregon",372,103,269,41,10550,72.31182795698925
"Cascadia CDP, Oregon",100,59,41,41,11700,41.0
"Crabtree CDP, Oregon",237,237,0,41,16350,0.0
"Crane CDP, Oregon",50,28,22,41,16450,44.0
"Crooked River Ranch CDP, Oregon",2205,1820,385,41,16975,17.46031746031746
"Damascus CDP, Oregon",4246,4069,177,41,17800,4.168629298162977
"Tumalo CDP, Oregon",227,227,0,41,75050,0.0
"Umapine CDP, Oregon",157,136,21,41,75600,13.375796178343949
"West Scio CDP, Oregon",65,65,0,41,80750,0.0
"Wallowa Lake CDP, Oregon",254,7,247,41,78160,97.24409448818898
"Warren CDP, Oregon",812,722,90,41,78800,11.083743842364532
"Westport CDP, Oregon",147,122,25,41,80400,17.006802721088434
"Williams CDP, Oregon",527,489,38,41,82450,7.2106261859582546
"Wimer CDP, Oregon",251,206,45,41,82850,17.928286852589643
"Jeffers Gardens CDP, Oregon",138,138,0,41,37202,0.0
"Neahkahnie CDP, Oregon",368,51,317,41,51450,86.1413043478261
"Beatty CDP, Oregon",2,0,2,41,05150,100.0
"Talent city, Oregon",3114,2980,134,41,72500,4.303147077713552
"Barlow city, Oregon",39,39,0,41,04000,0.0
"Estacada city, Oregon",1369,1250,119,41,23800,8.692476260043827
"Mount Hood Village CDP, Oregon",3983,2006,1977,41,50235,49.63595279939744
"Oregon City city, Oregon",13531,13089,442,41,55200,3.266573054467519
"Ashland city, Oregon",10705,9816,889,41,03050,8.304530593180756
"Redwood CDP, Oregon",1290,1216,74,41,61250,5.736434108527131
"Baker City city, Oregon",4699,4116,583,41,03650,12.406895084060439
"Sumpter city, Oregon",377,114,263,41,71000,69.76127320954907
"Grass Valley city, Oregon",84,68,16,41,30650,19.047619047619047
"Rickreall CDP, Oregon",21,21,0,41,61800,0.0
"Oceanside CDP, Oregon",783,206,577,41,54450,73.69093231162196
"Drain city, Oregon",436,395,41,41,20500,9.403669724770642
"Spray town, Oregon",103,84,19,41,69450,18.446601941747574
"Hines city, Oregon",706,603,103,41,34250,14.589235127478753
"Beaverton city, Oregon",41306,39452,1854,41,05350,4.4884520408657345
"Nehalem city, Oregon",182,137,45,41,51700,24.725274725274726
"Wheeler city, Oregon",230,161,69,41,81300,30.0
"Athena city, Oregon",518,481,37,41,03200,7.142857142857142
"Gopher Flats CDP, Oregon",162,150,12,41,30165,7.4074074074074066
"Helix city, Oregon",62,49,13,41,33250,20.967741935483872
"Hermiston city, Oregon",6667,6198,469,41,33700,7.034648267586621
"Burns city, Oregon",1554,1273,281,41,09800,18.082368082368085
"Hood River city, Oregon",3923,3494,429,41,34900,10.935508539383125
"Odell CDP, Oregon",569,569,0,41,54550,0.0
"Durham city, Oregon",704,682,22,41,21250,3.125
"Lake Oswego city, Oregon",17377,16492,885,41,40550,5.092938942280025
"Bend city, Oregon",40686,37339,3347,41,05800,8.226416949319177
"Lincoln Beach CDP, Oregon",2486,1007,1479,41,42550,59.49316170555109
"Newport city, Oregon",5694,4560,1134,41,52450,19.915700737618547
"Dunes City city, Oregon",830,567,263,41,21150,31.686746987951807
"Veneta city, Oregon",1929,1869,60,41,77050,3.1104199066874028
"South Lebanon CDP, Oregon",307,307,0,41,68875,0.0
"Brookings city, Oregon",3260,2814,446,41,08650,13.680981595092023
"Harbor CDP, Oregon",1626,1311,315,41,32100,19.37269372693727
"Adrian city, Oregon",93,87,6,41,00500,6.451612903225806
"Merrill city, Oregon",362,292,70,41,47700,19.337016574585636
"Pine Hollow CDP, Oregon",482,243,239,41,57875,49.5850622406639
"Carlton city, Oregon",777,706,71,41,11150,9.137709137709138
"Lexington town, Oregon",84,78,6,41,42200,7.142857142857142
"Green CDP, Oregon",3085,2884,201,41,30750,6.515397082658023
"Reedsport city, Oregon",2001,1754,247,41,61300,12.343828085957021
"Roseburg city, Oregon",10997,10322,675,41,63650,6.138037646630899
"Beaver CDP, Oregon",103,95,8,41,05200,7.766990291262135
"Neskowin CDP, Oregon",408,133,275,41,52000,67.40196078431373
"Mission CDP, Oregon",338,305,33,41,49000,9.763313609467456
"Mitchell city, Oregon",60,46,14,41,49150,23.333333333333332
"Molalla city, Oregon",3341,3187,154,41,49450,4.60939838371745
"Oak Grove CDP, Oregon",7856,7309,547,41,53900,6.962830957230143
"St. Paul city, Oregon",143,139,4,41,64850,2.797202797202797
"West Linn city, Oregon",10102,9846,256,41,80150,2.5341516531379926
"Butteville CDP, Oregon",102,102,0,41,10100,0.0
"Gervais city, Oregon",693,610,83,41,28650,11.976911976911978
"Turner city, Oregon",1000,912,88,41,75150,8.799999999999999
"Banks city, Oregon",558,526,32,41,03850,5.734767025089606
"Cedar Hills CDP, Oregon",3686,3531,155,41,12050,4.205100379815518
"Garden Home-Whitford CDP, Oregon",2924,2722,202,41,27825,6.908344733242135
"Cave Junction city, Oregon",1094,1041,53,41,11850,4.844606946983546
"Kirkpatrick CDP, Oregon",57,55,2,41,39566,3.508771929824561
"Pendleton city, Oregon",6687,5947,740,41,57150,11.066247943771497
"Riverside CDP, Oregon",71,62,9,41,62412,12.676056338028168
"Tutuilla CDP, Oregon",178,175,3,41,75185,1.6853932584269662
"Ukiah city, Oregon",123,88,35,41,75550,28.455284552845526
"Fossil city, Oregon",284,242,42,41,26650,14.788732394366196
"Aloha CDP, Oregon",18864,18159,705,41,01650,3.737277353689567
"Cedar Mill CDP, Oregon",6300,6101,199,41,12150,3.1587301587301586
"Cornelius city, Oregon",3772,3631,141,41,15550,3.7380699893955462
"North Plains city, Oregon",928,902,26,41,53150,2.8017241379310347
"Roseburg North CDP, Oregon",2199,2168,31,41,63660,1.409731696225557
"Glendale city, Oregon",357,344,13,41,29350,3.6414565826330536
"Myrtle Creek city, Oregon",1381,1257,124,41,50950,8.979000724112963
"Sutherlin city, Oregon",3539,3260,279,41,71650,7.88358293303193
"Winchester Bay CDP, Oregon",224,163,61,41,83050,27.232142857142854
"Heppner city, Oregon",633,500,133,41,33550,21.011058451816748
"Garibaldi city, Oregon",511,359,152,41,28000,29.74559686888454
"Manzanita city, Oregon",1266,204,1062,41,45700,83.88625592417061
"Pacific City CDP, Oregon",1530,431,1099,41,56150,71.83006535947712
"Rockaway Beach city, Oregon",2171,546,1625,41,62900,74.8502994011976
"Tillamook city, Oregon",2448,2284,164,41,73700,6.699346405228758
"Echo city, Oregon",278,267,11,41,22200,3.9568345323741005
"Dayton city, Oregon",825,749,76,41,18250,9.212121212121211
"Jordan Valley city, Oregon",157,74,83,41,37850,52.86624203821656
"Vale city, Oregon",789,681,108,41,76600,13.688212927756654
"Lostine city, Oregon",133,106,27,41,43900,20.30075187969925
"Lincoln City city, Oregon",6710,3947,2763,41,42600,41.177347242921016
"Cayuse CDP, Oregon",22,22,0,41,11900,0.0
"St. Helens city, Oregon",5388,4997,391,41,64600,7.256867112100965
"Vernonia city, Oregon",905,764,141,41,77250,15.58011049723757
"Bonanza town, Oregon",189,171,18,41,07300,9.523809523809524
"Coquille city, Oregon",1692,1623,69,41,15350,4.078014184397164
"Lakeside city, Oregon",1223,917,306,41,40650,25.020441537203595
"Myrtle Point city, Oregon",1177,1052,125,41,51050,10.620220900594731
"North Bend city, Oregon",4217,3837,380,41,53000,9.011145364002845
"Eugene city, Oregon",73049,68855,4194,41,23850,5.741351695437309
"Albany city, Oregon",21591,20469,1122,41,01000,5.19660969848548
"Cloverdale CDP, Oregon",184,184,0,41,14200,0.0
"Happy Valley city, Oregon",6410,6278,132,41,32050,2.059282371294852
"Jennings Lodge CDP, Oregon",3434,3388,46,41,37400,1.3395457192778102
"Bay City city, Oregon",716,634,82,41,04800,11.452513966480447
"Malin city, Oregon",345,304,41,41,45400,11.884057971014492
"Florence city, Oregon",5079,4322,757,41,26050,14.904508761567236
"Ontario city, Oregon",4789,4207,582,41,54900,12.152850281896011
"Prescott city, Oregon",45,38,7,41,59750,15.555555555555555
"Siletz city, Oregon",568,543,25,41,67500,4.401408450704225
"Manchester borough, Pennsylvania",1253,1253,0,42,46864,0.0
"North York borough, Pennsylvania",947,858,89,42,55608,9.398099260823653
"Spry CDP, Pennsylvania",2184,2093,91,42,73528,4.166666666666666
"Dunnstown CDP, Pennsylvania",633,609,24,42,20416,3.7914691943127963
"Winterstown borough, Pennsylvania",261,256,5,42,85872,1.9157088122605364
"Chester city, Pennsylvania",14447,11633,2814,42,13208,19.478092337509516
"York Haven borough, Pennsylvania",321,280,41,42,87080,12.77258566978193
"Bellwood borough, Pennsylvania",780,750,30,42,05384,3.8461538461538463
"West Brownsville borough, Pennsylvania",499,441,58,42,82616,11.623246492985972
"Clark borough, Pennsylvania",252,236,16,42,13832,6.349206349206349
"Mount Holly Springs borough, Pennsylvania",903,812,91,42,51592,10.077519379844961
"Newburg borough (Cumberland County), Pennsylvania",155,136,19,42,53344,12.258064516129032
"Shiremanstown borough, Pennsylvania",745,674,71,42,70384,9.53020134228188
"Reedsville CDP, Pennsylvania",254,254,0,42,63976,0.0
"Clarence CDP, Pennsylvania",281,234,47,42,13768,16.72597864768683
"Lemont CDP, Pennsylvania",1040,967,73,42,42632,7.019230769230769
"Lewistown borough, Pennsylvania",4304,3760,544,42,43000,12.639405204460965
"Duboistown borough, Pennsylvania",541,512,29,42,20144,5.360443622920517
"Jersey Shore borough, Pennsylvania",1975,1665,310,42,38128,15.69620253164557
"Salladasburg borough, Pennsylvania",112,96,16,42,67616,14.285714285714285
"Eagleville CDP (Centre County), Pennsylvania",247,166,81,42,20664,32.79352226720648
"Eagleville CDP (Montgomery County), Pennsylvania",1144,1091,53,42,20672,4.6328671328671325
"Earlston CDP, Pennsylvania",481,409,72,42,20704,14.96881496881497
"East Earl CDP, Pennsylvania",415,373,42,42,21064,10.120481927710843
"East Freedom CDP, Pennsylvania",418,361,57,42,21176,13.636363636363635
"East Salem CDP, Pennsylvania",73,70,3,42,21792,4.10958904109589
"Eddington CDP, Pennsylvania",769,714,55,42,22280,7.152145643693109
"Edenborn CDP, Pennsylvania",101,101,0,42,22344,0.0
"Edenburg CDP, Pennsylvania",326,316,10,42,22352,3.067484662576687
"Edie CDP, Pennsylvania",34,34,0,42,22600,0.0
"Effort CDP, Pennsylvania",889,809,80,42,22680,8.998875140607424
"Egypt CDP, Pennsylvania",847,847,0,42,22696,0.0
"Eighty Four CDP, Pennsylvania",212,212,0,42,22736,0.0
"Elrama CDP, Pennsylvania",183,131,52,42,23392,28.415300546448087
"Emerald Lakes CDP, Pennsylvania",1737,1081,656,42,23540,37.76626367299942
"Enhaut CDP, Pennsylvania",426,375,51,42,23704,11.971830985915492
"Enlow CDP, Pennsylvania",563,516,47,42,23720,8.348134991119005
"Fairhope CDP, Pennsylvania",513,475,38,42,24664,7.4074074074074066
"Falmouth CDP, Pennsylvania",179,179,0,42,25168,0.0
"Farmersville CDP, Pennsylvania",366,366,0,42,25248,0.0
"Farmington CDP, Pennsylvania",72,52,20,42,25280,27.77777777777778
"Fawn Lake Forest CDP, Pennsylvania",580,216,364,42,25420,62.758620689655174
"Faxon CDP, Pennsylvania",641,561,80,42,25424,12.480499219968799
"Feasterville CDP, Pennsylvania",1162,1117,45,42,25496,3.87263339070568
"Fellsburg CDP, Pennsylvania",584,569,15,42,25568,2.5684931506849313
"Fivepointville CDP, Pennsylvania",448,448,0,42,26232,0.0
"Flora Dale CDP, Pennsylvania",0,0,0,42,26328,
"Foot of Ten CDP, Pennsylvania",318,307,11,42,26488,3.459119496855346
"Force CDP, Pennsylvania",83,70,13,42,26504,15.66265060240964
"Fort Loudon CDP, Pennsylvania",280,280,0,42,26824,0.0
"Cetronia CDP, Pennsylvania",1030,958,72,42,12424,6.990291262135923
"Jacksonville CDP (Centre County), Pennsylvania",38,30,8,42,37544,21.052631578947366
"Leola CDP, Pennsylvania",2821,2733,88,42,42776,3.119461183977313
"Lionville CDP, Pennsylvania",2768,2666,102,42,43744,3.6849710982658963
"Snydertown CDP, Pennsylvania",121,121,0,42,71672,0.0
"Woxall CDP, Pennsylvania",413,413,0,42,86576,0.0
"Foster Brook CDP, Pennsylvania",583,484,99,42,26960,16.9811320754717
"Fox Chase CDP, Pennsylvania",655,655,0,42,27130,0.0
"Gardners CDP, Pennsylvania",46,46,0,42,28488,0.0
"Fredericktown CDP, Pennsylvania",266,208,58,42,27672,21.804511278195488
"Frizzleburg CDP, Pennsylvania",253,253,0,42,28014,0.0
"Frystown CDP, Pennsylvania",203,203,0,42,28128,0.0
"Hegins CDP, Pennsylvania",381,381,0,42,33576,0.0
"Heidlersburg CDP, Pennsylvania",293,287,6,42,33632,2.04778156996587
"Hemlock Farms CDP, Pennsylvania",3336,1347,1989,42,33772,59.62230215827338
"Hendersonville CDP, Pennsylvania",112,104,8,42,33840,7.142857142857142
"Hereford CDP, Pennsylvania",382,336,46,42,34008,12.041884816753926
"Hickory CDP, Pennsylvania",279,269,10,42,34256,3.584229390681003
"Hickory Hills CDP, Pennsylvania",426,235,191,42,34308,44.835680751173705
"Hilldale CDP, Pennsylvania",655,655,0,42,34776,0.0
"Holiday Pocono CDP, Pennsylvania",484,229,255,42,35172,52.68595041322314
"Hopeland CDP, Pennsylvania",237,237,0,42,35632,0.0
"Hostetter CDP, Pennsylvania",304,214,90,42,35872,29.605263157894733
"Hublersburg CDP, Pennsylvania",31,31,0,42,36064,0.0
"Hudson CDP, Pennsylvania",725,626,99,42,36096,13.655172413793103
"Hunterstown CDP, Pennsylvania",229,229,0,42,36352,0.0
"Hyde Park CDP, Pennsylvania",1032,942,90,42,36576,8.720930232558139
"Idaville CDP, Pennsylvania",78,78,0,42,36712,0.0
"Imperial CDP, Pennsylvania",1204,1103,101,42,36768,8.388704318936876
"Indian Mountain Lake CDP, Pennsylvania",2779,1324,1455,42,36904,52.35696293630803
"Inkerman CDP, Pennsylvania",1021,933,88,42,37008,8.619000979431929
"Intercourse CDP, Pennsylvania",630,620,10,42,37016,1.5873015873015872
"Jacksonville CDP (Indiana County), Pennsylvania",341,290,51,42,37552,14.95601173020528
"Jacksonwald CDP, Pennsylvania",1293,1187,106,42,37584,8.19798917246713
"James City CDP, Pennsylvania",155,118,37,42,37656,23.870967741935484
"Joffre CDP, Pennsylvania",266,246,20,42,38240,7.518796992481203
"Kapp Heights CDP, Pennsylvania",385,362,23,42,38744,5.974025974025974
"Kelayres CDP, Pennsylvania",248,195,53,42,39056,21.370967741935484
"Kempton CDP, Pennsylvania",40,40,0,42,39224,0.0
"Kenmar CDP, Pennsylvania",2002,1776,226,42,39280,11.288711288711289
"Kennerdell CDP, Pennsylvania",355,100,255,42,39336,71.83098591549296
"Kerrtown CDP, Pennsylvania",151,95,56,42,39504,37.086092715231786
"Kersey CDP, Pennsylvania",472,472,0,42,39512,0.0
"Kirkwood CDP, Pennsylvania",99,94,5,42,39944,5.05050505050505
"Kiskimere CDP, Pennsylvania",86,52,34,42,39960,39.53488372093023
"Kutztown University CDP, Pennsylvania",0,0,0,42,40666,
"Kylertown CDP, Pennsylvania",181,169,12,42,40680,6.629834254143646
"Lake Arthur Estates CDP, Pennsylvania",297,297,0,42,40948,0.0
"Lake Latonka CDP, Pennsylvania",523,368,155,42,40982,29.636711281070742
"Lakemont CDP, Pennsylvania",949,913,36,42,40992,3.7934668071654376
"Lake Winola CDP, Pennsylvania",550,267,283,42,41080,51.45454545454545
"Lamar CDP, Pennsylvania",262,243,19,42,41104,7.251908396946565
"Lampeter CDP, Pennsylvania",527,486,41,42,41192,7.7798861480075905
"Landisville CDP, Pennsylvania",762,725,37,42,41304,4.8556430446194225
"Langeloth CDP, Pennsylvania",285,285,0,42,41376,0.0
"Lattimer CDP, Pennsylvania",239,177,62,42,41700,25.94142259414226
"Laurelton CDP, Pennsylvania",123,113,10,42,41856,8.130081300813007
"Laurys Station CDP, Pennsylvania",540,447,93,42,41880,17.22222222222222
"Lavelle CDP, Pennsylvania",303,303,0,42,41904,0.0
"Lawrence CDP, Pennsylvania",373,243,130,42,41968,34.852546916890084
"Leeper CDP, Pennsylvania",86,70,16,42,42328,18.6046511627907
"Lemont Furnace CDP, Pennsylvania",369,355,14,42,42640,3.7940379403794036
"Lenkerville CDP, Pennsylvania",251,213,38,42,42704,15.139442231075698
"Little Britain CDP, Pennsylvania",142,142,0,42,43828,0.0
"Level Green CDP, Pennsylvania",1716,1591,125,42,42912,7.284382284382285
"Lincoln Park CDP, Pennsylvania",789,682,107,42,43496,13.561470215462613
"Lincoln University CDP, Pennsylvania",0,0,0,42,43544,
"Longfellow CDP, Pennsylvania",76,71,5,42,44528,6.578947368421052
"Loyalhanna CDP, Pennsylvania",1704,1546,158,42,45192,9.272300469483568
"Lumber City CDP, Pennsylvania",100,100,0,42,45452,0.0
"McConnellstown CDP, Pennsylvania",587,557,30,42,46016,5.110732538330494
"McElhattan CDP, Pennsylvania",239,214,25,42,46112,10.460251046025103
"McKnightstown CDP, Pennsylvania",137,86,51,42,46312,37.22627737226277
"Maitland CDP, Pennsylvania",183,131,52,42,46728,28.415300546448087
"Mammoth CDP, Pennsylvania",186,186,0,42,46800,0.0
"Mapletown CDP, Pennsylvania",57,49,8,42,47264,14.035087719298245
"Marianne CDP, Pennsylvania",452,433,19,42,47404,4.20353982300885
"Marienville CDP, Pennsylvania",499,199,300,42,47416,60.120240480961925
"Marion CDP, Pennsylvania",472,416,56,42,47464,11.864406779661017
"Martins Creek CDP, Pennsylvania",309,309,0,42,47896,0.0
"Masthope CDP, Pennsylvania",1447,315,1132,42,48032,78.2308223911541
"Mather CDP, Pennsylvania",241,194,47,42,48064,19.502074688796682
"Mattawana CDP, Pennsylvania",196,196,0,42,48072,0.0
"Meadowlands CDP, Pennsylvania",520,404,116,42,48320,22.30769230769231
"Mertztown CDP, Pennsylvania",350,333,17,42,48824,4.857142857142857
"Messiah College CDP, Pennsylvania",33,33,0,42,48868,0.0
"Milford Square CDP, Pennsylvania",320,320,0,42,49440,0.0
"Millerton CDP, Pennsylvania",151,134,17,42,49736,11.258278145695364
"Millsboro CDP, Pennsylvania",321,242,79,42,49880,24.610591900311526
"Millwood CDP, Pennsylvania",269,269,0,42,49960,0.0
"Mingoville CDP, Pennsylvania",276,276,0,42,50104,0.0
"Mocanaqua CDP, Pennsylvania",335,282,53,42,50208,15.82089552238806
"Mohrsville CDP, Pennsylvania",277,277,0,42,50280,0.0
"Montandon CDP, Pennsylvania",493,441,52,42,50552,10.547667342799189
"Montrose Manor CDP, Pennsylvania",215,215,0,42,50748,0.0
"Morgantown CDP, Pennsylvania",358,358,0,42,51016,0.0
"Morrisdale CDP, Pennsylvania",305,231,74,42,51120,24.262295081967213
"Moshannon CDP, Pennsylvania",150,147,3,42,51240,2.0
"Mount Aetna CDP, Pennsylvania",142,142,0,42,51320,0.0
"Mount Eagle CDP, Pennsylvania",27,27,0,42,51552,0.0
"Mount Morris CDP, Pennsylvania",418,345,73,42,51720,17.464114832535884
"Muhlenberg Park CDP, Pennsylvania",687,687,0,42,52216,0.0
"Muir CDP, Pennsylvania",235,215,20,42,52224,8.51063829787234
"Mundys Corner CDP, Pennsylvania",741,645,96,42,52312,12.955465587044534
"Muse CDP, Pennsylvania",997,914,83,42,52440,8.324974924774322
"Naomi CDP, Pennsylvania",73,73,0,42,52632,0.0
"Needmore CDP, Pennsylvania",46,43,3,42,52872,6.521739130434782
"New Bedford CDP, Pennsylvania",385,377,8,42,53192,2.0779220779220777
"New Berlinville CDP, Pennsylvania",709,691,18,42,53208,2.538787023977433
"New Columbia CDP, Pennsylvania",386,386,0,42,53432,0.0
"New Freeport CDP, Pennsylvania",35,22,13,42,53576,37.142857142857146
"New Jerusalem CDP, Pennsylvania",213,213,0,42,53728,0.0
"New Market CDP, Pennsylvania",405,405,0,42,53872,0.0
"New Salem CDP, Pennsylvania",308,202,106,42,54040,34.41558441558442
"New Schaefferstown CDP, Pennsylvania",77,74,3,42,54064,3.896103896103896
"New Tripoli CDP, Pennsylvania",341,341,0,42,54288,0.0
"Nittany CDP, Pennsylvania",309,309,0,42,54520,0.0
"Noblestown CDP, Pennsylvania",194,153,41,42,54568,21.1340206185567
"Norvelt CDP, Pennsylvania",410,401,9,42,55616,2.195121951219512
"North Vandergrift CDP, Pennsylvania",271,225,46,42,55480,16.974169741697416
"North Warren CDP, Pennsylvania",985,804,181,42,55520,18.3756345177665
"Northwood CDP, Pennsylvania",79,69,10,42,55584,12.658227848101266
"Noxen CDP, Pennsylvania",282,220,62,42,55728,21.98581560283688
"Oakland CDP (Cambria County), Pennsylvania",833,727,106,42,55996,12.725090036014405
"Oakland CDP (Lawrence County), Pennsylvania",599,567,32,42,56000,5.342237061769616
"Oberlin CDP, Pennsylvania",241,194,47,42,56264,19.502074688796682
"Oklahoma CDP, Pennsylvania",338,302,36,42,56488,10.650887573964498
"Oley CDP, Pennsylvania",516,470,46,42,56664,8.914728682170542
"Orviston CDP, Pennsylvania",58,52,6,42,57160,10.344827586206897
"Orwin CDP, Pennsylvania",131,105,26,42,57192,19.84732824427481
"Oval CDP, Pennsylvania",158,158,0,42,57376,0.0
"Palmdale CDP, Pennsylvania",495,486,9,42,57648,1.8181818181818181
"Pardeesville CDP, Pennsylvania",259,225,34,42,57904,13.127413127413126
"Paris CDP, Pennsylvania",407,348,59,42,57928,14.496314496314497
"Park Crest CDP, Pennsylvania",274,245,29,42,57968,10.583941605839415
"Pen Mar CDP, Pennsylvania",395,395,0,42,58776,0.0
"Penn Estates CDP, Pennsylvania",2376,1798,578,42,58948,24.326599326599325
"Pennside CDP, Pennsylvania",1844,1697,147,42,59176,7.971800433839479
"Penn State Erie (Behrend) CDP, Pennsylvania",0,0,0,42,59212,
"Pennwyn CDP, Pennsylvania",313,295,18,42,59304,5.7507987220447285
"Jeannette city, Pennsylvania",5020,4461,559,42,37784,11.135458167330677
"Arona borough, Pennsylvania",164,153,11,42,03120,6.707317073170732
"Irwin borough, Pennsylvania",2074,1941,133,42,37208,6.412729026036644
"New Kensington city, Pennsylvania",6990,5792,1198,42,53736,17.138769670958514
"Knoxville borough, Pennsylvania",300,269,31,42,40360,10.333333333333334
"Mansfield borough, Pennsylvania",1624,1353,271,42,47080,16.6871921182266
"Delta borough, Pennsylvania",288,220,68,42,18800,23.61111111111111
"Dillsburg borough, Pennsylvania",1094,1082,12,42,19208,1.0968921389396709
"Emigsville CDP, Pennsylvania",1188,1123,65,42,23560,5.4713804713804715
"Northwest Harborcreek CDP, Pennsylvania",3894,3634,260,42,55572,6.67693888032871
"Buck Run CDP, Pennsylvania",95,86,9,42,09896,9.473684210526317
"Shenandoah borough, Pennsylvania",3144,2007,1137,42,70056,36.16412213740458
"Sheppton CDP, Pennsylvania",120,102,18,42,70128,15.0
"Brookhaven borough, Pennsylvania",3698,3460,238,42,09080,6.435911303407248
"Big Beaver borough, Pennsylvania",822,758,64,42,06240,7.785888077858881
"Arnold city, Pennsylvania",2967,2257,710,42,03088,23.9298955173576
"Cokeburg borough, Pennsylvania",305,273,32,42,14896,10.491803278688524
"Dunlevy borough, Pennsylvania",175,165,10,42,20328,5.714285714285714
"Hollidaysburg borough, Pennsylvania",3029,2861,168,42,35224,5.546384945526577
"Broomall CDP, Pennsylvania",4191,4093,98,42,09248,2.338344070627535
"Marcus Hook borough, Pennsylvania",971,891,80,42,47344,8.2389289392379
"Morton borough, Pennsylvania",1179,1144,35,42,51176,2.9686174724342664
"Parkside borough, Pennsylvania",882,804,78,42,58176,8.843537414965986
"Upland borough, Pennsylvania",1419,1263,156,42,78712,10.993657505285412
"Mifflinburg borough, Pennsylvania",1694,1597,97,42,49288,5.7260920897284535
"Millheim borough, Pennsylvania",319,263,56,42,49768,17.55485893416928
"Uniontown city, Pennsylvania",5207,4360,847,42,78528,16.266564240445554
"Woodlyn CDP, Pennsylvania",4017,3606,411,42,86288,10.231516056758776
"Ebensburg borough, Pennsylvania",1833,1676,157,42,22144,8.56519367157665
"Lilly borough, Pennsylvania",404,377,27,42,43248,6.683168316831684
"Vintondale borough, Pennsylvania",181,163,18,42,80288,9.94475138121547
"Parkesburg borough, Pennsylvania",1408,1325,83,42,58032,5.894886363636364
"Spring City borough, Pennsylvania",1598,1540,58,42,72920,3.629536921151439
"Weissport East CDP, Pennsylvania",643,604,39,42,82088,6.065318818040436
"Toughkenamon CDP, Pennsylvania",453,410,43,42,77144,9.492273730684326
"West Chester borough, Pennsylvania",7718,7174,544,42,82704,7.048458149779736
"Rouzerville CDP, Pennsylvania",395,365,30,42,66448,7.59493670886076
"Cleona borough, Pennsylvania",925,889,36,42,14160,3.8918918918918917
"Washingtonville borough, Pennsylvania",116,68,48,42,81424,41.37931034482759
"Port Allegany borough, Pennsylvania",987,931,56,42,62088,5.673758865248227
"Edgewood borough, Pennsylvania",1605,1566,39,42,22520,2.4299065420560746
"Jefferson Hills borough, Pennsylvania",4820,4485,335,42,37955,6.950207468879668
"Millvale borough, Pennsylvania",2139,1879,260,42,49920,12.155212716222534
"Pittsburgh city, Pennsylvania",156617,136275,20342,42,61000,12.988372909709675
"Wall borough, Pennsylvania",353,264,89,42,80600,25.21246458923513
"Dushore borough, Pennsylvania",416,355,61,42,20528,14.663461538461538
"Forksville borough, Pennsylvania",110,69,41,42,26760,37.27272727272727
"Lorane CDP, Pennsylvania",1743,1711,32,42,44672,1.835915088927137
"Lyons borough, Pennsylvania",255,249,6,42,45752,2.3529411764705883
"New Morgan borough, Pennsylvania",6,6,0,42,53916,0.0
"Spring Ridge CDP, Pennsylvania",546,496,50,42,73318,9.157509157509157
"Macungie borough, Pennsylvania",1544,1436,108,42,46392,6.994818652849741
"Pymatuning North CDP, Pennsylvania",414,152,262,42,63011,63.28502415458937
"Coopersburg borough, Pennsylvania",1003,987,16,42,16056,1.5952143569292123
"Hokendauqua CDP, Pennsylvania",1250,1228,22,42,35120,1.76
"Schnecksville CDP, Pennsylvania",1362,1335,27,42,68192,1.9823788546255507
"North Catasauqua borough, Pennsylvania",1161,1101,60,42,54872,5.167958656330749
"Old Orchard CDP, Pennsylvania",1159,940,219,42,56624,18.895599654874893
"Driftwood borough, Pennsylvania",105,23,82,42,19976,78.0952380952381
"Foxburg borough, Pennsylvania",104,79,25,42,27112,24.03846153846154
"Knox borough, Pennsylvania",558,436,122,42,40272,21.863799283154123
"Rimersburg borough, Pennsylvania",401,370,31,42,64904,7.73067331670823
"Wrightsville borough, Pennsylvania",997,927,70,42,86640,7.021063189568706
"Flying Hills CDP, Pennsylvania",1380,1309,71,42,26397,5.144927536231884
"Kenhorst borough, Pennsylvania",1170,1105,65,42,39256,5.555555555555555
"Topton borough, Pennsylvania",871,831,40,42,77104,4.5924225028702645
"Orbisonia borough, Pennsylvania",223,201,22,42,56928,9.865470852017937
"East Petersburg borough, Pennsylvania",1944,1889,55,42,21688,2.8292181069958846
"Ephrata borough, Pennsylvania",5987,5731,256,42,23832,4.275931184232504
"Baldwin borough, Pennsylvania",8597,8011,586,42,03928,6.816331278352913
"Chester Heights borough, Pennsylvania",1075,1065,10,42,13232,0.9302325581395349
"Lima CDP, Pennsylvania",1245,1025,220,42,43272,17.670682730923694
"Ridley Park borough, Pennsylvania",2980,2768,212,42,64832,7.114093959731544
"Swarthmore borough, Pennsylvania",1964,1872,92,42,75648,4.684317718940937
"Darby borough, Pennsylvania",3856,3189,667,42,18152,17.29771784232365
"Lansdowne borough, Pennsylvania",4980,4521,459,42,41440,9.216867469879517
"Austin borough, Pennsylvania",275,213,62,42,03576,22.545454545454547
"Coudersport borough, Pennsylvania",1289,1052,237,42,16448,18.386346004654772
"Oswayo borough, Pennsylvania",79,55,24,42,57280,30.37974683544304
"Linntown CDP, Pennsylvania",741,616,125,42,43704,16.869095816464238
"Beallsville borough, Pennsylvania",238,194,44,42,04568,18.487394957983195
"Charleroi borough, Pennsylvania",2335,1712,623,42,12704,26.680942184154176
"Ellsworth borough, Pennsylvania",340,261,79,42,23296,23.235294117647058
"Gastonville CDP, Pennsylvania",1422,1208,214,42,28600,15.049226441631506
"New Eagle borough, Pennsylvania",1110,959,151,42,53496,13.603603603603604
"Volant borough, Pennsylvania",63,55,8,42,80368,12.698412698412698
"Harmonsburg CDP, Pennsylvania",201,172,29,42,32656,14.427860696517413
"Newport borough, Pennsylvania",736,656,80,42,53968,10.869565217391305
"Lincolnville CDP, Pennsylvania",65,56,9,42,43552,13.846153846153847
"Pymatuning South CDP, Pennsylvania",291,153,138,42,63013,47.42268041237113
"Marysville borough, Pennsylvania",1221,1140,81,42,47968,6.6339066339066335
"Jackson Center borough, Pennsylvania",80,76,4,42,37496,5.0
"West Middlesex borough, Pennsylvania",338,327,11,42,83496,3.2544378698224854
"Wormleysburg borough, Pennsylvania",1519,1414,105,42,86528,6.912442396313365
"Eau Claire borough, Pennsylvania",154,131,23,42,22128,14.935064935064934
"Petrolia borough, Pennsylvania",98,85,13,42,59672,13.26530612244898
"Prospect borough, Pennsylvania",501,460,41,42,62752,8.183632734530939
"Valencia borough, Pennsylvania",327,299,28,42,79504,8.56269113149847
"West Liberty borough, Pennsylvania",150,144,6,42,83376,4.0
"Adamsville CDP, Pennsylvania",38,31,7,42,00372,18.421052631578945
"Shippenville borough, Pennsylvania",243,220,23,42,70368,9.465020576131687
"Rochester borough, Pennsylvania",1889,1634,255,42,65392,13.499205929062995
"Belle Vernon borough, Pennsylvania",676,558,118,42,05288,17.45562130177515
"Brownsville borough, Pennsylvania",1360,937,423,42,09432,31.102941176470587
"Dayton borough, Pennsylvania",235,215,20,42,18400,8.51063829787234
"Timber Hills CDP, Pennsylvania",223,223,0,42,76724,0.0
"Danville borough, Pennsylvania",2548,2356,192,42,18136,7.535321821036106
"Mount Jewett borough, Pennsylvania",483,427,56,42,51632,11.594202898550725
"Smethport borough, Pennsylvania",748,705,43,42,71248,5.748663101604278
"West Hills CDP, Pennsylvania",492,492,0,42,83172,0.0
"Archbald borough, Pennsylvania",3130,2991,139,42,02832,4.440894568690096
"Clarks Summit borough, Pennsylvania",2389,2240,149,42,13880,6.236919213059858
"Oak Hills CDP, Pennsylvania",1126,1097,29,42,55969,2.575488454706927
"Hartstown CDP, Pennsylvania",77,71,6,42,32976,7.792207792207792
"Springboro borough, Pennsylvania",202,166,36,42,72872,17.82178217821782
"Woodcock borough, Pennsylvania",60,58,2,42,86160,3.3333333333333335
"Linesville borough, Pennsylvania",474,433,41,42,43656,8.649789029535865
"New Beaver borough, Pennsylvania",667,599,68,42,53184,10.194902548725636
"S.N.P.J. borough, Pennsylvania",74,18,56,42,71620,75.67567567567568
"Wampum borough, Pennsylvania",313,284,29,42,80880,9.26517571884984
"Liverpool borough, Pennsylvania",436,394,42,42,43968,9.63302752293578
"Millerstown borough, Pennsylvania",300,292,8,42,49720,2.666666666666667
"Colver CDP, Pennsylvania",487,448,39,42,15416,8.008213552361395
"Cresson borough, Pennsylvania",866,809,57,42,17136,6.581986143187067
"Dale borough, Pennsylvania",642,516,126,42,18000,19.626168224299064
"Gallitzin borough, Pennsylvania",799,685,114,42,28328,14.267834793491865
"Bally borough, Pennsylvania",471,463,8,42,03984,1.6985138004246285
"Centerport borough, Pennsylvania",113,113,0,42,12104,0.0
"Aspinwall borough, Pennsylvania",1389,1243,146,42,03320,10.51115910727142
"Avalon borough, Pennsylvania",3016,2487,529,42,03608,17.539787798408486
"Bell Acres borough, Pennsylvania",610,555,55,42,05216,9.01639344262295
"Berrysburg borough, Pennsylvania",168,139,29,42,05856,17.261904761904763
"Berwick borough, Pennsylvania",5016,4367,649,42,05888,12.938596491228072
"Jonestown CDP, Pennsylvania",50,36,14,42,38392,28.000000000000004
"Wilburton Number One CDP, Pennsylvania",118,87,31,42,85076,26.27118644067797
"Lawnton CDP, Pennsylvania",1691,1644,47,42,41944,2.7794204612655236
"Linglestown CDP, Pennsylvania",2568,2450,118,42,43672,4.595015576323988
"Pillow borough, Pennsylvania",109,99,10,42,60264,9.174311926605505
"Manorville borough, Pennsylvania",199,177,22,42,47064,11.055276381909549
"West Easton borough, Pennsylvania",554,529,25,42,82832,4.512635379061372
"Hawthorn borough, Pennsylvania",180,162,18,42,33216,10.0
"Markleysburg borough, Pennsylvania",104,77,27,42,47560,25.961538461538463
"Tunkhannock borough, Pennsylvania",851,794,57,42,77784,6.698002350176263
"Chester Hill borough, Pennsylvania",425,356,69,42,13240,16.235294117647058
"Jim Thorpe borough, Pennsylvania",2319,1947,372,42,38200,16.041397153945667
"Greencastle borough, Pennsylvania",1745,1672,73,42,30896,4.183381088825215
"Mont Alto borough, Pennsylvania",665,610,55,42,50544,8.270676691729323
"Lehighton borough, Pennsylvania",2671,2278,393,42,42472,14.71359041557469
"Summit Hill borough, Pennsylvania",1364,1200,164,42,75248,12.023460410557185
"Cornwall borough, Pennsylvania",1827,1775,52,42,16256,2.8461959496442253
"Lebanon city, Pennsylvania",11086,9943,1143,42,42168,10.310301280894823
"Fairchance borough, Pennsylvania",984,846,138,42,24536,14.02439024390244
"Fayette City borough, Pennsylvania",265,198,67,42,25456,25.28301886792453
"Masontown borough, Pennsylvania",1648,1521,127,42,48000,7.70631067961165
"Harrison City CDP, Pennsylvania",49,49,0,42,32864,0.0
"Lynnwood-Pricedale CDP, Pennsylvania",1073,893,180,42,45732,16.775396085740912
"Madison borough, Pennsylvania",191,175,16,42,46488,8.37696335078534
"Mount Pleasant borough, Pennsylvania",2211,1929,282,42,51880,12.754409769335142
"South Greensburg borough, Pennsylvania",1185,1044,141,42,72192,11.89873417721519
"Southwest Greensburg borough, Pennsylvania",1170,995,175,42,72616,14.957264957264957
"Youngwood borough, Pennsylvania",1666,1420,246,42,87232,14.765906362545017
"Beaver borough, Pennsylvania",2281,2022,259,42,04688,11.354669004822446
"Monaca borough, Pennsylvania",2936,2705,231,42,50320,7.867847411444141
"Ohioville borough, Pennsylvania",1444,1314,130,42,56432,9.002770083102494
"Matamoras borough, Pennsylvania",1066,936,130,42,48048,12.195121951219512
"Coaldale borough (Bedford County), Pennsylvania",72,62,10,42,14584,13.88888888888889
"Hyndman borough, Pennsylvania",386,324,62,42,36640,16.06217616580311
"New Paris borough, Pennsylvania",83,79,4,42,53928,4.819277108433735
"Burlington borough, Pennsylvania",82,64,18,42,10240,21.951219512195124
"Towanda borough, Pennsylvania",1419,1210,209,42,77168,14.728682170542637
"West Kittanning borough, Pennsylvania",612,573,39,42,83248,6.372549019607843
"Blakely borough, Pennsylvania",3081,2891,190,42,06928,6.166828951639078
"Glenburn CDP, Pennsylvania",435,407,28,42,29496,6.436781609195402
"Jermyn borough, Pennsylvania",1064,968,96,42,38096,9.022556390977442
"Moscow borough, Pennsylvania",868,777,91,42,51208,10.483870967741936
"New Castle Northwest CDP, Pennsylvania",629,629,0,42,53392,0.0
"New Wilmington borough, Pennsylvania",654,562,92,42,54352,14.067278287461773
"Duncannon borough, Pennsylvania",799,690,109,42,20240,13.642052565707132
"Mechanicsburg borough, Pennsylvania",4526,4267,259,42,48376,5.722492266902342
"Evans City borough, Pennsylvania",852,833,19,42,24248,2.2300469483568075
"Harrisville borough, Pennsylvania",334,329,5,42,32896,1.4970059880239521
"Meridian CDP, Pennsylvania",1668,1643,25,42,48728,1.498800959232614
"Zelienople borough, Pennsylvania",1863,1805,58,42,87272,3.113258185721954
"Pymatuning Central CDP, Pennsylvania",2916,1043,1873,42,63009,64.23182441700959
"Townville borough, Pennsylvania",139,124,15,42,77232,10.79136690647482
"St. Petersburg borough, Pennsylvania",150,135,15,42,67384,10.0
"Ehrenfeld borough, Pennsylvania",93,71,22,42,22712,23.655913978494624
"Northern Cambria borough, Pennsylvania",1735,1533,202,42,55000,11.642651296829971
"Summerhill borough, Pennsylvania",221,198,23,42,75136,10.407239819004525
"Vinco CDP, Pennsylvania",576,503,73,42,80264,12.67361111111111
"Westmont borough, Pennsylvania",2285,2027,258,42,83584,11.291028446389497
"Grove City borough, Pennsylvania",2816,2507,309,42,31656,10.973011363636363
"New Milford borough, Pennsylvania",440,375,65,42,53880,14.772727272727273
"McDonald borough, Pennsylvania",1113,945,168,42,46072,15.09433962264151
"New Kingstown CDP, Pennsylvania",278,278,0,42,53752,0.0
"McGovern CDP, Pennsylvania",1239,1118,121,42,46160,9.76594027441485
"Stoneboro borough, Pennsylvania",517,445,72,42,74288,13.926499032882012
"Carlisle borough, Pennsylvania",8344,7531,813,42,11272,9.74352828379674
"Kenilworth CDP, Pennsylvania",795,773,22,42,39272,2.767295597484277
"Garden View CDP, Pennsylvania",1314,1259,55,42,28456,4.185692541856925
"Montoursville borough, Pennsylvania",2019,1931,88,42,50720,4.358593363051015
"Williamsport city, Pennsylvania",13153,11355,1798,42,85312,13.669885197293393
"Oxford borough, Pennsylvania",2093,1870,223,42,57480,10.654562828475871
"Woodward CDP, Pennsylvania",77,57,20,42,86432,25.97402597402597
"Glen Hope borough, Pennsylvania",79,70,9,42,29632,11.39240506329114
"Mahaffey borough, Pennsylvania",156,149,7,42,46568,4.487179487179487
"New Washington borough, Pennsylvania",37,18,19,42,54344,51.35135135135135
"Osceola Mills borough, Pennsylvania",519,459,60,42,57232,11.560693641618498
"Treasure Lake CDP, Pennsylvania",2052,1226,826,42,77335,40.253411306042885
"Wallaceton borough, Pennsylvania",130,129,1,42,80640,0.7692307692307693
"Croydon CDP, Pennsylvania",3989,3713,276,42,17448,6.919027325144146
"Langhorne Manor borough, Pennsylvania",317,309,8,42,41416,2.5236593059936907
"Richlandtown borough, Pennsylvania",477,445,32,42,64584,6.708595387840671
"Richfield CDP, Pennsylvania",258,231,27,42,64488,10.465116279069768
"Biglerville borough, Pennsylvania",515,459,56,42,06296,10.87378640776699
"Carroll Valley borough, Pennsylvania",1655,1518,137,42,11472,8.277945619335348
"Fairfield borough, Pennsylvania",275,244,31,42,24560,11.272727272727273
"Nemacolin CDP, Pennsylvania",382,340,42,42,52968,10.99476439790576
"Rices Landing borough, Pennsylvania",229,192,37,42,64432,16.157205240174672
"Valley View CDP (York County), Pennsylvania",1109,1102,7,42,79682,0.6311992786293958
"Steelton borough, Pennsylvania",2387,2065,322,42,73888,13.48973607038123
"Lawrenceville borough, Pennsylvania",299,233,66,42,42016,22.073578595317723
"Dover borough, Pennsylvania",847,780,67,42,19696,7.910271546635183
"West York borough, Pennsylvania",1962,1722,240,42,84288,12.232415902140673
"Laceyville borough, Pennsylvania",213,179,34,42,40744,15.96244131455399
"Allenport borough, Pennsylvania",274,233,41,42,00988,14.963503649635038
"California borough, Pennsylvania",3045,2144,901,42,10768,29.589490968801314
"Centerville borough (Washington County), Pennsylvania",1416,1274,142,42,12224,10.028248587570623
"Sutersville borough, Pennsylvania",290,208,82,42,75584,28.27586206896552
"South Heights borough, Pennsylvania",210,181,29,42,72216,13.80952380952381
"West Mayfield borough, Pennsylvania",514,466,48,42,83472,9.33852140077821
"Blue Bell CDP, Pennsylvania",2597,2381,216,42,07224,8.317289179822874
"Bryn Mawr CDP, Pennsylvania",1358,1224,134,42,09728,9.867452135493373
"Tionesta borough, Pennsylvania",291,185,106,42,76848,36.42611683848797
"Hopwood CDP, Pennsylvania",849,784,65,42,35728,7.656065959952886
"Ohiopyle borough, Pennsylvania",22,7,15,42,56408,68.18181818181817
"Perryopolis borough, Pennsylvania",938,829,109,42,59520,11.620469083155651
"Derry borough, Pennsylvania",1349,1138,211,42,18960,15.6412157153447
"Export borough, Pennsylvania",500,423,77,42,24432,15.4
"Mount Union borough, Pennsylvania",1367,1109,258,42,51984,18.873445501097294
"Coalmont borough, Pennsylvania",51,36,15,42,14640,29.411764705882355
"Dudley borough, Pennsylvania",104,86,18,42,20152,17.307692307692307
"Mapleton borough, Pennsylvania",217,167,50,42,47248,23.04147465437788
"Shirleysburg borough, Pennsylvania",57,55,2,42,70408,3.508771929824561
"Reynoldsville borough, Pennsylvania",1399,1219,180,42,64376,12.866333095067905
"Worthville borough, Pennsylvania",30,30,0,42,86568,0.0
"Christiana borough, Pennsylvania",371,339,32,42,13512,8.62533692722372
"Columbia borough, Pennsylvania",4768,4394,374,42,15384,7.843959731543625
"Pine Ridge CDP, Pennsylvania",1190,868,322,42,60547,27.058823529411764
"Manheim borough, Pennsylvania",1995,1916,79,42,46888,3.9598997493734336
"Penryn CDP, Pennsylvania",299,299,0,42,59344,0.0
"Pikes Creek CDP, Pennsylvania",133,106,27,42,60224,20.30075187969925
"Plains CDP, Pennsylvania",2063,1919,144,42,61112,6.98012603005332
"Glen Campbell borough, Pennsylvania",108,90,18,42,29512,16.666666666666664
"Rossiter CDP, Pennsylvania",293,236,57,42,66304,19.453924914675767
"Ashley borough, Pennsylvania",1408,1130,278,42,03272,19.744318181818183
"Avoca borough, Pennsylvania",1246,1070,176,42,03640,14.125200642054574
"Laflin borough, Pennsylvania",649,623,26,42,40848,4.006163328197227
"Laurel Run borough, Pennsylvania",250,232,18,42,41848,7.199999999999999
"Bellefonte borough, Pennsylvania",3003,2702,301,42,05256,10.023310023310025
"Blanchard CDP, Pennsylvania",261,231,30,42,06960,11.494252873563218
"Madisonburg CDP, Pennsylvania",78,78,0,42,46504,0.0
"Zion CDP, Pennsylvania",797,797,0,42,87320,0.0
"Belleville CDP, Pennsylvania",801,794,7,42,05304,0.8739076154806492
"Muncy borough, Pennsylvania",1119,996,123,42,52264,10.991957104557642
"Lenhartsville borough, Pennsylvania",74,64,10,42,42688,13.513513513513514
"Reading city, Pennsylvania",33656,28805,4851,42,63624,14.413477537437606
"Wernersville borough, Pennsylvania",1256,1200,56,42,82296,4.45859872611465
"Saltillo borough, Pennsylvania",148,131,17,42,67632,11.486486486486488
"Brickerville CDP, Pennsylvania",503,503,0,42,08504,0.0
"Lancaster city, Pennsylvania",24044,22118,1926,42,41216,8.010314423556812
"East McKeesport borough, Pennsylvania",1164,987,177,42,21444,15.206185567010309
"Dublin borough, Pennsylvania",914,887,27,42,20104,2.954048140043764
"Brisbin borough, Pennsylvania",167,134,33,42,08744,19.760479041916167
"Plymptonville CDP, Pennsylvania",473,457,16,42,61704,3.382663847780127
"Hyde CDP, Pennsylvania",692,650,42,42,36568,6.069364161849711
"Levittown CDP, Pennsylvania",18857,18022,835,42,42928,4.428063848968552
"Morrisville borough, Pennsylvania",3787,3492,295,42,51144,7.789807235278584
"Creekside borough, Pennsylvania",135,122,13,42,17024,9.62962962962963
"Ernest borough, Pennsylvania",231,200,31,42,24040,13.41991341991342
"Plumville borough, Pennsylvania",136,118,18,42,61632,13.23529411764706
"Smicksburg borough, Pennsylvania",22,17,5,42,71256,22.727272727272727
"Courtdale borough, Pennsylvania",319,285,34,42,16568,10.658307210031348
"Duncansville borough, Pennsylvania",643,616,27,42,20248,4.199066874027993
"Martinsburg borough, Pennsylvania",898,811,87,42,47872,9.688195991091314
"Aldan borough, Pennsylvania",1936,1742,194,42,00676,10.020661157024794
"Sewickley Hills borough, Pennsylvania",271,259,12,42,69416,4.428044280442804
"Sharpsburg borough, Pennsylvania",1845,1590,255,42,69776,13.821138211382115
"Springdale borough, Pennsylvania",1738,1586,152,42,72960,8.745684695051784
"Laporte borough, Pennsylvania",226,96,130,42,41512,57.52212389380531
"Oakmont borough, Pennsylvania",3379,3192,187,42,56088,5.534181710565256
"Russellton CDP, Pennsylvania",845,753,92,42,66832,10.88757396449704
"Boswell borough, Pennsylvania",674,581,93,42,07712,13.798219584569733
"Hooversville borough, Pennsylvania",322,284,38,42,35608,11.801242236024844
"New Baltimore borough, Pennsylvania",89,80,9,42,53168,10.112359550561797
"Waymart borough, Pennsylvania",540,429,111,42,81712,20.555555555555554
"Bloomsburg town, Pennsylvania",5156,4759,397,42,07128,7.699767261442979
"Espy CDP, Pennsylvania",730,721,9,42,24088,1.2328767123287672
"Tullytown borough, Pennsylvania",794,764,30,42,77744,3.7783375314861463
"Mifflintown borough, Pennsylvania",512,461,51,42,49304,9.9609375
"Armagh borough, Pennsylvania",65,60,5,42,03032,7.6923076923076925
"Black Lick CDP, Pennsylvania",740,602,138,42,06744,18.64864864864865
"Commodore CDP, Pennsylvania",185,185,0,42,15464,0.0
"Shamokin Dam borough, Pennsylvania",898,859,39,42,69616,4.342984409799555
"Heilwood CDP, Pennsylvania",254,229,25,42,33672,9.84251968503937
"Lucerne Mines CDP, Pennsylvania",370,326,44,42,45312,11.891891891891893
"Paxtonville CDP, Pennsylvania",95,95,0,42,58536,0.0
"Chapman borough, Pennsylvania",84,80,4,42,12656,4.761904761904762
"East Bangor borough, Pennsylvania",360,342,18,42,20776,5.0
"Freemansburg borough, Pennsylvania",1094,976,118,42,27760,10.786106032906764
"Glendon borough, Pennsylvania",161,149,12,42,29568,7.453416149068323
"Tatamy borough, Pennsylvania",414,388,26,42,76144,6.280193236714976
"Callensburg borough, Pennsylvania",65,48,17,42,10792,26.153846153846157
"Sligo borough, Pennsylvania",254,216,38,42,71176,14.960629921259844
"Claysville borough, Pennsylvania",362,337,25,42,14000,6.906077348066299
"Coal Center borough, Pennsylvania",69,37,32,42,14568,46.3768115942029
"Elco borough, Pennsylvania",145,103,42,42,22800,28.965517241379313
"Hermitage city, Pennsylvania",7875,7237,638,42,34064,8.101587301587301
"Yeadon borough, Pennsylvania",4800,4378,422,42,86968,8.791666666666668
"New Berlin borough, Pennsylvania",379,356,23,42,53200,6.068601583113456
"Trappe borough, Pennsylvania",1388,1339,49,42,77304,3.5302593659942363
"Berlin borough, Pennsylvania",921,820,101,42,05776,10.966340933767643
"Whitaker borough, Pennsylvania",599,524,75,42,84440,12.520868113522537
"Whitehall borough, Pennsylvania",6170,5734,436,42,84512,7.06645056726094
"Eagles Mere borough, Pennsylvania",364,67,297,42,20648,81.5934065934066
"York city, Pennsylvania",19196,16442,2754,42,87048,14.34673890393832
"Yorkana borough, Pennsylvania",94,87,7,42,87064,7.446808510638298
"Benton borough, Pennsylvania",402,306,96,42,05680,23.88059701492537
"Freeland borough, Pennsylvania",1660,1352,308,42,27744,18.55421686746988
"Hazleton city, Pennsylvania",10708,8997,1711,42,33408,15.978707508404929
"Pringle borough, Pennsylvania",496,396,100,42,62712,20.161290322580644
"Lansdale borough, Pennsylvania",6930,6476,454,42,41432,6.55122655122655
"Central City borough, Pennsylvania",615,484,131,42,12296,21.30081300813008
"Grapeville CDP, Pennsylvania",182,162,20,42,30512,10.989010989010989
"Lawson Heights CDP, Pennsylvania",1012,929,83,42,42032,8.201581027667984
"New Florence borough, Pennsylvania",316,288,28,42,53544,8.860759493670885
"New Stanton borough, Pennsylvania",1026,964,62,42,54104,6.042884990253411
"North Irwin borough, Pennsylvania",403,385,18,42,55136,4.466501240694789
"Seward borough, Pennsylvania",226,163,63,42,69368,27.876106194690266
"Smithton borough, Pennsylvania",202,175,27,42,71424,13.366336633663368
"Trafford borough, Pennsylvania",1618,1390,228,42,77272,14.091470951792337
"West Leechburg borough, Pennsylvania",687,641,46,42,83328,6.695778748180495
"Aliquippa city, Pennsylvania",5665,4522,1143,42,00820,20.176522506619595
"Spring Mount CDP, Pennsylvania",958,898,60,42,73312,6.263048016701461
"Penn Wynne CDP, Pennsylvania",2336,2229,107,42,59312,4.580479452054795
"Red Hill borough, Pennsylvania",1144,1077,67,42,63808,5.856643356643357
"Skippack CDP, Pennsylvania",1704,1571,133,42,71008,7.805164319248827
"Erie city, Pennsylvania",45325,40182,5143,42,24000,11.346938775510203
"North East borough, Pennsylvania",1793,1695,98,42,54952,5.465699944227551
"Lebanon South CDP, Pennsylvania",1041,993,48,42,42192,4.610951008645533
"Mount Gretna borough, Pennsylvania",209,102,107,42,51568,51.196172248803826
"Myerstown borough, Pennsylvania",1415,1261,154,42,52488,10.883392226148409
"Palmyra borough, Pennsylvania",3745,3474,271,42,57720,7.236315086782376
"Pleasant Hill CDP, Pennsylvania",1015,987,28,42,61312,2.7586206896551726
"Quentin CDP, Pennsylvania",255,223,32,42,63160,12.549019607843137
"Richland borough, Pennsylvania",637,607,30,42,64560,4.709576138147567
"Bradford city, Pennsylvania",4280,3742,538,42,08040,12.570093457943926
"King of Prussia CDP, Pennsylvania",9763,8784,979,42,39736,10.0276554337806
"Eldred borough, Pennsylvania",347,301,46,42,22888,13.256484149855908
"Kane borough, Pennsylvania",1810,1559,251,42,38688,13.867403314917127
"Lewis Run borough, Pennsylvania",361,314,47,42,42984,13.019390581717452
"Kulpsville CDP, Pennsylvania",3625,3552,73,42,40608,2.013793103448276
"Maple Glen CDP, Pennsylvania",2350,2298,52,42,47152,2.2127659574468086
"Houserville CDP, Pennsylvania",794,760,34,42,35888,4.282115869017632
"Pleasant Gap CDP, Pennsylvania",1294,1294,0,42,61232,0.0
"Rebersburg CDP, Pennsylvania",214,197,17,42,63688,7.943925233644859
"Spring Mills CDP, Pennsylvania",146,126,20,42,73288,13.698630136986301
"North Philipsburg CDP, Pennsylvania",292,229,63,42,55304,21.575342465753426
"Pine Grove Mills CDP, Pennsylvania",629,581,48,42,60496,7.631160572337042
"Versailles borough, Pennsylvania",886,802,84,42,80040,9.480812641083523
"West Homestead borough, Pennsylvania",956,833,123,42,83200,12.866108786610878
"Confluence borough, Pennsylvania",412,282,130,42,15680,31.55339805825243
"Indian Lake borough, Pennsylvania",622,213,409,42,36888,65.7556270096463
"Tyrone borough, Pennsylvania",2416,2280,136,42,78168,5.629139072847682
"Hatboro borough, Pennsylvania",3058,2991,67,42,33088,2.190974493132767
"Hatfield borough, Pennsylvania",1261,1220,41,42,33112,3.251387787470262
"Mayfield borough, Pennsylvania",828,735,93,42,48176,11.231884057971014
"Swissvale borough, Pennsylvania",5197,4454,743,42,75816,14.296709640177024
"Brodheadsville CDP, Pennsylvania",728,601,127,42,09000,17.445054945054945
"Paradise CDP, Pennsylvania",389,381,8,42,57840,2.056555269922879
"Bellevue borough, Pennsylvania",5124,4558,566,42,05312,11.046057767369243
"Castle Shannon borough, Pennsylvania",4251,3909,342,42,11680,8.045165843330981
"Churchill borough, Pennsylvania",1337,1260,77,42,13608,5.7591623036649215
"Coraopolis borough, Pennsylvania",3122,2655,467,42,16144,14.9583600256246
"Curtisville CDP, Pennsylvania",595,576,19,42,17832,3.1932773109243695
"Etna borough, Pennsylvania",1587,1532,55,42,24160,3.465658475110271
"Honesdale borough, Pennsylvania",2269,2011,258,42,35520,11.370647862494492
"Delaware Water Gap borough, Pennsylvania",324,275,49,42,18736,15.123456790123457
"Williamstown borough, Pennsylvania",652,495,157,42,85320,24.079754601226995
"Blossburg borough, Pennsylvania",767,696,71,42,07160,9.256844850065189
"Dallastown borough, Pennsylvania",1748,1706,42,42,18072,2.402745995423341
"Jacobus borough, Pennsylvania",668,637,31,42,37640,4.640718562874251
"Pennville CDP, Pennsylvania",909,843,66,42,59296,7.2607260726072615
"Jenkintown borough, Pennsylvania",1848,1829,19,42,38000,1.0281385281385282
"Brackenridge borough, Pennsylvania",1616,1386,230,42,07976,14.232673267326732
"Cheswick borough, Pennsylvania",887,809,78,42,13392,8.793686583990981
"Flourtown CDP, Pennsylvania",1719,1694,25,42,26376,1.4543339150668992
"Fort Washington CDP, Pennsylvania",2093,2019,74,42,26872,3.535594839942666
"Glenside CDP, Pennsylvania",2939,2824,115,42,29808,3.912895542701599
"Montgomeryville CDP, Pennsylvania",4677,4631,46,42,50672,0.9835364549925165
"North Wales borough, Pennsylvania",1357,1310,47,42,55512,3.4635224760501107
"Oreland CDP, Pennsylvania",2198,2138,60,42,57024,2.72975432211101
"Pennsburg borough, Pennsylvania",1470,1390,80,42,59120,5.442176870748299
"Stowe CDP, Pennsylvania",1652,1531,121,42,74660,7.324455205811138
"Wattsburg borough, Pennsylvania",203,192,11,42,81648,5.41871921182266
"Beurys Lake CDP, Pennsylvania",103,60,43,42,06171,41.74757281553398
"Coaldale borough (Schuylkill County), Pennsylvania",1180,1015,165,42,14600,13.983050847457626
"Friedensburg CDP, Pennsylvania",426,406,20,42,27936,4.694835680751173
"Minersville borough, Pennsylvania",2260,1892,368,42,50088,16.283185840707965
"Tuscarora CDP, Pennsylvania",469,420,49,42,77968,10.44776119402985
"Darlington borough, Pennsylvania",96,82,14,42,18192,14.583333333333334
"Homewood borough, Pennsylvania",56,52,4,42,35488,7.142857142857142
"Eastvale borough, Pennsylvania",124,82,42,42,21968,33.87096774193548
"Ellwood City borough, Pennsylvania",4048,3555,493,42,23304,12.178853754940713
"Freedom borough, Pennsylvania",713,623,90,42,27712,12.622720897615707
"Midland borough, Pennsylvania",1345,1217,128,42,49184,9.516728624535316
"Ambler borough, Pennsylvania",2730,2657,73,42,02264,2.673992673992674
"Monroe borough, Pennsylvania",254,245,9,42,50432,3.543307086614173
"Troy borough, Pennsylvania",631,554,77,42,77584,12.202852614896988
"Addison borough, Pennsylvania",123,93,30,42,00396,24.390243902439025
"Callimont borough, Pennsylvania",33,27,6,42,10808,18.181818181818183
"Casselman borough, Pennsylvania",31,28,3,42,11624,9.67741935483871
"Bethany borough, Pennsylvania",114,94,20,42,05976,17.543859649122805
"Prompton borough, Pennsylvania",132,105,27,42,62744,20.454545454545457
"Pocono Pines CDP, Pennsylvania",2211,509,1702,42,61768,76.97874265038445
"Pleasantville borough (Bedford County), Pennsylvania",79,61,18,42,61496,22.78481012658228
"Sayre borough, Pennsylvania",2748,2523,225,42,68096,8.187772925764191
"Almedia CDP, Pennsylvania",499,446,53,42,02088,10.62124248496994
"Centralia borough, Pennsylvania",5,5,0,42,12312,0.0
"Foundryville CDP, Pennsylvania",54,54,0,42,26984,0.0
"Jamison City CDP, Pennsylvania",143,68,75,42,37728,52.44755244755245
"Lightstreet CDP, Pennsylvania",466,449,17,42,43224,3.648068669527897
"Orangeville borough, Pennsylvania",167,114,53,42,56912,31.736526946107784
"Lock Haven city, Pennsylvania",3992,3512,480,42,44128,12.024048096192384
"Mill Hall borough, Pennsylvania",744,676,68,42,49760,9.13978494623656
"Belmont CDP, Pennsylvania",1360,1184,176,42,05400,12.941176470588237
"Seven Springs borough, Pennsylvania",104,18,86,42,69336,82.6923076923077
"Wellersburg borough, Pennsylvania",89,81,8,42,82128,8.98876404494382
"East Stroudsburg borough, Pennsylvania",3772,3269,503,42,21872,13.33510074231177
"Mountainhome CDP, Pennsylvania",654,545,109,42,51344,16.666666666666664
"Stroudsburg borough, Pennsylvania",2665,2322,343,42,74888,12.870544090056285
"Hopewell borough, Pennsylvania",108,99,9,42,35648,8.333333333333332
"St. Clairsville borough, Pennsylvania",41,32,9,42,67256,21.951219512195124
"Schellsburg borough, Pennsylvania",157,134,23,42,68152,14.64968152866242
"Athens borough, Pennsylvania",1463,1315,148,42,03392,10.1161995898838
"Loretto borough, Pennsylvania",151,103,48,42,44704,31.788079470198678
"Penndel borough, Pennsylvania",1194,1142,52,42,58936,4.355108877721943
"Village Shires CDP, Pennsylvania",1840,1688,152,42,80229,8.26086956521739
"Rouseville borough, Pennsylvania",229,187,42,42,66440,18.340611353711793
"Tremont borough, Pennsylvania",720,645,75,42,77392,10.416666666666668
"East Greenville borough, Pennsylvania",1171,1065,106,42,21200,9.052092228864218
"Narberth borough, Pennsylvania",1971,1892,79,42,52664,4.008117706747844
"Pottsgrove CDP, Pennsylvania",1439,1314,125,42,62396,8.686587908269631
"Pottstown borough, Pennsylvania",10302,9076,1226,42,62416,11.900601824888371
"Tresckow CDP, Pennsylvania",485,411,74,42,77424,15.257731958762887
"Annville CDP, Pennsylvania",1648,1496,152,42,02608,9.223300970873787
"Avon CDP, Pennsylvania",687,621,66,42,03648,9.606986899563319
"Fort Indiantown Gap CDP, Pennsylvania",28,28,0,42,26812,0.0
"Jonestown borough, Pennsylvania",696,666,30,42,38400,4.310344827586207
"Newmanstown CDP, Pennsylvania",948,910,38,42,53856,4.008438818565401
"Elkland borough, Pennsylvania",812,744,68,42,23152,8.374384236453201
"Roseville borough, Pennsylvania",63,52,11,42,66232,17.46031746031746
"Hanover borough, Pennsylvania",7625,6930,695,42,32448,9.114754098360656
"Red Lion borough, Pennsylvania",2635,2417,218,42,63840,8.273244781783681
"Stewartstown borough, Pennsylvania",987,900,87,42,74104,8.814589665653495
"Union City borough, Pennsylvania",1458,1374,84,42,78448,5.761316872427984
"Valley Green CDP, Pennsylvania",1632,1579,53,42,79640,3.2475490196078436
"Girard borough, Pennsylvania",1213,1213,0,42,29232,0.0
"Lawrence Park CDP, Pennsylvania",1607,1515,92,42,41992,5.7249533291848165
"Wesleyville borough, Pennsylvania",1552,1418,134,42,82344,8.6340206185567
"Mechanicsville borough, Pennsylvania",209,188,21,42,48448,10.047846889952153
"Mount Carbon borough, Pennsylvania",42,33,9,42,51488,21.428571428571427
"Orwigsburg borough, Pennsylvania",1298,1241,57,42,57184,4.391371340523883
"Ravine CDP, Pennsylvania",250,250,0,42,63536,0.0
"Schuylkill Haven borough, Pennsylvania",2384,2232,152,42,68312,6.375838926174497
"Valley View CDP (Schuylkill County), Pennsylvania",765,658,107,42,79680,13.986928104575163
"Riverside borough, Pennsylvania",919,864,55,42,65112,5.984766050054406
"Liberty borough (Tioga County), Pennsylvania",94,86,8,42,43128,8.51063829787234
"Cross Roads borough, Pennsylvania",195,177,18,42,17416,9.230769230769232
"Felton borough, Pennsylvania",209,188,21,42,25584,10.047846889952153
"Grantley CDP, Pennsylvania",844,780,64,42,30435,7.5829383886255926
"Wilkinsburg borough, Pennsylvania",10971,8773,2198,42,85188,20.034636769665482
"Avis borough, Pennsylvania",691,578,113,42,03632,16.35311143270622
"Ulysses borough, Pennsylvania",311,273,38,42,78240,12.218649517684888
"Manns Choice borough, Pennsylvania",138,96,42,42,46944,30.434782608695656
"Jerseytown CDP, Pennsylvania",56,39,17,42,38152,30.357142857142854
"Millersburg borough, Pennsylvania",1438,1173,265,42,49680,18.42837273991655
"Clearfield borough, Pennsylvania",3295,2836,459,42,14064,13.93019726858877
"Factoryville borough, Pennsylvania",433,352,81,42,24488,18.706697459584294
"Spring Hill CDP, Pennsylvania",331,311,20,42,73224,6.042296072507553
"Warminster Heights CDP, Pennsylvania",1603,1531,72,42,80962,4.491578290704928
"Houtzdale borough, Pennsylvania",358,298,60,42,35928,16.75977653631285
"Tarentum borough, Pennsylvania",2452,2143,309,42,76104,12.60195758564437
"Everett borough, Pennsylvania",996,837,159,42,24304,15.963855421686745
"Leetsdale borough, Pennsylvania",637,573,64,42,42392,10.047095761381476
"Clarion borough, Pennsylvania",2617,2203,414,42,13800,15.819640810087886
"Franklin borough, Pennsylvania",196,127,69,42,27360,35.204081632653065
"Collingdale borough, Pennsylvania",3727,3218,509,42,15232,13.657096860745908
"Colwyn borough, Pennsylvania",1016,850,166,42,15432,16.338582677165352
"Mercersburg borough, Pennsylvania",793,751,42,42,48704,5.296343001261034
"East Side borough, Pennsylvania",138,127,11,42,21816,7.971014492753622
"Weissport borough, Pennsylvania",186,171,15,42,82080,8.064516129032258
"Fredericksburg CDP (Lebanon County), Pennsylvania",642,624,18,42,27656,2.803738317757009
"Sand Hill CDP, Pennsylvania",987,954,33,42,67744,3.343465045592705
"Mill Village borough, Pennsylvania",163,155,8,42,49936,4.9079754601226995
"Donaldson CDP, Pennsylvania",130,104,26,42,19432,20.0
"McAdoo borough, Pennsylvania",1238,1004,234,42,45824,18.901453957996768
"Mahanoy City borough, Pennsylvania",2365,1575,790,42,46592,33.40380549682875
"Marlin CDP, Pennsylvania",249,214,35,42,47600,14.056224899598394
"Leith-Hatfield CDP, Pennsylvania",1222,1076,146,42,42596,11.947626841243862
"Republic CDP, Pennsylvania",537,463,74,42,64224,13.780260707635009
"Smithfield borough, Pennsylvania",374,327,47,42,71320,12.566844919786096
"Vanderbilt borough, Pennsylvania",170,154,16,42,79768,9.411764705882353
"Evansburg CDP, Pennsylvania",795,795,0,42,24240,0.0
"Halfway House CDP, Pennsylvania",1034,973,61,42,32024,5.899419729206963
"Plymouth Meeting CDP, Pennsylvania",3000,2797,203,42,61688,6.766666666666667
"Rockledge borough, Pennsylvania",1109,1076,33,42,65568,2.9756537421100093
"Churchville CDP, Pennsylvania",1334,1307,27,42,13648,2.0239880059970012
"Doylestown borough, Pennsylvania",4091,3786,305,42,19784,7.455389880224884
"Perkasie borough, Pennsylvania",3353,3282,71,42,59384,2.1175067104085894
"Langhorne borough, Pennsylvania",607,550,57,42,41392,9.390444810543658
"New Hope borough, Pennsylvania",1416,1157,259,42,53712,18.2909604519774
"Newtown borough, Pennsylvania",985,918,67,42,54184,6.802030456852792
"Silverdale borough, Pennsylvania",267,264,3,42,70744,1.1235955056179776
"Burnham borough, Pennsylvania",953,847,106,42,10256,11.12277019937041
"Milesburg borough, Pennsylvania",482,404,78,42,49368,16.182572614107883
"Monument CDP, Pennsylvania",89,74,15,42,50760,16.853932584269664
"Pine Glen CDP, Pennsylvania",66,66,0,42,60432,0.0
"Montgomery borough, Pennsylvania",661,578,83,42,50632,12.556732223903177
"Deemston borough, Pennsylvania",365,329,36,42,18496,9.863013698630137
"East York CDP, Pennsylvania",3609,3438,171,42,22104,4.738154613466334
"Goldsboro borough, Pennsylvania",395,371,24,42,30016,6.075949367088607
"Mercer borough, Pennsylvania",988,821,167,42,48696,16.902834008097166
"New Lebanon borough, Pennsylvania",93,80,13,42,53768,13.978494623655912
"Wheatland borough, Pennsylvania",372,358,14,42,84376,3.763440860215054
"Lower Allen CDP, Pennsylvania",3195,3105,90,42,44824,2.8169014084507045
"Harmony borough, Pennsylvania",389,378,11,42,32688,2.827763496143959
"Blooming Valley borough, Pennsylvania",143,126,17,42,07120,11.888111888111888
"Conneaut Lakeshore CDP, Pennsylvania",2519,1179,1340,42,15755,53.195712584358866
"Fredericksburg CDP (Crawford County), Pennsylvania",439,379,60,42,27648,13.66742596810934
"Meadville city, Pennsylvania",6298,5352,946,42,48360,15.020641473483645
"Spartansburg borough, Pennsylvania",136,120,16,42,72704,11.76470588235294
"Titusville city, Pennsylvania",2690,2299,391,42,76904,14.535315985130111
"Montrose borough, Pennsylvania",917,796,121,42,50736,13.195201744820064
"Barkeyville borough, Pennsylvania",119,105,14,42,04136,11.76470588235294
"Clintonville borough, Pennsylvania",219,200,19,42,14376,8.67579908675799
"Pleasantville borough (Venango County), Pennsylvania",425,357,68,42,61512,16.0
"Woodland Heights CDP, Pennsylvania",595,539,56,42,86224,9.411764705882353
"Bear Lake borough, Pennsylvania",80,70,10,42,04608,12.5
"Sugar Grove borough, Pennsylvania",238,231,7,42,75024,2.941176470588235
"Portersville borough, Pennsylvania",130,125,5,42,62224,3.8461538461538463
"Slippery Rock borough, Pennsylvania",1418,1130,288,42,71184,20.310296191819464
"Cochranton borough, Pennsylvania",506,465,41,42,14800,8.102766798418973
"Conneaut Lake borough, Pennsylvania",362,328,34,42,15744,9.392265193370166
"Conneautville borough, Pennsylvania",356,314,42,42,15760,11.797752808988763
"Worthington borough, Pennsylvania",281,253,28,42,86560,9.9644128113879
"Tidioute borough, Pennsylvania",412,341,71,42,76696,17.233009708737864
"Emmaus borough, Pennsylvania",5138,5030,108,42,23584,2.1019852082522386
"Fawn Grove borough, Pennsylvania",194,187,7,42,25416,3.608247422680412
"Franklintown borough, Pennsylvania",228,199,29,42,27576,12.719298245614036
"Loganville borough, Pennsylvania",504,483,21,42,44416,4.166666666666666
"New Freedom borough, Pennsylvania",1852,1778,74,42,53568,3.995680345572354
"Shiloh CDP, Pennsylvania",4947,4777,170,42,70256,3.436426116838488
"Shrewsbury borough, Pennsylvania",1609,1539,70,42,70568,4.35052827843381
"Beech Creek borough, Pennsylvania",317,297,20,42,04984,6.309148264984227
"Millbourne borough, Pennsylvania",418,363,55,42,49504,13.157894736842104
"Trainer borough, Pennsylvania",622,528,94,42,77288,15.112540192926044
"Woodside CDP, Pennsylvania",803,783,20,42,86352,2.4906600249066
"Port Royal borough, Pennsylvania",437,376,61,42,62304,13.958810068649885
"Homer City borough, Pennsylvania",844,768,76,42,35408,9.004739336492891
"Marion Center borough, Pennsylvania",215,200,15,42,47472,6.976744186046512
"Shelocta borough, Pennsylvania",43,39,4,42,70040,9.30232558139535
"Jeddo borough, Pennsylvania",126,118,8,42,37792,6.349206349206349
"Freeport borough, Pennsylvania",909,845,64,42,27784,7.04070407040704
"Youngsville borough, Pennsylvania",807,761,46,42,87224,5.700123915737299
"Slabtown CDP, Pennsylvania",93,55,38,42,71056,40.86021505376344
"Wilburton Number Two CDP, Pennsylvania",52,36,16,42,85078,30.76923076923077
"Waynesburg borough, Pennsylvania",1681,1386,295,42,81832,17.549077929803687
"Throop borough, Pennsylvania",1963,1737,226,42,76648,11.512990320937341
"Moosic borough, Pennsylvania",2673,2376,297,42,50880,11.11111111111111
"Mount Cobb CDP, Pennsylvania",797,699,98,42,51536,12.296110414052698
"Clairton city, Pennsylvania",4088,2966,1122,42,13704,27.44618395303327
"Duquesne city, Pennsylvania",2917,2254,663,42,20432,22.728830990743916
"Emsworth borough, Pennsylvania",1252,1245,7,42,23616,0.5591054313099041
"Homestead borough, Pennsylvania",1752,1360,392,42,35424,22.37442922374429
"McKees Rocks borough, Pennsylvania",3370,2728,642,42,46264,19.050445103857566
"New Holland borough, Pennsylvania",2323,2244,79,42,53696,3.4007748600947054
"West Mifflin borough, Pennsylvania",9623,8655,968,42,83512,10.059233087394784
"White Oak borough, Pennsylvania",3850,3601,249,42,84704,6.467532467532468
"Mill Creek borough, Pennsylvania",161,152,9,42,49552,5.590062111801243
"Big Run borough, Pennsylvania",200,192,8,42,06344,4.0
"Elizabethtown borough, Pennsylvania",4498,4094,404,42,23016,8.981769675411295
"Rheems CDP, Pennsylvania",510,510,0,42,64392,0.0
"Willow Street CDP, Pennsylvania",4075,3572,503,42,85464,12.343558282208589
"Dormont borough, Pennsylvania",4412,4033,379,42,19576,8.59020852221215
"East Pittsburgh borough, Pennsylvania",1093,815,278,42,21712,25.434583714547117
"Elizabeth borough, Pennsylvania",736,648,88,42,22992,11.956521739130435
"North Braddock borough, Pennsylvania",2921,2155,766,42,54816,26.22389592605272
"Rosslyn Farms borough, Pennsylvania",191,185,6,42,66320,3.1413612565445024
"Sewickley Heights borough, Pennsylvania",364,288,76,42,69400,20.87912087912088
"Plainfield CDP, Pennsylvania",333,244,89,42,61080,26.726726726726728
"Sheffield CDP, Pennsylvania",530,495,35,42,69984,6.60377358490566
"Finleyville borough, Pennsylvania",229,161,68,42,25944,29.694323144104807
"Roscoe borough, Pennsylvania",403,357,46,42,66016,11.41439205955335
"Le Raysville borough, Pennsylvania",105,92,13,42,42824,12.380952380952381
"Cooperstown borough, Pennsylvania",180,174,6,42,16080,3.3333333333333335
"Saxton borough, Pennsylvania",342,277,65,42,68072,19.005847953216374
"Woodbury borough, Pennsylvania",123,109,14,42,86128,11.38211382113821
"Rome borough, Pennsylvania",219,188,31,42,65944,14.15525114155251
"South Waverly borough, Pennsylvania",523,459,64,42,72592,12.237093690248566
"Sylvania borough, Pennsylvania",102,91,11,42,75944,10.784313725490197
"Aristes CDP, Pennsylvania",204,164,40,42,02968,19.607843137254903
"Iola CDP, Pennsylvania",90,90,0,42,37024,0.0
"Meyersdale borough, Pennsylvania",1072,898,174,42,48912,16.23134328358209
"Paint borough, Pennsylvania",455,394,61,42,57544,13.406593406593407
"Loganton borough, Pennsylvania",193,182,11,42,44400,5.699481865284974
"Renovo borough, Pennsylvania",679,470,209,42,64200,30.78055964653903
"Ashville borough, Pennsylvania",98,80,18,42,03296,18.367346938775512
"Carrolltown borough, Pennsylvania",377,347,30,42,11456,7.957559681697612
"West Conshohocken borough, Pennsylvania",702,638,64,42,82736,9.116809116809117
"Bendersville borough, Pennsylvania",275,259,16,42,05536,5.818181818181818
"Hampton CDP, Pennsylvania",183,183,0,42,32320,0.0
"Bedford borough, Pennsylvania",1456,1255,201,42,04944,13.804945054945057
"Rainsburg borough, Pennsylvania",48,32,16,42,63312,33.33333333333333
"Bristol borough, Pennsylvania",4059,3815,244,42,08760,6.011332840601134
"Sankertown borough, Pennsylvania",294,256,38,42,67920,12.925170068027212
"Irvona borough, Pennsylvania",283,246,37,42,37192,13.074204946996467
"Grampian borough, Pennsylvania",181,147,34,42,30280,18.784530386740332
"Troutville borough, Pennsylvania",89,85,4,42,77568,4.49438202247191
"New Britain borough, Pennsylvania",1019,952,67,42,53296,6.575073601570167
"Monessen city, Pennsylvania",4495,3474,1021,42,50344,22.71412680756396
"Herminie CDP, Pennsylvania",286,210,76,42,34048,26.573426573426573
"New Alexandria borough, Pennsylvania",298,277,21,42,53160,7.046979865771812
"Scottdale borough, Pennsylvania",2131,1914,217,42,68432,10.18301267010793
"Slickville CDP, Pennsylvania",115,115,0,42,71160,0.0
"Economy borough, Pennsylvania",4012,3913,99,42,22264,2.4675972083748756
"Industry borough, Pennsylvania",810,703,107,42,36944,13.209876543209875
"Green Hills borough, Pennsylvania",8,8,0,42,31082,0.0
"Kulpmont borough, Pennsylvania",1580,1316,264,42,40584,16.70886075949367
"Baidland CDP, Pennsylvania",629,584,45,42,03768,7.154213036565977
"Donora borough, Pennsylvania",2595,1883,712,42,19536,27.4373795761079
"Marianna borough, Pennsylvania",258,185,73,42,47400,28.294573643410853
"West Middletown borough, Pennsylvania",60,49,11,42,83504,18.333333333333332
"Fredonia borough, Pennsylvania",227,193,34,42,27688,14.977973568281937
"Sheakleyville borough, Pennsylvania",80,76,4,42,69936,5.0
"Camp Hill borough, Pennsylvania",3332,3131,201,42,11000,6.032412965186074
"Conway borough, Pennsylvania",1043,970,73,42,15872,6.999041227229147
"Enola CDP, Pennsylvania",2854,2659,195,42,23744,6.832515767344079
"Newville borough, Pennsylvania",636,553,83,42,54320,13.050314465408805
"Ambridge borough, Pennsylvania",3929,3077,852,42,02288,21.68490710104352
"East Rochester borough, Pennsylvania",262,242,20,42,21752,7.633587786259542
"Georgetown borough, Pennsylvania",70,66,4,42,28824,5.714285714285714
"Salisbury borough, Pennsylvania",415,358,57,42,67584,13.734939759036143
"Wilmerding borough, Pennsylvania",1238,916,322,42,85496,26.009693053311793
"Jerome CDP, Pennsylvania",423,337,86,42,38104,20.33096926713948
"New Centerville borough, Pennsylvania",56,54,2,42,53416,3.571428571428571
"Lime Ridge CDP, Pennsylvania",387,379,8,42,43320,2.0671834625323
"Millville borough, Pennsylvania",383,353,30,42,49944,7.83289817232376
"Rupert CDP, Pennsylvania",70,70,0,42,66696,0.0
"Lykens borough, Pennsylvania",942,736,206,42,45592,21.86836518046709
"Hallam borough, Pennsylvania",1285,1173,112,42,32056,8.715953307392995
"Mount Wolf borough, Pennsylvania",679,663,16,42,52056,2.3564064801178204
"Railroad borough, Pennsylvania",130,121,9,42,63288,6.923076923076923
"Spring Grove borough, Pennsylvania",914,880,34,42,73192,3.7199124726477026
"Susquehanna Trails CDP, Pennsylvania",907,716,191,42,75574,21.05843439911797
"Weigelstown CDP, Pennsylvania",5363,5111,252,42,82008,4.698862576915905
"Wellsville borough, Pennsylvania",96,92,4,42,82200,4.166666666666666
"Windsor borough, Pennsylvania",589,501,88,42,85728,14.94057724957555
"Catawissa borough, Pennsylvania",788,711,77,42,11736,9.771573604060913
"Mainville CDP, Pennsylvania",62,45,17,42,46720,27.419354838709676
"Waller CDP, Pennsylvania",38,33,5,42,80656,13.157894736842104
"Hershey CDP, Pennsylvania",5869,5491,378,42,34144,6.440620207871869
"Penbrook borough, Pennsylvania",1305,1260,45,42,58712,3.4482758620689653
"Atwood borough, Pennsylvania",51,44,7,42,03480,13.725490196078432
"Elderton borough, Pennsylvania",172,160,12,42,22832,6.976744186046512
"Ford Cliff borough, Pennsylvania",217,209,8,42,26520,3.686635944700461
"Lenape Heights CDP, Pennsylvania",666,562,104,42,42672,15.615615615615615
"Rural Valley borough, Pennsylvania",462,412,50,42,66720,10.822510822510822
"Warren city, Pennsylvania",4903,4320,583,42,81000,11.890679176014684
"Newry borough, Pennsylvania",117,97,20,42,54024,17.094017094017094
"Buckhorn CDP, Pennsylvania",183,136,47,42,09792,25.683060109289617
"Gibraltar CDP, Pennsylvania",266,184,82,42,29000,30.82706766917293
"Canton borough, Pennsylvania",911,737,174,42,11160,19.099890230515918
"Georgetown CDP (Lancaster County), Pennsylvania",371,371,0,42,28828,0.0
"Georgetown CDP (Luzerne County), Pennsylvania",846,772,74,42,28832,8.747044917257684
"Gibsonia CDP, Pennsylvania",903,856,47,42,29040,5.204872646733112
"Glenshaw CDP, Pennsylvania",3947,3782,165,42,29800,4.1803901697491765
"Gold Key Lake CDP, Pennsylvania",889,594,295,42,30013,33.18335208098988
"Goodville CDP, Pennsylvania",220,220,0,42,30096,0.0
"Gordonville CDP, Pennsylvania",217,193,24,42,30136,11.059907834101383
"Gouglersville CDP, Pennsylvania",235,192,43,42,30192,18.29787234042553
"Gouldsboro CDP, Pennsylvania",506,257,249,42,30200,49.209486166007906
"Graceton CDP, Pennsylvania",103,59,44,42,30224,42.71844660194174
"Granville CDP, Pennsylvania",160,160,0,42,30472,0.0
"Grassflat CDP, Pennsylvania",259,245,14,42,30528,5.405405405405405
"Grazierville CDP, Pennsylvania",272,247,25,42,30704,9.191176470588236
"Greenfields CDP, Pennsylvania",406,406,0,42,31038,0.0
"Greenock CDP, Pennsylvania",988,894,94,42,31120,9.51417004048583
"Greens Landing CDP, Pennsylvania",400,351,49,42,31208,12.25
"Greenwood CDP, Pennsylvania",1116,1051,65,42,31368,5.824372759856631
"Grier City CDP, Pennsylvania",146,146,0,42,31536,0.0
"Grill CDP, Pennsylvania",608,608,0,42,31568,0.0
"Grindstone CDP, Pennsylvania",226,196,30,42,31592,13.274336283185843
"Hannasville CDP, Pennsylvania",64,55,9,42,32384,14.0625
"Harleigh CDP, Pennsylvania",576,576,0,42,32600,0.0
"Harwick CDP, Pennsylvania",542,538,4,42,33024,0.7380073800738007
"Haverford College CDP, Pennsylvania",99,82,17,42,33154,17.17171717171717
"Hawk Run CDP, Pennsylvania",229,229,0,42,33184,0.0
"Hebron CDP, Pennsylvania",196,196,0,42,33504,0.0
"Hummels Wharf CDP, Pennsylvania",599,579,20,42,36240,3.33889816360601
"Penns Creek CDP, Pennsylvania",237,221,16,42,59160,6.751054852320674
"Port Trevorton CDP, Pennsylvania",307,269,38,42,62312,12.37785016286645
"Ancient Oaks CDP, Pennsylvania",2936,2854,82,42,02416,2.79291553133515
"Catasauqua borough, Pennsylvania",2812,2747,65,42,11720,2.3115220483641536
"Jennerstown borough, Pennsylvania",343,265,78,42,38048,22.740524781341108
"McKean borough, Pennsylvania",217,207,10,42,46216,4.6082949308755765
"Mount Pocono borough, Pennsylvania",1356,1168,188,42,51912,13.864306784660767
"Elgin borough, Pennsylvania",76,72,4,42,22960,5.263157894736842
"Lake City borough, Pennsylvania",1226,1156,70,42,40960,5.709624796084829
"Altamont CDP, Pennsylvania",390,348,42,42,02144,10.76923076923077
"Auburn borough, Pennsylvania",302,283,19,42,03488,6.291390728476822
"Branchdale CDP, Pennsylvania",209,162,47,42,08208,22.48803827751196
"Brandonville CDP, Pennsylvania",112,109,3,42,08240,2.6785714285714284
"Fountain Springs CDP, Pennsylvania",150,150,0,42,27024,0.0
"Klingerstown CDP, Pennsylvania",71,41,30,42,40136,42.25352112676056
"Landingville borough, Pennsylvania",63,58,5,42,41264,7.936507936507936
"Olyphant borough, Pennsylvania",2380,2206,174,42,56792,7.3109243697479
"Taylor borough, Pennsylvania",2751,2519,232,42,76184,8.433296982915303
"Vandling borough, Pennsylvania",313,268,45,42,79792,14.376996805111823
"McClure borough, Pennsylvania",475,432,43,42,45992,9.05263157894737
"Middleburg borough, Pennsylvania",597,569,28,42,48960,4.690117252931323
"Coplay borough, Pennsylvania",1440,1379,61,42,16128,4.236111111111112
"Fountain Hill borough, Pennsylvania",2227,2084,143,42,27008,6.421194431971262
"Sharon city, Pennsylvania",7537,6029,1508,42,69720,20.00796072707974
"New Cumberland borough, Pennsylvania",3718,3407,311,42,53464,8.364712210866058
"Geneva CDP, Pennsylvania",54,45,9,42,28768,16.666666666666664
"Connoquenessing borough, Pennsylvania",235,228,7,42,15808,2.9787234042553195
"Fairview borough, Pennsylvania",70,60,10,42,24832,14.285714285714285
"Saxonburg borough, Pennsylvania",861,788,73,42,68056,8.478513356562138
"Hydetown borough, Pennsylvania",325,303,22,42,36616,6.769230769230769
"Colony Park CDP, Pennsylvania",471,471,0,42,15368,0.0
"Columbus CDP, Pennsylvania",350,308,42,42,15400,12.0
"Conashaugh Lakes CDP, Pennsylvania",711,530,181,42,15479,25.457102672292546
"Conestoga CDP, Pennsylvania",476,444,32,42,15584,6.722689075630252
"Coral CDP, Pennsylvania",231,231,0,42,16136,0.0
"Cornwells Heights CDP, Pennsylvania",472,439,33,42,16272,6.991525423728813
"Crenshaw CDP, Pennsylvania",190,157,33,42,17040,17.36842105263158
"Cross Creek CDP, Pennsylvania",53,53,0,42,17320,0.0
"Crown CDP, Pennsylvania",171,88,83,42,17440,48.53801169590643
"Crucible CDP, Pennsylvania",308,265,43,42,17528,13.96103896103896
"Cumbola CDP, Pennsylvania",198,184,14,42,17680,7.07070707070707
"Dalmatia CDP, Pennsylvania",208,186,22,42,18080,10.576923076923077
"Dauberville CDP, Pennsylvania",313,313,0,42,18256,0.0
"Deer Lake CDP, Pennsylvania",236,175,61,42,18568,25.847457627118644
"Defiance CDP, Pennsylvania",140,120,20,42,18608,14.285714285714285
"DeSales University CDP, Pennsylvania",0,0,0,42,18998,
"Devon CDP, Pennsylvania",648,648,0,42,19040,0.0
"Dewart CDP, Pennsylvania",544,544,0,42,19048,0.0
"Dorneyville CDP, Pennsylvania",1793,1775,18,42,19584,1.003904071388734
"Douglassville CDP, Pennsylvania",378,378,0,42,19680,0.0
"Dry Tavern CDP, Pennsylvania",272,259,13,42,20080,4.779411764705882
"Dryville CDP, Pennsylvania",147,147,0,42,20096,0.0
"Dunlo CDP, Pennsylvania",128,69,59,42,20336,46.09375
"Eagle Lake CDP, Pennsylvania",121,0,121,42,20634,100.0
"Eagleview CDP, Pennsylvania",894,840,54,42,20662,6.0402684563758395
"Newry CDP, South Carolina",119,91,28,45,49975,23.52941176470588
"Pinopolis CDP, South Carolina",648,614,34,45,57175,5.246913580246913
"Russellville CDP, South Carolina",184,129,55,45,62305,29.891304347826086
"Sangaree CDP, South Carolina",3218,2928,290,45,63665,9.01180857675575
"Tigerville CDP, South Carolina",30,30,0,45,71890,0.0
"Wallace CDP, South Carolina",407,325,82,45,74140,20.14742014742015
"Ware Place CDP, South Carolina",83,55,28,45,74635,33.734939759036145
"Warrenville CDP, South Carolina",618,472,146,45,74725,23.624595469255663
"Ferney CDP, South Dakota",60,60,0,46,21380,0.0
"Forestburg CDP, South Dakota",65,57,8,46,22100,12.307692307692308
"Gann Valley CDP, South Dakota",23,14,9,46,23421,39.130434782608695
"Goodwill CDP, South Dakota",204,190,14,46,24775,6.862745098039216
"Johnson Siding CDP, South Dakota",361,307,54,46,32820,14.958448753462603
"Kidder CDP, South Dakota",0,0,0,46,33900,
"Lake Madison CDP, South Dakota",893,387,506,46,35430,56.662933930571114
"Lake Poinsett CDP, South Dakota",686,192,494,46,35480,72.01166180758017
"Long Hollow CDP, South Dakota",57,57,0,46,38760,0.0
"Mansfield CDP, South Dakota",53,45,8,46,40580,15.09433962264151
"Meadow View Addition CDP, South Dakota",212,212,0,46,41680,0.0
"Morningside CDP, South Dakota",76,64,12,46,43780,15.789473684210526
"Norris CDP, South Dakota",61,51,10,46,45420,16.39344262295082
"Okreek CDP, South Dakota",103,80,23,46,46660,22.330097087378643
"Ola CDP, South Dakota",0,0,0,46,46700,
"Pine Lakes Addition CDP, South Dakota",116,116,0,46,49640,0.0
"Prairie City CDP, South Dakota",17,2,15,46,51660,88.23529411764706
"St. Onge CDP, South Dakota",62,62,0,46,57260,0.0
"Renner Corner CDP, South Dakota",184,184,0,46,54145,0.0
"Richland CDP, South Dakota",57,57,0,46,54750,0.0
"Running Water CDP, South Dakota",26,16,10,46,56820,38.46153846153847
"Shindler CDP, South Dakota",242,242,0,46,58590,0.0
"Soldier Creek CDP, South Dakota",62,62,0,46,59700,0.0
"Vale CDP, South Dakota",62,62,0,46,65900,0.0
"Waverly CDP, South Dakota",17,17,0,46,69420,0.0
"Winfred CDP, South Dakota",67,53,14,46,72100,20.8955223880597
"Caputa CDP, South Dakota",0,0,0,46,09780,
"Roswell CDP, South Dakota",1,1,0,46,56420,0.0
"Kimball city, South Dakota",341,290,51,46,33980,14.95601173020528
"Deadwood city, South Dakota",976,770,206,46,15700,21.10655737704918
"Ravinia town, South Dakota",43,26,17,46,53220,39.53488372093023
"Morristown town, South Dakota",39,22,17,46,43860,43.58974358974359
"Henry town, South Dakota",151,133,18,46,28140,11.920529801324504
"Astoria town, South Dakota",95,71,24,46,02580,25.263157894736842
"Brandt town, South Dakota",48,42,6,46,06940,12.5
"Buffalo Gap town, South Dakota",81,57,24,46,08340,29.629629629629626
"Hermosa town, South Dakota",212,184,28,46,28300,13.20754716981132
"Green Grass CDP, South Dakota",4,4,0,46,25900,0.0
"North Eagle Butte CDP, South Dakota",635,520,115,46,45548,18.11023622047244
"Big Stone City city, South Dakota",376,313,63,46,05540,16.75531914893617
"Bonesteel city, South Dakota",193,161,32,46,06220,16.580310880829018
"St. Charles CDP, South Dakota",13,2,11,46,57060,84.61538461538461
"Vienna town, South Dakota",26,18,8,46,67220,30.76923076923077
"Lake Andes city, South Dakota",321,262,59,46,35100,18.38006230529595
"St. Lawrence town, South Dakota",90,82,8,46,57180,8.88888888888889
"Kaylor CDP, South Dakota",14,14,0,46,33380,0.0
"Yankton city, South Dakota",6553,6238,315,46,73060,4.8069586448954675
"Pollock town, South Dakota",199,111,88,46,51260,44.221105527638194
"Faulkton city, South Dakota",498,407,91,46,21260,18.27309236947791
"Spencer city, South Dakota",91,64,27,46,60060,29.67032967032967
"Aberdeen city, South Dakota",13137,12011,1126,46,00100,8.57121108320012
"Davis town, South Dakota",58,49,9,46,15540,15.517241379310345
"McKeansburg CDP, Pennsylvania",69,69,0,42,46232,0.0
"Park Forest Village CDP, Pennsylvania",4144,3986,158,42,58036,3.812741312741313
"Ben Avon Heights borough, Pennsylvania",134,131,3,42,05520,2.2388059701492535
"West Wyomissing CDP, Pennsylvania",1427,1362,65,42,84280,4.555010511562719
"Ringtown borough, Pennsylvania",372,333,39,42,65000,10.483870967741936
"Newell borough, Pennsylvania",229,209,20,42,53504,8.73362445414847
"Penn borough, Pennsylvania",198,159,39,42,58872,19.696969696969695
"Hookstown borough, Pennsylvania",65,60,5,42,35576,7.6923076923076925
"Picture Rocks borough, Pennsylvania",311,297,14,42,60136,4.501607717041801
"Conshohocken borough, Pennsylvania",4188,3875,313,42,15848,7.473734479465138
"Spring House CDP, Pennsylvania",1562,1464,98,42,73264,6.274007682458387
"Deer Lake borough, Pennsylvania",306,298,8,42,18576,2.6143790849673203
"Newtown CDP, Pennsylvania",138,127,11,42,54264,7.971014492753622
"Pleasant View CDP, Pennsylvania",353,330,23,42,61432,6.515580736543909
"Plumsteadville CDP, Pennsylvania",887,852,35,42,61624,3.9458850056369785
"Pocono Mountain Lake Estates CDP, Pennsylvania",538,218,320,42,61756,59.479553903345725
"Pocono Ranch Lands CDP, Pennsylvania",669,452,217,42,61773,32.436472346786246
"Pocono Springs CDP, Pennsylvania",1333,561,772,42,61774,57.91447861965492
"Pocono Woodland Lakes CDP, Pennsylvania",1265,1226,39,42,61788,3.08300395256917
"Pomeroy CDP, Pennsylvania",207,207,0,42,61968,0.0
"Strasburg borough, Pennsylvania",1189,1144,45,42,74712,3.7846930193439863
"Potlicker Flats CDP, Pennsylvania",113,113,0,42,62340,0.0
"East Waterford CDP, Pennsylvania",106,92,14,42,22024,13.20754716981132
"Latrobe borough, Pennsylvania",4191,3563,628,42,41680,14.984490575041756
"Fairview-Ferndale CDP, Pennsylvania",1142,937,205,42,24948,17.950963222416814
"Marshallton CDP, Pennsylvania",717,604,113,42,47736,15.760111576011157
"Plymouth borough, Pennsylvania",3196,2537,659,42,61648,20.619524405506883
"Dallas borough, Pennsylvania",1235,1154,81,42,18048,6.558704453441296
"Larksville borough, Pennsylvania",2038,1842,196,42,41608,9.617271835132483
"Mountain Top CDP, Pennsylvania",4296,4096,200,42,51384,4.655493482309125
"Shickshinny borough, Pennsylvania",372,290,82,42,70224,22.043010752688172
"Sugar Notch borough, Pennsylvania",452,373,79,42,75072,17.47787610619469
"West Pittston borough, Pennsylvania",2391,2051,340,42,83856,14.219991635299037
"Hallstead borough, Pennsylvania",647,580,67,42,32080,10.35548686244204
"Union Dale borough, Pennsylvania",163,119,44,42,78456,26.993865030674847
"Willow Grove CDP, Pennsylvania",6382,5878,504,42,85408,7.897210905672203
"Wyndmoor CDP, Pennsylvania",2159,2092,67,42,86776,3.1032885595182953
"Shanksville borough, Pennsylvania",95,88,7,42,69680,7.368421052631578
"Hawley borough, Pennsylvania",650,521,129,42,33200,19.846153846153847
"Starrucca borough, Pennsylvania",113,73,40,42,73784,35.39823008849557
"Tioga borough, Pennsylvania",320,276,44,42,76808,13.750000000000002
"Wellsboro borough, Pennsylvania",1760,1421,339,42,82160,19.261363636363637
"East Prospect borough, Pennsylvania",382,359,23,42,21728,6.020942408376963
"Glen Rock borough, Pennsylvania",835,777,58,42,29760,6.946107784431138
"Lewisberry borough, Pennsylvania",189,184,5,42,42968,2.6455026455026456
"Nixon CDP, Pennsylvania",530,530,0,42,54552,0.0
"Melville CDP, Rhode Island",512,438,74,44,45010,14.453125
"Cranston city, Rhode Island",33254,30754,2500,44,19180,7.517892584350755
"Greenville CDP, Rhode Island",3588,3356,232,44,31600,6.465997770345597
"Valley Falls CDP, Rhode Island",4906,4581,325,44,72500,6.624541377904607
"Newport city, Rhode Island",13086,10546,2540,44,49960,19.410056548983647
"Tiverton CDP, Rhode Island",3738,3392,346,44,70700,9.256286784376671
"Kingston CDP, Rhode Island",746,665,81,44,38980,10.857908847184987
"Ashaway CDP, Rhode Island",497,444,53,44,03520,10.663983903420524
"Wakefield-Peacedale CDP, Rhode Island",3777,3576,201,44,73130,5.321683876092136
"East Providence city, Rhode Island",20712,19668,1044,44,22960,5.040556199304751
"Harrisville CDP, Rhode Island",606,606,0,44,33400,0.0
"Bradford CDP, Rhode Island",550,506,44,44,08020,8.0
"Florence town, South Dakota",167,142,25,46,21820,14.97005988023952
"Batesland town, South Dakota",28,25,3,46,03860,10.714285714285714
"Winner city, South Dakota",1577,1328,249,46,72180,15.789473684210526
"Raymond town, South Dakota",35,26,9,46,53260,25.71428571428571
"Geddes city, South Dakota",156,109,47,46,23980,30.128205128205128
"Vermillion city, South Dakota",4387,3924,463,46,66700,10.553909277410531
"Colman city, South Dakota",313,279,34,46,13220,10.86261980830671
"Bullhead CDP, South Dakota",86,60,26,46,08460,30.23255813953488
"Wessington Springs city, South Dakota",507,427,80,46,70220,15.779092702169626
"Sturgis city, South Dakota",3312,2987,325,46,62100,9.812801932367151
"Artesian town, South Dakota",121,105,16,46,02380,13.223140495867769
"Artas town, South Dakota",30,20,10,46,02340,33.33333333333333
"Draper town, South Dakota",49,37,12,46,17020,24.489795918367346
"Spearfish city, South Dakota",5498,4947,551,46,60020,10.021826118588578
"Keystone town, South Dakota",215,142,73,46,33820,33.95348837209302
"Oacoma town, South Dakota",229,191,38,46,46180,16.593886462882097
"Presho city, South Dakota",310,220,90,46,51820,29.03225806451613
"Hetland town, South Dakota",23,9,14,46,28460,60.86956521739131
"Jefferson city, South Dakota",291,278,13,46,32700,4.4673539518900345
"Parmelee CDP, South Dakota",138,122,16,46,48500,11.594202898550725
"Java town, South Dakota",125,65,60,46,32460,48.0
"Oldham city, South Dakota",87,73,14,46,46780,16.091954022988507
"Madison city, South Dakota",2810,2550,260,46,40220,9.252669039145907
"Nunda town, South Dakota",29,25,4,46,46060,13.793103448275861
"Wolsey town, South Dakota",236,212,24,46,72540,10.16949152542373
"Volga city, South Dakota",759,709,50,46,67700,6.587615283267458
"Stratford town, South Dakota",36,22,14,46,62020,38.88888888888889
"Wagner city, South Dakota",693,579,114,46,68020,16.450216450216452
"Egan city, South Dakota",145,140,5,46,18460,3.4482758620689653
"Hamill CDP, South Dakota",9,0,9,46,26660,100.0
"Garden City town, South Dakota",31,28,3,46,23460,9.67741935483871
"Gary city, South Dakota",188,142,46,46,23860,24.46808510638298
"Virgil town, South Dakota",10,10,0,46,67500,0.0
"Yale town, South Dakota",58,51,7,46,73020,12.068965517241379
"Allen CDP, South Dakota",54,50,4,46,00900,7.4074074074074066
"Bruce city, South Dakota",89,79,10,46,07740,11.235955056179774
"McIntosh city, South Dakota",103,72,31,46,39940,30.097087378640776
"Hazel town, South Dakota",41,37,4,46,27940,9.75609756097561
"Arlington city, South Dakota",506,478,28,46,02180,5.533596837944664
"Bancroft town, South Dakota",15,10,5,46,03420,33.33333333333333
"Onida city, South Dakota",296,261,35,46,47180,11.824324324324325
"Northville town, South Dakota",50,38,12,46,45740,24.0
"Turton town, South Dakota",45,19,26,46,64540,57.77777777777777
"Mount Vernon city, South Dakota",205,197,8,46,44100,3.902439024390244
"Bushnell town, South Dakota",45,43,2,46,08820,4.444444444444445
"Avon city, South Dakota",343,271,72,46,02900,20.99125364431487
"Scotland city, South Dakota",489,393,96,46,57940,19.631901840490798
"North Spearfish CDP, South Dakota",1057,985,72,46,45715,6.811731315042574
"Ashland Heights CDP, South Dakota",409,409,0,46,02530,0.0
"Claire City town, South Dakota",46,38,8,46,12020,17.391304347826086
"Corona town, South Dakota",63,33,30,46,13940,47.61904761904761
"Summit town, South Dakota",144,126,18,46,62220,12.5
"Pierre city, South Dakota",6492,6143,349,46,49600,5.3758471965496
"White Horse CDP, South Dakota",66,66,0,46,71150,0.0
"Grenville town, South Dakota",51,33,18,46,26220,35.294117647058826
"Letcher town, South Dakota",120,115,5,46,36620,4.166666666666666
"Goodwin town, South Dakota",68,64,4,46,24820,5.88235294117647
"Andover town, South Dakota",78,63,15,46,01500,19.230769230769234
"Marvin town, South Dakota",26,23,3,46,41220,11.538461538461538
"Gregory city, South Dakota",772,675,97,46,26180,12.564766839378239
"Central Falls city, Rhode Island",7310,6328,982,44,14140,13.433652530779755
"Pascoag CDP, Rhode Island",1984,1733,251,44,54460,12.651209677419356
"Warwick city, Rhode Island",37495,34744,2751,44,74300,7.336978263768502
"Hope Valley CDP, Rhode Island",674,555,119,44,34660,17.655786350148368
"Cumberland Hill CDP, Rhode Island",3429,3205,224,44,20260,6.532516768737241
"Narragansett Pier CDP, Rhode Island",2401,1841,560,44,48700,23.323615160349853
"Newport East CDP, Rhode Island",5829,5142,687,44,50140,11.785898095728255
"Providence city, Rhode Island",72860,61638,11222,44,59000,15.402141092506177
"Woonsocket city, Rhode Island",19186,16940,2246,44,80780,11.706452621703326
"Westerly CDP, Rhode Island",8985,7554,1431,44,76820,15.926544240400666
"Pawtucket city, Rhode Island",31464,28196,3268,44,54640,10.38647342995169
"Charlestown CDP, Rhode Island",1620,666,954,44,14320,58.88888888888889
"Hopkinton CDP, Rhode Island",274,274,0,44,35200,0.0
"Foster Center CDP, Rhode Island",180,180,0,44,27640,0.0
"Carolina CDP, Rhode Island",293,244,49,44,12340,16.723549488054605
"Chepachet CDP, Rhode Island",687,603,84,44,14860,12.22707423580786
"Clayville CDP, Rhode Island",82,82,0,44,15940,0.0
"Greene CDP, Rhode Island",349,316,33,44,31240,9.455587392550143
"Harmony CDP, Rhode Island",523,429,94,44,33040,17.97323135755258
"Misquamicut CDP, Rhode Island",770,211,559,44,46000,72.59740259740259
"Quonochontaug CDP, Rhode Island",750,234,516,44,60260,68.8
"Watch Hill CDP, Rhode Island",291,68,223,44,75200,76.6323024054983
"Weekapaug CDP, Rhode Island",662,233,429,44,75920,64.8036253776435
"Wyoming CDP, Rhode Island",142,142,0,44,80960,0.0
"Johnston town, South Carolina",978,818,160,45,37150,16.359918200409
"Parksville town, South Carolina",94,81,13,45,54700,13.829787234042554
"Willington CDP, South Carolina",88,32,56,45,77920,63.63636363636363
"Donalds town, South Carolina",131,103,28,45,19870,21.374045801526716
"Hickory Grove town, South Carolina",206,187,19,45,33640,9.223300970873787
"India Hook CDP, South Carolina",1872,1766,106,45,35635,5.662393162393163
"McConnells town, South Carolina",97,92,5,45,43675,5.154639175257731
"Pamplico town, South Carolina",441,335,106,45,54340,24.03628117913832
"Hilton Head Island town, South Carolina",34514,17385,17129,45,34045,49.62913600278148
"West Pelzer town, South Carolina",403,336,67,45,76345,16.62531017369727
"Williamston town, South Carolina",2204,1878,326,45,77875,14.791288566243194
"Ehrhardt town, South Carolina",335,197,138,45,23200,41.19402985074627
"Winnsboro town, South Carolina",1718,1278,440,45,78460,25.611175785797442
"Pawleys Island town, South Carolina",552,54,498,45,55015,90.21739130434783
"Coward town, South Carolina",359,284,75,45,17215,20.891364902506965
"Quinby town, South Carolina",471,422,49,45,58795,10.40339702760085
"Bucksport CDP, South Carolina",434,302,132,45,10000,30.414746543778804
"Ridge Spring town, South Carolina",389,286,103,45,60325,26.47814910025707
"Ward town, South Carolina",79,65,14,45,74590,17.72151898734177
"Lockhart town, South Carolina",272,190,82,45,42190,30.14705882352941
"Hodges town, South Carolina",53,41,12,45,34225,22.641509433962266
"Sellers town, South Carolina",124,92,32,45,65005,25.806451612903224
"Lancaster city, South Carolina",3911,3444,467,45,39895,11.940680132958322
"Mountville CDP, South Carolina",69,40,29,45,48670,42.028985507246375
"Marion city, South Carolina",2881,2262,619,45,44575,21.48559527941687
"Burnettown town, South Carolina",1226,975,251,45,10270,20.473083197389887
"Gloverville CDP, South Carolina",1285,1096,189,45,29410,14.708171206225682
"Windsor town, South Carolina",55,49,6,45,78190,10.909090909090908
"Cherryvale CDP, South Carolina",1179,1032,147,45,14018,12.46819338422392
"Lakewood CDP, South Carolina",1299,1144,155,45,39772,11.932255581216321
"Bennettsville city, South Carolina",3701,2947,754,45,05680,20.372872196703593
"Blenheim town, South Carolina",96,77,19,45,06850,19.791666666666664
"Pomaria town, South Carolina",53,47,6,45,57850,11.320754716981133
"Salem town, South Carolina",51,35,16,45,62980,31.372549019607842
"Woodfield CDP, South Carolina",4248,3713,535,45,78820,12.594161958568739
"Belle Fourche city, South Dakota",2667,2403,264,46,04380,9.898762654668166
"New Underwood city, South Dakota",288,223,65,46,45060,22.569444444444446
"New Effington town, South Dakota",128,104,24,46,44820,18.75
"Wilmot city, South Dakota",287,255,32,46,71980,11.149825783972126
"Salem city, South Dakota",609,550,59,46,57340,9.688013136289
"Gettysburg city, South Dakota",636,509,127,46,24260,19.968553459119498
"Lebanon town, South Dakota",26,12,14,46,36260,53.84615384615385
"Beresford city, South Dakota",1012,931,81,46,04980,8.003952569169961
"Antelope CDP, South Dakota",272,245,27,46,01740,9.926470588235293
"Ethan town, South Dakota",186,173,13,46,20060,6.989247311827956
"Mobridge city, South Dakota",1794,1492,302,46,43180,16.833890746934223
"Whitewood city, South Dakota",456,422,34,46,71580,7.456140350877193
"Rapid City city, South Dakota",32369,29942,2427,46,52980,7.497914671444901
"Lower Brule CDP, South Dakota",232,212,20,46,39180,8.620689655172415
"Alcester city, South Dakota",448,423,25,46,00700,5.580357142857143
"Mission city, South Dakota",459,361,98,46,42940,21.350762527233115
"Glenham town, South Dakota",70,51,19,46,24620,27.142857142857142
"Carthage city, South Dakota",152,106,46,46,10220,30.263157894736842
"Howard city, South Dakota",455,375,80,46,30460,17.582417582417584
"Farmer town, South Dakota",3,1,2,46,21060,66.66666666666666
"Hillsview town, South Dakota",2,0,2,46,29340,100.0
"Chancellor town, South Dakota",147,126,21,46,11380,14.285714285714285
"Colton city, South Dakota",343,326,17,46,13380,4.956268221574344
"Sherman town, South Dakota",32,28,4,46,58580,12.5
"Groton city, South Dakota",692,622,70,46,26340,10.115606936416185
"Warner town, South Dakota",155,150,5,46,68740,3.225806451612903
"Westport town, South Dakota",64,56,8,46,70540,12.5
"Lane town, South Dakota",43,41,2,46,35780,4.651162790697675
"South Shore town, South Dakota",125,109,16,46,59940,12.8
"Tea city, South Dakota",1625,1597,28,46,63100,1.723076923076923
"Wounded Knee CDP, South Dakota",93,84,9,46,72900,9.67741935483871
"Altamont town, South Dakota",31,19,12,46,01140,38.70967741935484
"Toronto town, South Dakota",115,103,12,46,63740,10.434782608695652
"Eagle Butte city, South Dakota",387,302,85,46,17620,21.963824289405682
"Martin city, South Dakota",442,364,78,46,41100,17.647058823529413
"Irene city, South Dakota",203,182,21,46,31940,10.344827586206897
"Bristol city, South Dakota",231,192,39,46,07300,16.883116883116884
"Butler town, South Dakota",10,5,5,46,08860,50.0
"Fairfax town, South Dakota",90,73,17,46,20380,18.88888888888889
"Dante town, South Dakota",36,36,0,46,15420,0.0
"Pickstown town, South Dakota",132,95,37,46,49460,28.030303030303028
"Reliance town, South Dakota",73,62,11,46,54020,15.068493150684931
"Hosmer city, South Dakota",155,110,45,46,30140,29.03225806451613
"Ipswich city, South Dakota",483,407,76,46,31860,15.734989648033126
"Emery city, South Dakota",191,168,23,46,19420,12.041884816753926
"Wood town, South Dakota",40,24,16,46,72620,40.0
"Tolstoy town, South Dakota",39,23,16,46,63700,41.02564102564102
"Two Strike CDP, South Dakota",71,64,7,46,64840,9.859154929577464
"Lowry town, South Dakota",11,4,7,46,39260,63.63636363636363
"Fort Thompson CDP, South Dakota",366,313,53,46,22340,14.48087431693989
"Tyndall city, South Dakota",560,540,20,46,64860,3.571428571428571
"Highmore city, South Dakota",421,369,52,46,28980,12.351543942992874
"Okaton CDP, South Dakota",17,3,14,46,46620,82.35294117647058
"Lead city, South Dakota",1850,1397,453,46,36220,24.486486486486488
"Box Elder city, South Dakota",3521,3220,301,46,06620,8.548707753479125
"Belvidere town, South Dakota",62,38,24,46,04620,38.70967741935484
"Canova town, South Dakota",56,45,11,46,09420,19.642857142857142
"Claremont town, South Dakota",43,37,6,46,12100,13.953488372093023
"Verdon town, South Dakota",2,2,0,46,66660,0.0
"Fulton town, South Dakota",60,60,0,46,23220,0.0
"Central town, South Carolina",2761,2506,255,45,13015,9.235784136182543
"Holly Hill town, South Carolina",638,511,127,45,34360,19.905956112852667
"Neeses town, South Carolina",138,104,34,45,49390,24.637681159420293
"Woodruff city, South Carolina",1635,1509,126,45,79090,7.706422018348624
"North town, South Carolina",399,289,110,45,50560,27.56892230576441
"Vance town, South Carolina",57,41,16,45,73510,28.07017543859649
"Rowesville town, South Carolina",136,91,45,45,62035,33.088235294117645
"Ridgeland town, South Carolina",1434,1284,150,45,60280,10.460251046025103
"Furman town, South Carolina",117,93,24,45,27835,20.51282051282051
"Lyman town, South Carolina",1520,1388,132,45,43315,8.68421052631579
"Turbeville town, South Carolina",445,417,28,45,72745,6.292134831460674
"Troy town, South Carolina",58,49,9,45,72655,15.517241379310345
"Springdale town, South Carolina",1225,1154,71,45,68425,5.795918367346939
"West Columbia city, South Carolina",8965,8059,906,45,75850,10.105967651979922
"Beaufort city, South Carolina",5689,4835,854,45,04690,15.011425558094569
"Edisto CDP, South Carolina",1274,838,436,45,22997,34.22291993720565
"Eutawville town, South Carolina",160,126,34,45,24100,21.25
"Orangeburg city, South Carolina",5176,4237,939,45,53080,18.141421947449768
"Springfield town, South Carolina",325,213,112,45,68470,34.46153846153846
"Lowrys town, South Carolina",104,85,19,45,42865,18.269230769230766
"Swansea town, South Carolina",407,349,58,45,70675,14.250614250614252
"Fairfax town, South Carolina",1047,770,277,45,24370,26.456542502387776
"Jamestown town, South Carolina",54,44,10,45,36475,18.51851851851852
"Gilbert town, South Carolina",254,231,23,45,29050,9.05511811023622
"Rock Hill city, South Carolina",30267,28112,2155,45,61405,7.119965639144943
"Joanna CDP, South Carolina",733,540,193,45,36790,26.330150068212827
"Cayce city, South Carolina",6317,5905,412,45,12655,6.522083267373753
"Red Bank CDP, South Carolina",4132,3968,164,45,59110,3.969022265246854
"Elko town, South Carolina",104,89,15,45,23335,14.423076923076922
"Lamar town, South Carolina",440,383,57,45,39805,12.954545454545455
"Kiawah Island town, South Carolina",3516,804,2712,45,38162,77.13310580204778
"North Charleston city, South Carolina",45968,41004,4964,45,50875,10.798816568047338
"Ravenel town, South Carolina",1160,958,202,45,59020,17.413793103448274
"Ridgeville town, South Carolina",305,299,6,45,60370,1.9672131147540985
"Anderson city, South Carolina",13076,11436,1640,45,01360,12.542061792597126
"Centerville CDP, South Carolina",3187,3031,156,45,12965,4.894885472230938
"Northlake CDP, South Carolina",1755,1575,180,45,51180,10.256410256410255
"Williams town, South Carolina",62,54,8,45,77785,12.903225806451612
"Bamberg town, South Carolina",1558,1138,420,45,03790,26.957637997432606
"Olar town, South Carolina",140,96,44,45,52585,31.428571428571427
"Laurel Bay CDP, South Carolina",2253,2058,195,45,40525,8.655126498002662
"Port Royal town, South Carolina",4080,3688,392,45,58030,9.607843137254903
"Trenton town, South Carolina",144,121,23,45,72520,15.972222222222221
"Briarcliffe Acres town, South Carolina",252,225,27,45,08830,10.714285714285714
"Forestbrook CDP, South Carolina",2519,2229,290,45,26372,11.512504962286622
"North Myrtle Beach city, South Carolina",28291,7640,20651,45,51280,72.99494538899297
"Socastee CDP, South Carolina",9696,8769,927,45,67390,9.560643564356436
"Monetta town, South Carolina",99,92,7,45,47320,7.07070707070707
"Carlisle town, South Carolina",273,191,82,45,11755,30.036630036630036
"Shell Point CDP, South Carolina",993,906,87,45,65680,8.761329305135952
"St. Matthews town, South Carolina",1120,938,182,45,62620,16.25
"Murphys Estates CDP, South Carolina",592,510,82,45,48900,13.85135135135135
"Murrells Inlet CDP, South Carolina",5295,4084,1211,45,48985,22.870632672332388
"Johnsonville city, South Carolina",699,545,154,45,37105,22.031473533619454
"Timmonsville town, South Carolina",1016,843,173,45,71980,17.02755905511811
"Liberty city, South Carolina",1546,1381,165,45,41380,10.672703751617076
"Newberry city, South Carolina",4417,3947,470,45,49570,10.640706361784016
"Pickens city, South Carolina",1472,1272,200,45,56140,13.586956521739129
"Jenkinsville town, South Carolina",40,33,7,45,36655,17.5
"McKeesport city, Pennsylvania",11362,8929,2433,42,46256,21.413483541629994
"Numidia CDP, Pennsylvania",91,91,0,42,55792,0.0
"Ingram borough, Pennsylvania",1650,1528,122,42,37000,7.3939393939393945
"Lincoln borough, Pennsylvania",485,470,15,42,43408,3.0927835051546393
"Pennsbury Village borough, Pennsylvania",513,487,26,42,59152,5.0682261208577
"Thornburg borough, Pennsylvania",195,182,13,42,76560,6.666666666666667
"Turtle Creek borough, Pennsylvania",2848,2445,403,42,77912,14.150280898876405
"Avonmore borough, Pennsylvania",538,492,46,42,03688,8.550185873605948
"East Vandergrift borough, Pennsylvania",399,335,64,42,21976,16.040100250626566
"Scranton city, Pennsylvania",35442,30386,5056,42,69000,14.265560634275717
"Freeburg borough, Pennsylvania",252,233,19,42,27696,7.5396825396825395
"Kreamer CDP, Pennsylvania",310,293,17,42,40464,5.483870967741936
"Mount Pleasant Mills CDP, Pennsylvania",208,195,13,42,51904,6.25
"Englewood CDP, Pennsylvania",263,218,45,42,23688,17.110266159695815
"West Hazleton borough, Pennsylvania",1941,1724,217,42,83136,11.179804224626482
"Seltzer CDP, Pennsylvania",171,139,32,42,69256,18.71345029239766
"Port Carbon borough, Pennsylvania",902,824,78,42,62128,8.647450110864744
"Pottsville city, Pennsylvania",7376,5878,1498,42,62432,20.309110629067245
"St. Clair borough, Pennsylvania",1560,1277,283,42,67224,18.14102564102564
"Atglen borough, Pennsylvania",525,525,0,42,03384,0.0
"Avondale borough, Pennsylvania",374,366,8,42,03656,2.13903743315508
"Elverson borough, Pennsylvania",757,683,74,42,23440,9.775429326287979
"Paoli CDP, Pennsylvania",2582,2445,137,42,57816,5.305964368706429
"Milroy CDP, Pennsylvania",860,736,124,42,50000,14.418604651162791
"Bentleyville borough, Pennsylvania",1361,1140,221,42,05672,16.23806024981631
"Carbondale city, Pennsylvania",4293,3783,510,42,11232,11.87980433263452
"Dunmore borough, Pennsylvania",6296,5499,797,42,20352,12.658831003811944
"Trooper CDP, Pennsylvania",2125,2017,108,42,77520,5.08235294117647
"Cecil-Bishop CDP, Pennsylvania",854,822,32,42,11804,3.747072599531616
"Long Branch borough, Pennsylvania",210,181,29,42,44512,13.80952380952381
"Monongahela city, Pennsylvania",2185,1850,335,42,50408,15.331807780320366
"Speers borough, Pennsylvania",590,538,52,42,72736,8.813559322033898
"Stockdale borough, Pennsylvania",253,207,46,42,74224,18.181818181818183
"Wickerham Manor-Fisher CDP, Pennsylvania",920,832,88,42,84931,9.565217391304348
"Hellertown borough, Pennsylvania",2549,2339,210,42,33744,8.23852491173009
"Nazareth borough, Pennsylvania",2871,2561,310,42,52808,10.79763148728666
"Roseto borough, Pennsylvania",735,689,46,42,66168,6.258503401360545
"Locustdale CDP, Pennsylvania",100,74,26,42,44224,26.0
"Alba borough, Pennsylvania",68,53,15,42,00572,22.058823529411764
"Wyalusing borough, Pennsylvania",333,272,61,42,86656,18.31831831831832
"Eyers Grove CDP, Pennsylvania",55,40,15,42,24448,27.27272727272727
"Mifflinville CDP, Pennsylvania",559,525,34,42,49312,6.082289803220036
"Highspire borough, Pennsylvania",1267,1111,156,42,34664,12.312549329123915
"Middletown borough, Pennsylvania",4105,3736,369,42,49128,8.989037758830694
"Birmingham borough, Pennsylvania",63,63,0,42,06560,0.0
"Pitcairn borough, Pennsylvania",1716,1528,188,42,60712,10.955710955710956
"Haysville borough, Pennsylvania",43,32,11,42,33312,25.581395348837212
"West View borough, Pennsylvania",3188,2996,192,42,84144,6.022584692597239
"Davidsville CDP, Pennsylvania",391,377,14,42,18312,3.580562659846547
"Friedens CDP, Pennsylvania",672,624,48,42,27928,7.142857142857142
"Rockwood borough, Pennsylvania",415,351,64,42,65736,15.421686746987953
"Somerset borough, Pennsylvania",3288,2752,536,42,71776,16.30170316301703
"Stoystown borough, Pennsylvania",215,187,28,42,74672,13.023255813953488
"Ursina borough, Pennsylvania",124,101,23,42,79424,18.548387096774192
"Girardville borough, Pennsylvania",879,568,311,42,29264,35.381114903299206
"Windber borough, Pennsylvania",2038,1845,193,42,85632,9.470068694798822
"Patton borough, Pennsylvania",896,796,100,42,58432,11.160714285714286
"Gilberton borough, Pennsylvania",464,312,152,42,29088,32.758620689655174
"Heckscherville CDP, Pennsylvania",88,71,17,42,33528,19.318181818181817
"Mauldin city, South Carolina",10499,9834,665,45,45115,6.33393656538718
"Simpsonville city, South Carolina",8645,8073,572,45,66580,6.616541353383458
"Taylors CDP, South Carolina",8970,8543,427,45,71395,4.7603121516165
"Welcome CDP, South Carolina",3208,2905,303,45,75535,9.445137157107233
"Branchville town, South Carolina",488,414,74,45,08245,15.163934426229508
"Cowpens town, South Carolina",901,789,112,45,17260,12.430632630410656
"Pacolet town, South Carolina",1182,963,219,45,53845,18.527918781725887
"Watts Mills CDP, South Carolina",526,526,0,45,75220,0.0
"Walhalla city, South Carolina",1962,1756,206,45,74095,10.499490316004078
"Stuckey town, South Carolina",102,83,19,45,70045,18.627450980392158
"Paxville town, South Carolina",181,170,11,45,55060,6.077348066298343
"Summerton town, South Carolina",563,461,102,45,70225,18.117229129662523
"McClellanville town, South Carolina",288,213,75,45,43585,26.041666666666668
"Central Pacolet town, South Carolina",81,59,22,45,13060,27.160493827160494
"Inman Mills CDP, South Carolina",313,306,7,45,35800,2.2364217252396164
"Saxon CDP, South Carolina",1552,1242,310,45,64240,19.974226804123713
"Cross Hill town, South Carolina",277,223,54,45,17890,19.494584837545126
"Wagener town, South Carolina",387,314,73,45,74050,18.863049095607234
"Lake Wylie CDP, South Carolina",5071,4819,252,45,39785,4.969434036679156
"Georgetown city, South Carolina",4192,3422,770,45,28870,18.36832061068702
"Elgin town, South Carolina",600,564,36,45,23245,6.0
"Red Hill CDP, South Carolina",6882,5970,912,45,59190,13.251961639058413
"Monarch Mill CDP, South Carolina",783,641,142,45,47200,18.135376756066414
"Lake City city, South Carolina",2881,2349,532,45,39310,18.465810482471365
"Scranton town, South Carolina",331,302,29,45,64600,8.761329305135952
"Loris city, South Carolina",1190,1050,140,45,42730,11.76470588235294
"Batesburg-Leesville town, South Carolina",2403,2010,393,45,04300,16.354556803995006
"Winnsboro Mills CDP, South Carolina",934,840,94,45,78505,10.06423982869379
"Florence city, South Carolina",17401,15291,2110,45,25810,12.125739900005748
"Olanta town, South Carolina",240,205,35,45,52540,14.583333333333334
"Conway city, South Carolina",8821,7832,989,45,16405,11.211880739145222
"Myrtle Beach city, South Carolina",24853,13774,11079,45,49075,44.57811934172937
"Surfside Beach town, South Carolina",4412,2070,2342,45,70585,53.08250226654578
"Meggett town, South Carolina",640,542,98,45,45790,15.312500000000002
"Reevesville town, South Carolina",125,94,31,45,59380,24.8
"Coronaca CDP, South Carolina",57,57,0,45,16945,0.0
"Santee town, South Carolina",454,385,69,45,63790,15.198237885462554
"Travelers Rest city, South Carolina",1963,1813,150,45,72430,7.641365257259297
"Norris town, South Carolina",352,300,52,45,50515,14.772727272727273
"Cordova town, South Carolina",65,63,2,45,16855,3.076923076923077
"Greeleyville town, South Carolina",237,185,52,45,30535,21.940928270042196
"Hemingway town, South Carolina",280,229,51,45,33145,18.21428571428571
"Southern Shops CDP, South Carolina",1000,948,52,45,67750,5.2
"West Union town, South Carolina",145,124,21,45,76435,14.482758620689657
"Dentsville CDP, South Carolina",7115,6292,823,45,19285,11.567111735769501
"Lake Murray of Richland CDP, South Carolina",2584,2473,111,45,39475,4.295665634674923
"Peak town, South Carolina",34,25,9,45,55150,26.47058823529412
"Dalzell CDP, South Carolina",1553,1273,280,45,18430,18.0296200901481
"Privateer CDP, South Carolina",1091,905,186,45,58570,17.048579285059578
"Sans Souci CDP, South Carolina",4001,3510,491,45,63700,12.271932016995752
"Sumter city, South Carolina",18164,15779,2385,45,70405,13.130367760405198
"Latta town, South Carolina",753,574,179,45,40480,23.771580345285525
"City View CDP, South Carolina",441,315,126,45,14455,28.57142857142857
"Easley city, South Carolina",9847,8945,902,45,21985,9.160150299583629
"Six Mile town, South Carolina",346,327,19,45,66760,5.491329479768786
"Heath Springs town, South Carolina",299,258,41,45,32965,13.712374581939798
"Gayle Mill CDP, South Carolina",453,347,106,45,28825,23.399558498896248
"Greenwood city, South Carolina",10332,8914,1418,45,30895,13.724351529229578
"Ninety Six town, South Carolina",800,691,109,45,50290,13.625000000000002
"Hometown CDP, Pennsylvania",662,633,29,42,35448,4.380664652567976
"New Ringgold borough, Pennsylvania",109,100,9,42,54016,8.256880733944955
"Nuremberg CDP, Pennsylvania",260,226,34,42,55808,13.076923076923078
"Maytown CDP, Pennsylvania",1225,1225,0,42,48224,0.0
"Adamstown borough, Pennsylvania",837,777,60,42,00364,7.168458781362006
"Marietta borough, Pennsylvania",1153,1086,67,42,47424,5.810928013876843
"Edwardsville borough, Pennsylvania",2388,1988,400,42,22672,16.750418760469014
"Harveys Lake borough, Pennsylvania",2066,1302,764,42,33000,36.979670861568245
"Hughestown borough, Pennsylvania",678,611,67,42,36152,9.882005899705016
"Kingston borough, Pennsylvania",6803,5868,935,42,39784,13.743936498603556
"Stillwater borough, Pennsylvania",114,96,18,42,74184,15.789473684210526
"Dauphin borough, Pennsylvania",378,323,55,42,18272,14.550264550264549
"Elizabethville borough, Pennsylvania",700,626,74,42,23024,10.571428571428571
"Gratz borough, Pennsylvania",356,307,49,42,30600,13.764044943820226
"Arendtsville borough, Pennsylvania",323,307,16,42,02928,4.953560371517028
"Paxtonia CDP, Pennsylvania",2461,2278,183,42,58528,7.436001625355547
"Kittanning borough, Pennsylvania",2292,1800,492,42,40040,21.465968586387437
"Fairdale CDP, Pennsylvania",1197,1032,165,42,24544,13.784461152882205
"Dalton borough, Pennsylvania",586,539,47,42,18088,8.020477815699659
"Dickson City borough, Pennsylvania",2943,2539,404,42,19160,13.727488956846756
"Fullerton CDP, Pennsylvania",6509,6302,207,42,28144,3.180212014134275
"Emporium borough, Pennsylvania",1140,967,173,42,23600,15.175438596491228
"Meshoppen borough, Pennsylvania",203,163,40,42,48856,19.704433497536947
"Nicholson borough, Pennsylvania",317,283,34,42,54400,10.725552050473187
"Castanea CDP, Pennsylvania",510,470,40,42,11648,7.8431372549019605
"East Conemaugh borough, Pennsylvania",611,476,135,42,20992,22.0949263502455
"Hastings borough, Pennsylvania",591,535,56,42,33080,9.475465313028765
"South Fork borough, Pennsylvania",463,406,57,42,72168,12.311015118790497
"Southmont borough, Pennsylvania",1038,920,118,42,72344,11.368015414258188
"Tunnelhill borough, Pennsylvania",174,148,26,42,77808,14.942528735632186
"Wilkes-Barre city, Pennsylvania",19471,15379,4092,42,85152,21.015869755020287
"Wyoming borough, Pennsylvania",1526,1443,83,42,86856,5.439056356487549
"Forest City borough, Pennsylvania",1007,867,140,42,26560,13.902681231380337
"Friendsville borough, Pennsylvania",63,53,10,42,27968,15.873015873015872
"Lanesboro borough, Pennsylvania",218,186,32,42,41336,14.678899082568808
"Oakland borough, Pennsylvania",289,269,20,42,56008,6.920415224913495
"Sunbury city, Pennsylvania",4576,4224,352,42,75304,7.6923076923076925
"Seven Fields borough, Pennsylvania",1240,1192,48,42,69309,3.870967741935484
"Shanor-Northvue CDP, Pennsylvania",2437,2255,182,42,69715,7.468198604842019
"West Sunbury borough, Pennsylvania",96,83,13,42,84064,13.541666666666666
"Atlantic CDP, Pennsylvania",23,23,0,42,03440,0.0
"Cambridge Springs borough, Pennsylvania",870,819,51,42,10912,5.862068965517241
"Guys Mills CDP, Pennsylvania",19,19,0,42,31840,0.0
"Saegertown borough, Pennsylvania",366,323,43,42,67120,11.748633879781421
"Jefferson borough (Greene County), Pennsylvania",132,102,30,42,37880,22.727272727272727
"Oakwood CDP, Pennsylvania",1035,930,105,42,56232,10.144927536231885
"Landisburg borough, Pennsylvania",87,78,9,42,41272,10.344827586206897
"Carmichaels borough, Pennsylvania",224,210,14,42,11328,6.25
"Clarks Green borough, Pennsylvania",686,653,33,42,13864,4.810495626822157
"Beaver Springs CDP, Pennsylvania",291,260,31,42,04824,10.652920962199312
"Selinsgrove borough, Pennsylvania",2111,1871,240,42,69216,11.369019422074846
"Troxelville CDP, Pennsylvania",124,108,16,42,77576,12.903225806451612
"Slatington borough, Pennsylvania",2006,1817,189,42,71144,9.421734795613162
"Bethlehem city, Pennsylvania",31189,28945,2244,42,06088,7.194844336144153
"Northampton borough, Pennsylvania",4187,3948,239,42,54696,5.708144256030571
"Pen Argyl borough, Pennsylvania",1581,1439,142,42,58696,8.981657179000631
"Harrisburg city, Pennsylvania",25450,20520,4930,42,32800,19.3713163064833
"Paxtang borough, Pennsylvania",699,690,9,42,58504,1.2875536480686696
"Riverview CDP, South Carolina",389,299,90,45,61112,23.13624678663239
"Union city, South Carolina",4055,3455,600,45,73105,14.796547472256474
"Andrews town, South Carolina",1358,1094,264,45,01450,19.44035346097202
"Barnwell city, South Carolina",2280,1736,544,45,04060,23.859649122807017
"Snelling town, South Carolina",128,98,30,45,67255,23.4375
"Williston town, South Carolina",1526,1159,367,45,77965,24.049803407601573
"St. George town, South Carolina",930,808,122,45,62530,13.118279569892474
"Modoc CDP, South Carolina",335,103,232,45,47050,69.25373134328359
"Moncks Corner town, South Carolina",3810,3562,248,45,47275,6.509186351706036
"Edisto Beach town, South Carolina",2162,300,1862,45,23020,86.12395929694728
"Abbeville city, South Carolina",2660,2194,466,45,00100,17.518796992481203
"Little Mountain town, South Carolina",122,88,34,45,41965,27.86885245901639
"Lynchburg town, South Carolina",212,157,55,45,43360,25.943396226415093
"St. Stephen town, South Carolina",814,682,132,45,62755,16.216216216216218
"Promised Land CDP, South Carolina",221,221,0,45,58615,0.0
"Mount Carmel CDP, South Carolina",173,129,44,45,48310,25.43352601156069
"Cheraw town, South Carolina",2772,2124,648,45,13600,23.376623376623375
"Judson CDP, South Carolina",922,681,241,45,37465,26.13882863340564
"Chesnee city, South Carolina",435,320,115,45,14050,26.436781609195403
"Stateburg CDP, South Carolina",754,594,160,45,69010,21.220159151193634
"Fountain Inn city, South Carolina",3399,2939,460,45,27070,13.533392174168874
"Aynor town, South Carolina",325,289,36,45,03430,11.076923076923077
"Salley town, South Carolina",155,112,43,45,63115,27.741935483870968
"Jonesville town, South Carolina",433,318,115,45,37330,26.558891454965355
"Garden City CDP, South Carolina",9991,4837,5154,45,28455,51.58642778500651
"Rembert CDP, South Carolina",127,98,29,45,59470,22.83464566929134
"Harleyville town, South Carolina",324,287,37,45,32335,11.419753086419753
"Honea Path town, South Carolina",1838,1522,316,45,34810,17.19260065288357
"Calhoun Falls town, South Carolina",940,758,182,45,10720,19.361702127659576
"Utica CDP, South Carolina",788,581,207,45,73330,26.269035532994923
"Bowman town, South Carolina",439,335,104,45,07840,23.690205011389523
"Greenville city, South Carolina",32620,28762,3858,45,30850,11.82709993868792
"Sullivan's Island town, South Carolina",1088,800,288,45,70090,26.47058823529412
"Perry town, South Carolina",110,79,31,45,55960,28.18181818181818
"Folly Beach city, South Carolina",2912,1357,1555,45,26035,53.39972527472527
"Chester city, South Carolina",2760,2235,525,45,14095,19.021739130434785
"Newport CDP, South Carolina",1661,1607,54,45,49885,3.2510535821794098
"Tega Cay city, South Carolina",3591,3454,137,45,71417,3.815093288777499
"Hanahan city, South Carolina",8863,8376,487,45,32065,5.49475346947986
"Fort Lawn town, South Carolina",395,362,33,45,26845,8.354430379746836
"Ladson CDP, South Carolina",5348,4941,407,45,39220,7.610321615557218
"McBee town, South Carolina",420,331,89,45,43495,21.19047619047619
"Hartsville city, South Carolina",3592,3065,527,45,32560,14.671492204899778
"Isle of Palms city, South Carolina",4409,1879,2530,45,36115,57.382626445906105
"Mount Pleasant town, South Carolina",35849,33208,2641,45,48535,7.36701163212363
"Oak Grove CDP, South Carolina",4772,4543,229,45,51720,4.798826487845767
"Pine Ridge town, South Carolina",930,845,85,45,56950,9.13978494623656
"Seven Oaks CDP, South Carolina",7314,6575,739,45,65207,10.103910308996445
"Pendleton town, South Carolina",1750,1450,300,45,55645,17.142857142857142
"Starr town, South Carolina",82,65,17,45,68875,20.73170731707317
"Govan town, South Carolina",29,29,0,45,29950,0.0
"Spartanburg city, South Carolina",17936,15294,2642,45,68290,14.730151650312221
"Startex CDP, South Carolina",577,527,50,45,68920,8.665511265164644
"Belvedere CDP, South Carolina",2600,2083,517,45,05410,19.884615384615383
"Springdale CDP, South Carolina",1045,831,214,45,68380,20.47846889952153
"Waterloo town, South Carolina",63,61,2,45,74995,3.1746031746031744
"Gaston town, South Carolina",689,618,71,45,28780,10.304789550072568
"Lexington town, South Carolina",8654,7995,659,45,41335,7.614975733764733
"Blackville town, South Carolina",1225,887,338,45,06490,27.591836734693874
"Apollo borough, Pennsylvania",743,634,109,42,02720,14.670255720053834
"Leechburg borough, Pennsylvania",1152,977,175,42,42280,15.190972222222221
"North Apollo borough, Pennsylvania",639,580,59,42,54728,9.233176838810643
"St. Lawrence borough, Pennsylvania",802,791,11,42,67304,1.3715710723192018
"Akron borough, Pennsylvania",1735,1688,47,42,00540,2.7089337175792507
"Bernville borough, Pennsylvania",427,355,72,42,05848,16.861826697892273
"Laureldale borough, Pennsylvania",1700,1573,127,42,41768,7.470588235294118
"Shoemakersville borough, Pennsylvania",598,577,21,42,70464,3.511705685618729
"Whitfield CDP, Pennsylvania",1924,1784,140,42,84856,7.276507276507277
"Alexandria borough, Pennsylvania",137,136,1,42,00756,0.7299270072992701
"Huntingdon borough, Pennsylvania",2914,2664,250,42,36368,8.579272477693891
"Marklesburg borough, Pennsylvania",138,93,45,42,47544,32.608695652173914
"Three Springs borough, Pennsylvania",273,252,21,42,76632,7.6923076923076925
"Brockway borough, Pennsylvania",1009,951,58,42,08960,5.7482656095143705
"Corsica borough, Pennsylvania",159,145,14,42,16304,8.80503144654088
"Punxsutawney borough, Pennsylvania",3087,2678,409,42,62920,13.249109167476513
"Denver borough, Pennsylvania",1502,1493,9,42,18888,0.5992010652463382
"Millersville borough, Pennsylvania",2939,2789,150,42,49728,5.103776794828173
"Mountville borough, Pennsylvania",1153,1153,0,42,52016,0.0
"Terre Hill borough, Pennsylvania",426,409,17,42,76400,3.9906103286384975
"Blawnox borough, Pennsylvania",891,831,60,42,07000,6.7340067340067336
"Strattanville borough, Pennsylvania",260,258,2,42,74728,0.7692307692307693
"Cherry Tree borough, Pennsylvania",155,141,14,42,13120,9.032258064516128
"Chevy Chase Heights CDP, Pennsylvania",953,828,125,42,13400,13.11647429171039
"Bear Creek Village borough, Pennsylvania",147,101,46,42,04599,31.292517006802722
"Progress CDP, Pennsylvania",4564,4359,205,42,62736,4.491673970201577
"Royalton borough, Pennsylvania",558,490,68,42,66560,12.186379928315413
"West Grove borough, Pennsylvania",943,907,36,42,83104,3.8176033934252387
"Port Matilda borough, Pennsylvania",294,273,21,42,62280,7.142857142857142
"State College borough, Pennsylvania",14099,12523,1576,42,73808,11.178097737428185
"Unionville borough, Pennsylvania",93,84,9,42,78616,9.67741935483871
"Kistler borough, Pennsylvania",176,138,38,42,40016,21.59090909090909
"McVeytown borough, Pennsylvania",186,165,21,42,46400,11.29032258064516
"Audubon CDP, Pennsylvania",3700,3549,151,42,03544,4.081081081081081
"Bridgeport borough, Pennsylvania",2272,2068,204,42,08568,8.97887323943662
"Koppel borough, Pennsylvania",380,341,39,42,40400,10.263157894736842
"Green Lane borough, Pennsylvania",214,191,23,42,31088,10.74766355140187
"Souderton borough, Pennsylvania",2815,2668,147,42,71856,5.22202486678508
"Youngstown borough, Pennsylvania",156,130,26,42,87208,16.666666666666664
"Chambersburg borough, Pennsylvania",9365,8634,731,42,12536,7.805659369994661
"Guilford CDP, Pennsylvania",1053,1000,53,42,31716,5.0332383665717
"Chesterbrook CDP, Pennsylvania",2274,2165,109,42,13216,4.793315743183817
"Coatesville city, Pennsylvania",5152,4537,615,42,14712,11.937111801242237
"Downingtown borough, Pennsylvania",3563,3312,251,42,19752,7.044625315745158
"Phoenixville borough, Pennsylvania",7461,7111,350,42,60120,4.69106017960059
"Gilbertsville CDP, Pennsylvania",2113,2051,62,42,29096,2.9342167534311407
"Horsham CDP, Pennsylvania",5975,5716,259,42,35800,4.334728033472803
"Schwenksville borough, Pennsylvania",689,631,58,42,68328,8.417997097242381
"Waynesboro borough, Pennsylvania",5137,4771,366,42,81824,7.124781000583999
"Lansford borough, Pennsylvania",2162,1668,494,42,41464,22.849213691026826
"Campbelltown CDP, Pennsylvania",1724,1635,89,42,10960,5.162412993039443
"Albion borough, Pennsylvania",724,674,50,42,00628,6.906077348066299
"Avonia CDP, Pennsylvania",487,459,28,42,03676,5.749486652977413
"Platea borough, Pennsylvania",175,165,10,42,61168,5.714285714285714
"Cressona borough, Pennsylvania",755,681,74,42,17152,9.801324503311259
"Frackville borough, Pennsylvania",1853,1500,353,42,27232,19.05018888289261
"Gordon borough, Pennsylvania",370,306,64,42,30128,17.2972972972973
"Lake Wynonah CDP, Pennsylvania",1249,1080,169,42,41099,13.530824659727783
"Lincolnville town, South Carolina",538,437,101,45,41740,18.773234200743495
"Antreville CDP, South Carolina",64,50,14,45,01810,21.875
"Pageland town, South Carolina",1238,1083,155,45,54025,12.520193861066236
"Ruby town, South Carolina",220,190,30,45,62080,13.636363636363635
"Manning city, South Carolina",1743,1535,208,45,44350,11.933448078026391
"Kershaw town, South Carolina",897,793,104,45,38095,11.594202898550725
"Clinton city, South Carolina",3577,2981,596,45,15295,16.66200726866089
"Due West town, South Carolina",316,259,57,45,21040,18.037974683544302
"Lake Secession CDP, South Carolina",966,443,523,45,39512,54.14078674948241
"Clearwater CDP, South Carolina",1982,1631,351,45,14860,17.709384460141273
"Sharon town, South Carolina",206,189,17,45,65410,8.25242718446602
"Allendale town, South Carolina",1546,1250,296,45,00955,19.146183699870633
"Sycamore town, South Carolina",108,90,18,45,70900,16.666666666666664
"Ulmer town, South Carolina",51,22,29,45,72880,56.86274509803921
"Hilda town, South Carolina",218,186,32,45,33820,14.678899082568808
"Bonneau town, South Carolina",273,224,49,45,07525,17.94871794871795
"Richburg town, South Carolina",152,112,40,45,59920,26.31578947368421
"Darlington city, South Carolina",3203,2772,431,45,18565,13.456134873556042
"Awendaw town, South Carolina",577,492,85,45,03385,14.731369150779896
"Cokesbury CDP, South Carolina",87,87,0,45,15625,0.0
"Summit town, South Carolina",232,210,22,45,70315,9.482758620689655
"Homeland Park CDP, South Carolina",2986,2682,304,45,34720,10.180843938379102
"Valley Falls CDP, South Carolina",2808,2577,231,45,73465,8.226495726495726
"Princeton CDP, South Carolina",8,8,0,45,58435,0.0
"Aiken city, South Carolina",14857,13211,1646,45,00550,11.078952682237329
"Fort Mill town, South Carolina",6031,5702,329,45,26890,5.455148399933676
"Arcadia Lakes town, South Carolina",402,382,20,45,02125,4.975124378109453
"St. Andrews CDP, South Carolina",11095,9586,1509,45,62395,13.600721045515998
"Prosperity town, South Carolina",505,489,16,45,58705,3.1683168316831685
"Silverstreet town, South Carolina",88,66,22,45,66400,25.0
"Oakland CDP, South Carolina",662,556,106,45,51887,16.012084592145015
"Dunean CDP, South Carolina",1849,1620,229,45,21310,12.385073012439156
"Lake View town, South Carolina",462,366,96,45,39715,20.77922077922078
"Clemson city, South Carolina",7153,6246,907,45,14950,12.679994407940724
"Berea CDP, South Carolina",6085,5711,374,45,05770,6.146261298274445
"Wade Hampton CDP, South Carolina",9757,9019,738,45,73870,7.563800348467767
"Mullins city, South Carolina",2122,1633,489,45,48805,23.04429783223374
"Gray Court town, South Carolina",366,314,52,45,30355,14.207650273224044
"Cope town, South Carolina",47,31,16,45,16720,34.04255319148936
"Laurens city, South Carolina",4544,3763,781,45,40615,17.1875
"Ware Shoals town, South Carolina",1144,966,178,45,74680,15.55944055944056
"Nichols town, South Carolina",203,113,90,45,50110,44.33497536945813
"Elloree town, South Carolina",354,262,92,45,23470,25.98870056497175
"Oswego CDP, South Carolina",114,114,0,45,53485,0.0
"South Sumter CDP, South Carolina",996,833,163,45,68177,16.365461847389557
"Seneca city, South Carolina",4323,3750,573,45,65095,13.25468424705066
"Blythewood town, South Carolina",1115,996,119,45,07255,10.672645739910314
"Forest Acres city, South Carolina",4966,4557,409,45,26305,8.236004832863472
"Irmo town, South Carolina",5060,4608,452,45,35890,8.932806324110672
"Gaffney city, South Carolina",5644,4293,1351,45,28060,23.936924167257263
"Dillon city, South Carolina",2608,2130,478,45,19420,18.328220858895705
"Hardeeville city, South Carolina",2500,2402,98,45,32245,3.92
"Brunson town, South Carolina",240,184,56,45,09865,23.333333333333332
"Yemassee town, South Carolina",421,363,58,45,79450,13.77672209026128
"Gantt CDP, South Carolina",6135,5523,612,45,28375,9.975550122249388
"Golden Grove CDP, South Carolina",1255,1209,46,45,29635,3.6653386454183265
"Slater-Marietta CDP, South Carolina",1003,704,299,45,66917,29.810568295114653
"Brookdale CDP, South Carolina",2346,1617,729,45,09527,31.074168797953966
"Livingston town, South Carolina",75,51,24,45,42100,32.0
"Pine Grove borough, Pennsylvania",1025,824,201,42,60456,19.609756097560975
"Renningers CDP, Pennsylvania",192,192,0,42,64188,0.0
"Summit Station CDP, Pennsylvania",100,100,0,42,75272,0.0
"McEwensville borough, Pennsylvania",174,161,13,42,46120,7.471264367816093
"Mount Carmel borough, Pennsylvania",3663,2849,814,42,51496,22.22222222222222
"Snow Shoe borough, Pennsylvania",349,308,41,42,71600,11.74785100286533
"Reamstown CDP, Pennsylvania",1396,1283,113,42,63664,8.094555873925502
"Rothsville CDP, Pennsylvania",1009,935,74,42,66392,7.333994053518335
"Ben Avon borough, Pennsylvania",824,767,57,42,05504,6.917475728155339
"Braddock borough, Pennsylvania",1121,722,399,42,07992,35.59322033898305
"Braddock Hills borough, Pennsylvania",1084,942,142,42,08008,13.099630996309964
"Rutherford CDP, Pennsylvania",1942,1877,65,42,66864,3.3470648815653967
"Orchard Hills CDP, Pennsylvania",1028,901,127,42,56960,12.354085603112841
"McConnellsburg borough, Pennsylvania",584,513,71,42,46000,12.157534246575343
"Valley-Hi borough, Pennsylvania",22,1,21,42,79644,95.45454545454545
"Bechtelsville borough, Pennsylvania",412,385,27,42,04896,6.553398058252427
"Shillington borough, Pennsylvania",2305,2216,89,42,70248,3.86117136659436
"Sinking Spring borough, Pennsylvania",1656,1586,70,42,70880,4.2270531400966185
"Wyomissing borough, Pennsylvania",4510,4278,232,42,86880,5.144124168514413
"Broad Top City borough, Pennsylvania",205,182,23,42,08896,11.219512195121952
"Cassville borough, Pennsylvania",60,57,3,42,11632,5.0
"Summerville borough, Pennsylvania",255,198,57,42,75168,22.35294117647059
"Sykesville borough, Pennsylvania",583,511,72,42,75888,12.34991423670669
"Timblin borough, Pennsylvania",79,66,13,42,76744,16.455696202531644
"Fayetteville CDP, Pennsylvania",1475,1433,42,42,25464,2.847457627118644
"Clarksville borough, Pennsylvania",83,61,22,42,13896,26.506024096385545
"Julian CDP, Pennsylvania",69,69,0,42,38528,0.0
"Morrisville CDP, Pennsylvania",587,562,25,42,51152,4.258943781942079
"Jessup borough, Pennsylvania",2057,1793,264,42,38160,12.834224598930483
"Centre Hall borough, Pennsylvania",492,473,19,42,12376,3.861788617886179
"Adamsburg borough, Pennsylvania",104,75,29,42,00332,27.884615384615387
"Delmont borough, Pennsylvania",1475,1252,223,42,18768,15.11864406779661
"Lower Burrell city, Pennsylvania",5263,4758,505,42,44864,9.595287858635759
"Oklahoma borough, Pennsylvania",415,371,44,42,56496,10.602409638554217
"Vandergrift borough, Pennsylvania",2734,2223,511,42,79776,18.69056327724945
"West Newton borough, Pennsylvania",1382,1217,165,42,83680,11.939218523878436
"Philadelphia city, Pennsylvania",682893,594778,88115,42,60000,12.903192740297529
"Bridgewater borough, Pennsylvania",431,387,44,42,08632,10.208816705336426
"Frankfort Springs borough, Pennsylvania",56,51,5,42,27312,8.928571428571429
"New Brighton borough, Pennsylvania",3049,2625,424,42,53288,13.906198753689733
"New Galilee borough, Pennsylvania",177,145,32,42,53592,18.07909604519774
"Dawson borough, Pennsylvania",197,180,17,42,18360,8.629441624365482
"Everson borough, Pennsylvania",424,343,81,42,24336,19.10377358490566
"Hiller CDP, Pennsylvania",609,462,147,42,34784,24.137931034482758
"Oliver CDP, Pennsylvania",1301,1107,194,42,56704,14.91160645657187
"South Connellsville borough, Pennsylvania",812,760,52,42,72080,6.403940886699508
"Ramblewood CDP, Pennsylvania",346,346,0,42,63349,0.0
"Greensburg city, Pennsylvania",7729,6627,1102,42,31200,14.257989390606806
"Hunker borough, Pennsylvania",127,126,1,42,36288,0.7874015748031495
"Ligonier borough, Pennsylvania",942,776,166,42,43232,17.62208067940552
"Sandy Ridge CDP, Pennsylvania",194,118,76,42,67872,39.175257731958766
"Newton Hamilton borough, Pennsylvania",89,64,25,42,54160,28.08988764044944
"Yeagertown CDP, Pennsylvania",473,420,53,42,86976,11.20507399577167
"Hughesville borough, Pennsylvania",990,914,76,42,36160,7.6767676767676765
"Cranesville borough, Pennsylvania",220,199,21,42,16960,9.545454545454547
"Brentwood borough, Pennsylvania",4429,3995,434,42,08416,9.799051704673742
"Carnot-Moon CDP, Pennsylvania",5234,4727,507,42,11348,9.686664119220481
"Fleetwood borough, Pennsylvania",1625,1576,49,42,26280,3.0153846153846153
"Norway town, South Carolina",191,134,57,45,51550,29.84293193717277
"Wilkinson Heights CDP, South Carolina",1120,765,355,45,77672,31.69642857142857
"Woodford town, South Carolina",88,56,32,45,78910,36.36363636363637
"Lane town, South Carolina",213,171,42,45,40210,19.718309859154928
"Irwin CDP, South Carolina",503,503,0,45,35980,0.0
"Bradley CDP, South Carolina",57,28,29,45,08155,50.877192982456144
"Charleston city, South Carolina",62753,55013,7740,45,13330,12.33407167784807
"Great Falls town, South Carolina",876,721,155,45,30490,17.69406392694064
"Bethune town, South Carolina",194,123,71,45,06040,36.597938144329895
"Lugoff CDP, South Carolina",3364,3135,229,45,43000,6.807372175980975
"Atlantic Beach town, South Carolina",255,92,163,45,03205,63.921568627450974
"Little River CDP, South Carolina",7270,4721,2549,45,42010,35.06189821182944
"Saluda town, South Carolina",1410,1150,260,45,63250,18.439716312056735
"Buffalo CDP, South Carolina",864,644,220,45,10090,25.462962962962965
"Lodge town, South Carolina",61,26,35,45,42280,57.377049180327866
"Walterboro city, South Carolina",2598,2310,288,45,74275,11.085450346420323
"North Augusta city, South Carolina",10197,9477,720,45,50695,7.0609002647837595
"Camden city, South Carolina",3508,2953,555,45,10855,15.820980615735461
"Luray town, South Carolina",98,55,43,45,43090,43.87755102040816
"Cane Savannah CDP, South Carolina",495,470,25,45,11350,5.05050505050505
"East Gaffney CDP, South Carolina",1391,1046,345,45,22075,24.802300503235085
"Hampton town, South Carolina",1483,1212,271,45,31885,18.27376938637896
"Arial CDP, South Carolina",1091,928,163,45,02440,14.940421631530706
"Five Forks CDP, South Carolina",5886,5630,256,45,25540,4.349303431872239
"Parker CDP, South Carolina",5017,4457,560,45,54535,11.162049033286825
"Piedmont CDP, South Carolina",2373,2077,296,45,56365,12.473662031184155
"Kingstree town, South Carolina",1655,1407,248,45,38590,14.984894259818732
"Campobello town, South Carolina",226,203,23,45,11125,10.176991150442479
"Duncan town, South Carolina",1436,1236,200,45,21265,13.92757660167131
"Greer city, South Carolina",11986,11212,774,45,30985,6.457533789420991
"Inman city, South Carolina",1336,1171,165,45,35755,12.350299401197605
"Roebuck CDP, South Carolina",921,862,59,45,61720,6.406080347448426
"Landrum city, South Carolina",1247,1081,166,45,40075,13.311948676824379
"Mayo CDP, South Carolina",636,524,112,45,45430,17.61006289308176
"Reidville town, South Carolina",343,310,33,45,59425,9.620991253644315
"Elgin CDP, South Carolina",1380,1222,158,45,23290,11.44927536231884
"Eastover town, South Carolina",350,285,65,45,22390,18.571428571428573
"East Sumter CDP, South Carolina",653,482,171,45,22547,26.186830015313934
"Mayesville town, South Carolina",298,206,92,45,45295,30.87248322147651
"Whitmire town, South Carolina",894,595,299,45,77380,33.44519015659955
"Westminster city, South Carolina",1300,1068,232,45,76165,17.846153846153847
"Columbia city, South Carolina",54542,46822,7720,45,16000,14.1542297678853
"Tatum town, South Carolina",49,35,14,45,71305,28.57142857142857
"Pinewood town, South Carolina",271,189,82,45,57085,30.25830258302583
"Shiloh CDP, South Carolina",88,88,0,45,65950,0.0
"Blacksburg town, South Carolina",943,767,176,45,06400,18.66383881230117
"Estill town, South Carolina",1222,872,350,45,23830,28.641571194762683
"Gifford town, South Carolina",125,98,27,45,29005,21.6
"Varnville town, South Carolina",933,702,231,45,73600,24.758842443729904
"Bishopville city, South Carolina",1637,1234,403,45,06310,24.618204031765426
"Mulberry CDP, South Carolina",259,122,137,45,48737,52.8957528957529
"Clio town, South Carolina",359,307,52,45,15310,14.484679665738161
"McColl town, South Carolina",1030,822,208,45,43630,20.19417475728155
"Scotia town, South Carolina",123,102,21,45,64465,17.073170731707318
"Burton CDP, South Carolina",3279,2941,338,45,10360,10.308020738029887
"Wedgefield CDP, South Carolina",727,637,90,45,75445,12.379642365887207
"Powdersville CDP, South Carolina",3581,3344,237,45,58170,6.618263055012566
"James Island town, South Carolina",5417,4921,496,45,36430,9.156359608639468
"Society Hill town, South Carolina",312,233,79,45,67435,25.320512820512818
"New Albany borough, Pennsylvania",165,121,44,42,53152,26.666666666666668
"Briar Creek borough, Pennsylvania",390,353,37,42,08472,9.487179487179487
"Fernville CDP, Pennsylvania",187,187,0,42,25744,0.0
"Amity Gardens CDP, Pennsylvania",1179,1134,45,42,02349,3.816793893129771
"Birdsboro borough, Pennsylvania",2128,2000,128,42,06504,6.015037593984962
"Robesonia borough, Pennsylvania",964,856,108,42,65336,11.20331950207469
"Petersburg borough, Pennsylvania",192,182,10,42,59616,5.208333333333334
"Gap CDP, Pennsylvania",659,659,0,42,28376,0.0
"Lititz borough, Pennsylvania",4036,3889,147,42,43816,3.6422200198216057
"Mount Joy borough, Pennsylvania",3634,3480,154,42,51656,4.237754540451293
"Quarryville borough, Pennsylvania",976,916,60,42,63064,6.147540983606557
"Easton city, Pennsylvania",10933,9261,1672,42,21648,15.29314918137748
"Palmer Heights CDP, Pennsylvania",1455,1445,10,42,57680,0.6872852233676976
"Portland borough, Pennsylvania",231,188,43,42,62264,18.614718614718615
"Walnutport borough, Pennsylvania",851,807,44,42,80800,5.170387779083431
"Wind Gap borough, Pennsylvania",1363,1183,180,42,85664,13.206162876008804
"Cassandra borough, Pennsylvania",80,74,6,42,11616,7.5
"Lewisburg borough, Pennsylvania",2296,2076,220,42,42976,9.581881533101045
"Milford borough, Pennsylvania",643,586,57,42,49400,8.864696734059098
"Claysburg CDP, Pennsylvania",676,556,120,42,13992,17.75147928994083
"Boothwyn CDP, Pennsylvania",2136,1956,180,42,07616,8.426966292134832
"Glenolden borough, Pennsylvania",3130,2864,266,42,29720,8.498402555910543
"Abbottstown borough, Pennsylvania",349,323,26,42,00116,7.4498567335243555
"Bonneauville borough, Pennsylvania",719,686,33,42,07560,4.58970792767733
"Gettysburg borough, Pennsylvania",2568,2338,230,42,28960,8.95638629283489
"Lake Meade CDP, Pennsylvania",1064,920,144,42,40988,13.533834586466165
"York Springs borough, Pennsylvania",292,275,17,42,87136,5.821917808219178
"Rohrsburg CDP, Pennsylvania",79,71,8,42,65872,10.126582278481013
"Halifax borough, Pennsylvania",414,376,38,42,32032,9.178743961352657
"Skyline View CDP, Pennsylvania",1947,1762,185,42,71032,9.501797637390858
"Applewold borough, Pennsylvania",178,148,30,42,02752,16.853932584269664
"Beavertown borough, Pennsylvania",444,398,46,42,04848,10.36036036036036
"Alburtis borough, Pennsylvania",1015,947,68,42,00660,6.6995073891625605
"Chicora borough, Pennsylvania",478,436,42,42,13440,8.786610878661087
"Karns City borough, Pennsylvania",90,81,9,42,38768,10.0
"Edinboro borough, Pennsylvania",2418,1881,537,42,22608,22.208436724565754
"Beaver Falls city, Pennsylvania",4059,3275,784,42,04792,19.315102241931513
"Bath borough, Pennsylvania",1116,1013,103,42,04432,9.229390681003585
"New Bethlehem borough, Pennsylvania",513,457,56,42,53248,10.916179337231968
"Wolfdale CDP, Pennsylvania",1286,1286,0,42,86000,0.0
"Wyncote CDP, Pennsylvania",1216,1135,81,42,86744,6.661184210526317
"South New Castle borough, Pennsylvania",332,304,28,42,72376,8.433734939759036
"North Belle Vernon borough, Pennsylvania",963,791,172,42,54776,17.86085150571132
"Connellsville city, Pennsylvania",3840,3455,385,42,15776,10.026041666666668
"Point Marion borough, Pennsylvania",614,533,81,42,61864,13.192182410423452
"Port Clinton borough, Pennsylvania",152,121,31,42,62136,20.394736842105264
"Trevorton CDP, Pennsylvania",847,706,141,42,77448,16.646989374262102
"New Salem borough, Pennsylvania",322,301,21,42,54056,6.521739130434782
"Philipsburg borough, Pennsylvania",1539,1323,216,42,60008,14.035087719298245
"East Washington borough, Pennsylvania",973,795,178,42,22016,18.29393627954779
"Chalfant borough, Pennsylvania",427,363,64,42,12496,14.988290398126464
"Arlington Heights CDP, Pennsylvania",2346,2010,336,42,03008,14.322250639386189
"Orrstown borough, Pennsylvania",125,112,13,42,57112,10.4
"Rankin borough, Pennsylvania",1080,899,181,42,63408,16.75925925925926
"Bolivar borough, Pennsylvania",201,170,31,42,07480,15.422885572139302
"Littlestown borough, Pennsylvania",1969,1849,120,42,43944,6.094464195022854
"Nesquehoning borough, Pennsylvania",1512,1329,183,42,53088,12.103174603174603
"Ashland borough, Pennsylvania",1692,1272,420,42,03264,24.822695035460992
"Rockville town, South Carolina",119,65,54,45,61495,45.378151260504204
"Summerville town, South Carolina",20157,18399,1758,45,70270,8.721535942848638
"Iva town, South Carolina",685,550,135,45,36160,19.708029197080293
"Pelzer town, South Carolina",671,571,100,45,55465,14.903129657228018
"Denmark city, South Carolina",1706,1072,634,45,19105,37.162954279015246
"Cameron town, South Carolina",221,181,40,45,10900,18.099547511312217
"Smoaks town, South Carolina",49,41,8,45,67165,16.3265306122449
"Clover town, South Carolina",2309,2075,234,45,15355,10.134257254222607
"Lesslie CDP, South Carolina",1234,1113,121,45,41065,9.805510534846029
"Clarks Hill CDP, South Carolina",161,115,46,45,14590,28.57142857142857
"Plum Branch town, South Carolina",62,31,31,45,57670,50.0
"Chapin town, South Carolina",795,722,73,45,13150,9.182389937106917
"South Congaree town, South Carolina",1033,911,122,45,67705,11.81026137463698
"Kline town, South Carolina",103,56,47,45,38950,45.63106796116505
"Jefferson town, South Carolina",403,378,25,45,36610,6.20347394540943
"Hollywood town, South Carolina",2545,2151,394,45,34495,15.481335952848724
"Eureka Mill CDP, South Carolina",666,567,99,45,24020,14.864864864864865
"Chesterfield town, South Carolina",700,550,150,45,14140,21.428571428571427
"Mount Croghan town, South Carolina",90,56,34,45,48355,37.77777777777778
"Patrick town, South Carolina",210,180,30,45,54925,14.285714285714285
"North Hartsville CDP, South Carolina",1142,999,143,45,51145,12.521891418563925
"Goose Creek city, South Carolina",14550,13770,780,45,29815,5.360824742268041
"Seabrook Island town, South Carolina",2287,895,1392,45,64712,60.86576300830783
"Belton city, South Carolina",2203,2014,189,45,05365,8.579210167952791
"Bluffton town, South Carolina",7651,6790,861,45,07210,11.253430924062215
"Cottageville town, South Carolina",362,321,41,45,16990,11.32596685082873
"Edgefield town, South Carolina",1389,1204,185,45,22795,13.31893448524118
"Ridgeway town, South Carolina",169,148,21,45,60415,12.42603550295858
"Boiling Springs CDP, South Carolina",3695,3558,137,45,07345,3.7077131258457374
"Wellford city, South Carolina",1058,952,106,45,75580,10.01890359168242
"Smyrna town, South Carolina",35,15,20,45,67210,57.14285714285714
"York city, South Carolina",3565,3353,212,45,79630,5.946704067321178
"Lowndesville town, South Carolina",95,54,41,45,42820,43.15789473684211
"Jackson town, South Carolina",934,772,162,45,36205,17.34475374732334
"New Ellenton town, South Carolina",1121,997,124,45,49705,11.061552185548617
"McCormick town, South Carolina",930,740,190,45,43720,20.43010752688172
"Pelion town, South Carolina",272,263,9,45,55420,3.308823529411765
"Van Wyck town, South Carolina",236,154,82,45,73555,34.74576271186441
"Alcolu CDP, South Carolina",195,195,0,45,00775,0.0
"Arcadia CDP, South Carolina",1618,1523,95,45,02080,5.871446229913473
"Bonneau Beach CDP, South Carolina",1011,749,262,45,07535,25.91493570722057
"Boykin CDP, South Carolina",115,84,31,45,08110,26.956521739130434
"Catawba CDP, South Carolina",559,519,40,45,12430,7.155635062611807
"Clifton CDP, South Carolina",325,267,58,45,15220,17.846153846153847
"Converse CDP, South Carolina",246,246,0,45,16360,0.0
"Cross Anchor CDP, South Carolina",116,61,55,45,17845,47.41379310344828
"Enoree CDP, South Carolina",390,260,130,45,23605,33.33333333333333
"Fairforest CDP, South Carolina",665,566,99,45,24505,14.887218045112782
"Fair Play CDP, South Carolina",452,214,238,45,24730,52.654867256637175
"Fingerville CDP, South Carolina",13,13,0,45,25360,0.0
"Gadsden CDP, South Carolina",617,617,0,45,27970,0.0
"Glendale CDP, South Carolina",145,131,14,45,29275,9.655172413793103
"Gramling CDP, South Carolina",23,23,0,45,30220,0.0
"Graniteville CDP, South Carolina",1422,1189,233,45,30265,16.38537271448664
"Hopkins CDP, South Carolina",1435,1129,306,45,34990,21.32404181184669
"Islandton CDP, South Carolina",48,28,20,45,36070,41.66666666666667
"Jacksonboro CDP, South Carolina",240,200,40,45,36250,16.666666666666664
"Langley CDP, South Carolina",869,681,188,45,40390,21.634062140391254
"Lydia CDP, South Carolina",296,229,67,45,43135,22.635135135135133
"Huron city, South Dakota",6050,5683,367,46,31060,6.066115702479339
"Brandon city, South Dakota",3716,3597,119,46,06840,3.2023681377825617
"Dell Rapids city, South Dakota",1434,1362,72,46,15980,5.02092050209205
"Columbia city, South Dakota",71,60,11,46,13420,15.492957746478872
"Aurora town, South Dakota",300,275,25,46,02780,8.333333333333332
"Brookings city, South Dakota",9851,8830,1021,46,07580,10.364430007105877
"Elkton city, South Dakota",304,261,43,46,18700,14.144736842105262
"Utica town, South Dakota",45,30,15,46,65780,33.33333333333333
"Olivet town, South Dakota",38,28,10,46,46900,26.31578947368421
"Tripp city, South Dakota",347,283,64,46,64020,18.443804034582133
"Chamberlain city, South Dakota",1245,1121,124,46,11220,9.959839357429718
"Gayville town, South Dakota",196,179,17,46,23900,8.673469387755102
"Central City city, South Dakota",102,63,39,46,11140,38.23529411764706
"Tabor town, South Dakota",208,193,15,46,62820,7.211538461538461
"Pukwana town, South Dakota",150,133,17,46,52220,11.333333333333332
"Blackhawk CDP, South Dakota",1272,1272,0,46,05780,0.0
"Hudson town, South Dakota",179,158,21,46,30740,11.731843575418994
"Wallace town, South Dakota",51,38,13,46,68420,25.49019607843137
"Canton city, South Dakota",1246,1127,119,46,09500,9.550561797752808
"Harrisburg city, South Dakota",1906,1906,0,46,27260,0.0
"Pine Ridge CDP, South Dakota",845,650,195,46,49660,23.076923076923077
"Colome city, South Dakota",171,139,32,46,13300,18.71345029239766
"Langford town, South Dakota",170,151,19,46,35820,11.176470588235295
"Clear Lake city, South Dakota",660,598,62,46,12540,9.393939393939393
"Dupree city, South Dakota",211,158,53,46,17420,25.118483412322274
"Pierpont town, South Dakota",82,70,12,46,49540,14.634146341463413
"Roslyn town, South Dakota",120,99,21,46,56380,17.5
"Waubay city, South Dakota",319,227,92,46,69340,28.84012539184953
"Isabel town, South Dakota",74,59,15,46,32140,20.27027027027027
"Albee town, South Dakota",3,3,0,46,00620,0.0
"Strandburg town, South Dakota",32,30,2,46,61980,6.25
"Bradley town, South Dakota",67,38,29,46,06660,43.28358208955223
"McLaughlin city, South Dakota",237,174,63,46,40020,26.582278481012654
"Kyle CDP, South Dakota",213,177,36,46,34460,16.901408450704224
"Oglala CDP, South Dakota",371,294,77,46,46540,20.754716981132077
"Faith city, South Dakota",218,150,68,46,20980,31.19266055045872
"Trent town, South Dakota",144,135,9,46,63940,6.25
"Philip city, South Dakota",570,455,115,46,49300,20.175438596491226
"Miller city, South Dakota",866,722,144,46,42460,16.628175519630485
"Freeman city, South Dakota",630,555,75,46,23020,11.904761904761903
"Milltown CDP, South Dakota",11,11,0,46,42620,0.0
"Clark city, South Dakota",744,649,95,46,12180,12.768817204301076
"White Lake city, South Dakota",211,177,34,46,71180,16.113744075829384
"Leola city, South Dakota",242,190,52,46,36460,21.487603305785125
"Viborg city, South Dakota",466,400,66,46,67020,14.163090128755366
"Alexandria city, South Dakota",267,250,17,46,00820,6.367041198501873
"Eureka city, South Dakota",683,511,172,46,20180,25.183016105417277
"Wetonka town, South Dakota",4,4,0,46,70740,0.0
"Centerville city, South Dakota",478,398,80,46,11060,16.736401673640167
"Monroe town, South Dakota",95,82,13,46,43380,13.684210526315791
"Stickney town, South Dakota",167,129,38,46,61700,22.75449101796407
"Cresbard town, South Dakota",87,50,37,46,14580,42.5287356321839
"Onaka town, South Dakota",28,6,22,46,46980,78.57142857142857
"Orient town, South Dakota",28,25,3,46,47460,10.714285714285714
"Badger town, South Dakota",55,47,8,46,03060,14.545454545454545
"Cottonwood town, South Dakota",5,2,3,46,14220,60.0
"Castlewood city, South Dakota",275,262,13,46,10500,4.7272727272727275
"Lake Norden city, South Dakota",202,182,20,46,35460,9.900990099009901
"Ramona town, South Dakota",122,97,25,46,52860,20.491803278688526
"Brentford town, South Dakota",30,27,3,46,07060,10.0
"Kimball town, Tennessee",679,645,34,47,39400,5.007363770250368
"Whitwell city, Tennessee",957,831,126,47,80620,13.166144200626958
"Bluff City city, Tennessee",902,777,125,47,06960,13.858093126385809
"Normandy town, Tennessee",47,42,5,47,53580,10.638297872340425
"Jellico city, Tennessee",1202,1019,183,47,38020,15.224625623960067
"Elizabethton city, Tennessee",5969,5424,545,47,23500,9.130507622717374
"Auburntown town, Tennessee",109,95,14,47,02400,12.844036697247708
"Roan Mountain CDP, Tennessee",587,508,79,47,63840,13.458262350936966
"Fairfield Glade CDP, Tennessee",5271,4538,733,47,24980,13.906279643331438
"Surgoinsville town, Tennessee",817,764,53,47,72380,6.487148102815178
"Kingston Springs town, Tennessee",1038,1000,38,47,39660,3.6608863198458574
"New Tazewell town, Tennessee",1417,1361,56,47,53140,3.952011291460833
"McEwen city, Tennessee",732,588,144,47,44840,19.672131147540984
"Union City city, Tennessee",5154,4451,703,47,75940,13.63989134652697
"Woodland Mills city, Tennessee",167,138,29,47,81700,17.365269461077844
"Clifton city, Tennessee",565,486,79,47,15480,13.982300884955754
"Fayetteville city, Tennessee",3543,3127,416,47,25920,11.741462037821055
"Lafayette city, Tennessee",2031,1983,48,47,40160,2.363367799113737
"Chattanooga city, Tennessee",83459,72842,10617,47,14000,12.721216405660266
"Arlington town, Tennessee",3441,3413,28,47,01740,0.8137169427492008
"Ashland City town, Tennessee",2156,1946,210,47,02180,9.740259740259742
"Powells Crossroads town, Tennessee",653,536,117,47,60500,17.917304747320063
"Brighton town, Tennessee",1078,997,81,47,08500,7.5139146567718
"Covington city, Tennessee",4106,3647,459,47,17680,11.178762786166585
"Bartlett city, Tennessee",20833,20044,789,47,03440,3.7872605961695385
"Crab Orchard city, Tennessee",297,266,31,47,17840,10.437710437710438
"Lake Tansi CDP, Tennessee",2340,1874,466,47,40560,19.914529914529915
"Tusculum city, Tennessee",746,676,70,47,75560,9.383378016085791
"Church Hill city, Tennessee",3168,2846,322,47,14980,10.164141414141415
"Maynardville city, Tennessee",1145,945,200,47,46700,17.46724890829694
"Hornbeak town, Tennessee",196,165,31,47,36000,15.816326530612246
"Harriman city, Tennessee",3224,2623,601,47,32520,18.641439205955336
"Adams city, Tennessee",242,213,29,47,00200,11.983471074380166
"Greenbrier town, Tennessee",2494,2471,23,47,30960,0.9222133119486768
"Springfield city, Tennessee",6775,6212,563,47,70500,8.309963099630997
"Johnson City city, Tennessee",32112,28337,3775,47,38320,11.755729945191828
"Spurgeon CDP, Tennessee",1986,1829,157,47,70680,7.905337361530715
"Eastview town, Tennessee",458,351,107,47,22920,23.362445414847162
"Guys town, Tennessee",250,213,37,47,31680,14.799999999999999
"Germantown city, Tennessee",15563,14777,786,47,28960,5.050440146501317
"Walterhill CDP, Tennessee",114,114,0,47,77980,0.0
"Red Boiling Springs city, Tennessee",636,535,101,47,62000,15.880503144654087
"Winfield town, Tennessee",483,417,66,47,81280,13.664596273291925
"Louisville city, Tennessee",1806,1631,175,47,43820,9.689922480620156
"Woodbury town, Tennessee",1281,1144,137,47,81560,10.694769711163152
"Tazewell town, Tennessee",1086,993,93,47,73120,8.56353591160221
"Berry Hill city, Tennessee",798,664,134,47,05140,16.791979949874687
"Oak Hill city, Tennessee",1812,1714,98,47,54780,5.408388520971302
"Paris city, Tennessee",5042,4147,895,47,56720,17.75089250297501
"Waverly city, Tennessee",2155,1679,476,47,78560,22.08816705336427
"Ripley city, Tennessee",3841,3293,548,47,63340,14.26711793803697
"Mount Juliet city, Tennessee",12298,11761,537,47,50780,4.366563668889251
"Rural Hill CDP, Tennessee",732,690,42,47,65642,5.737704918032787
"Harrison CDP, Tennessee",3175,2943,232,47,32600,7.307086614173228
"Middle Valley CDP, Tennessee",4564,4415,149,47,48360,3.264680105170903
"Milledgeville town, Tennessee",182,149,33,47,48920,18.13186813186813
"Byrdstown town, Tennessee",484,403,81,47,10180,16.735537190082646
"Oakland town, Tennessee",3068,3026,42,47,54920,1.3689700130378095
"Rossville town, Tennessee",406,358,48,47,65240,11.822660098522167
"Clarksburg town, Tennessee",202,182,20,47,15140,9.900990099009901
"Dyersburg city, Tennessee",7716,6913,803,47,22200,10.406946604458268
"Baltic city, South Dakota",404,399,5,46,03380,1.2376237623762376
"Aurora Center CDP, South Dakota",21,21,0,46,02860,0.0
"Long Lake town, South Dakota",48,14,34,46,38860,70.83333333333334
"Marion city, South Dakota",378,344,34,46,40860,8.994708994708994
"Kennebec town, South Dakota",165,140,25,46,33580,15.151515151515152
"Plankinton city, South Dakota",349,307,42,46,50020,12.034383954154727
"Harrold town, South Dakota",58,46,12,46,27420,20.689655172413794
"Dolton town, South Dakota",26,23,3,46,16860,11.538461538461538
"Parker city, South Dakota",471,395,76,46,48380,16.13588110403397
"Storla CDP, South Dakota",19,19,0,46,61940,0.0
"Blunt city, South Dakota",171,157,14,46,06180,8.187134502923977
"North Sioux City city, South Dakota",1366,1288,78,46,45700,5.710102489019034
"Rosebud CDP, South Dakota",524,427,97,46,55940,18.51145038167939
"St. Francis town, South Dakota",181,163,18,46,57140,9.94475138121547
"Spring Creek CDP, South Dakota",53,53,0,46,60500,0.0
"Akaska town, South Dakota",136,28,108,46,00540,79.41176470588235
"Selby city, South Dakota",283,224,59,46,58140,20.848056537102476
"Bryant city, South Dakota",263,213,50,46,08060,19.011406844106464
"Hayti town, South Dakota",235,185,50,46,27820,21.27659574468085
"Lake Preston city, South Dakota",325,272,53,46,35500,16.307692307692307
"Agar town, South Dakota",50,42,8,46,00460,16.0
"Ashton city, South Dakota",57,50,7,46,02540,12.280701754385964
"Frankfort city, South Dakota",62,45,17,46,22580,27.419354838709676
"Garretson city, South Dakota",518,474,44,46,23820,8.494208494208493
"Murdo city, South Dakota",311,228,83,46,44260,26.688102893890676
"Rapid Valley CDP, South Dakota",3396,3354,42,46,53007,1.2367491166077738
"De Smet city, South Dakota",561,503,58,46,16260,10.338680926916222
"Erwin town, South Dakota",32,19,13,46,19860,40.625
"Wentworth village, South Dakota",91,83,8,46,70020,8.791208791208792
"Mellette city, South Dakota",95,78,17,46,41860,17.894736842105264
"Redfield city, South Dakota",1264,1198,66,46,53460,5.2215189873417724
"Humboldt town, South Dakota",289,287,2,46,30900,0.6920415224913495
"Vilas town, South Dakota",4,4,0,46,67340,0.0
"Hecla city, South Dakota",145,103,42,46,27980,28.965517241379313
"Roscoe city, South Dakota",182,151,31,46,55820,17.032967032967033
"Hurley city, South Dakota",171,153,18,46,30980,10.526315789473683
"Loomis CDP, South Dakota",0,0,0,46,39020,
"Wessington city, South Dakota",148,138,10,46,70140,6.756756756756757
"Mission Hill town, South Dakota",84,80,4,46,42980,4.761904761904762
"Lily town, South Dakota",6,2,4,46,37140,66.66666666666666
"Revillo town, South Dakota",47,43,4,46,54220,8.51063829787234
"Fort Pierre city, South Dakota",1093,1019,74,46,22260,6.77035681610247
"Edgemont city, South Dakota",442,331,111,46,18300,25.1131221719457
"Corsica city, South Dakota",331,275,56,46,13980,16.91842900302115
"Interior town, South Dakota",54,32,22,46,31620,40.74074074074074
"Bison town, South Dakota",174,136,38,46,05620,21.839080459770116
"Chelsea town, South Dakota",22,14,8,46,11500,36.36363636363637
"Seneca town, South Dakota",34,15,19,46,58180,55.88235294117647
"Bridgewater city, South Dakota",233,167,66,46,07180,28.32618025751073
"Montrose city, South Dakota",250,226,24,46,43500,9.6
"White River city, South Dakota",245,197,48,46,71340,19.591836734693878
"Elk Point city, South Dakota",930,861,69,46,18620,7.419354838709677
"New Holland CDP, South Dakota",10,10,0,46,44940,0.0
"Mound City town, South Dakota",37,31,6,46,44020,16.216216216216218
"Volin town, South Dakota",71,62,9,46,67780,12.676056338028168
"Hot Springs city, South Dakota",2099,1772,327,46,30220,15.57884707003335
"Colonial Pine Hills CDP, South Dakota",842,824,18,46,13355,2.137767220902613
"Dickson city, Tennessee",6275,5798,477,47,20620,7.601593625498008
"Green Valley CDP, South Dakota",431,388,43,46,26035,9.976798143851507
"Hill City city, South Dakota",459,311,148,46,29100,32.24400871459695
"Wall town, South Dakota",400,289,111,46,68380,27.750000000000004
"Sewanee CDP, Tennessee",634,434,200,47,67140,31.545741324921135
"Beersheba Springs town, Tennessee",322,190,132,47,04240,40.993788819875775
"Humboldt city, Tennessee",4240,3398,842,47,36460,19.858490566037737
"Gordonsville town, Tennessee",651,635,16,47,30120,2.457757296466974
"Tennessee Ridge town, Tennessee",617,526,91,47,73460,14.748784440842789
"Fall Branch CDP, Tennessee",765,642,123,47,25540,16.07843137254902
"Watauga city, Tennessee",177,132,45,47,78240,25.423728813559322
"Saulsbury town, Tennessee",59,42,17,47,66680,28.8135593220339
"St. Joseph city, Tennessee",393,361,32,47,66160,8.142493638676845
"Medon city, Tennessee",116,106,10,47,47020,8.620689655172415
"Mitchellville city, Tennessee",64,63,1,47,49460,1.5625
"Watertown city, Tennessee",705,638,67,47,78320,9.50354609929078
"Big Sandy town, Tennessee",300,249,51,47,05860,17.0
"Lookout Mountain town, Tennessee",818,749,69,47,43640,8.43520782396088
"Ooltewah CDP, Tennessee",491,337,154,47,55900,31.364562118126273
"Signal Mountain town, Tennessee",3233,3075,158,47,68540,4.887101763068358
"Sardis town, Tennessee",217,150,67,47,66660,30.87557603686636
"Bethel Springs town, Tennessee",317,238,79,47,05380,24.9211356466877
"Tellico Plains town, Tennessee",468,383,85,47,73260,18.162393162393162
"Ramer city, Tennessee",194,163,31,47,61520,15.979381443298967
"Petersburg town, Tennessee",264,233,31,47,57740,11.742424242424242
"Cedar Hill city, Tennessee",105,94,11,47,11980,10.476190476190476
"Soddy-Daisy city, Tennessee",6238,5668,570,47,69560,9.137544084642514
"Allardt city, Tennessee",331,272,59,47,00660,17.82477341389728
"Lynnville town, Tennessee",152,129,23,47,44420,15.131578947368421
"East Ridge city, Tennessee",9800,8716,1084,47,22720,11.061224489795919
"Lexington city, Tennessee",3497,2925,572,47,41980,16.356877323420075
"Calhoun town, Tennessee",212,206,6,47,10440,2.8301886792452833
"Englewood town, Tennessee",739,645,94,47,24040,12.719891745602165
"Michie town, Tennessee",395,340,55,47,48180,13.924050632911392
"Oakdale town, Tennessee",105,76,29,47,54280,27.61904761904762
"Seymour CDP, Tennessee",4792,4431,361,47,67200,7.533388981636061
"Spencer town, Tennessee",737,609,128,47,70240,17.367706919945725
"Gray CDP, Tennessee",757,657,100,47,30700,13.210039630118892
"Greenfield city, Tennessee",1150,1013,137,47,31000,11.91304347826087
"Stanton town, Tennessee",206,173,33,47,70820,16.019417475728158
"Bean Station city, Tennessee",1300,1208,92,47,03760,7.076923076923077
"Erwin town, Tennessee",2877,2517,360,47,24360,12.51303441084463
"Harrogate city, Tennessee",1847,1606,241,47,32640,13.048186247969682
"Madisonville city, Tennessee",2292,1990,302,47,45320,13.176265270506107
"Orlinda city, Tennessee",369,352,17,47,56020,4.607046070460704
"Hartsville/Trousdale County, Tennessee",3533,3054,479,47,32742,13.557882819133882
"Fairmount CDP, Tennessee",954,850,104,47,25080,10.90146750524109
"Munford city, Tennessee",2376,2128,248,47,51540,10.437710437710438
"Lake City city, Tennessee",897,778,119,47,40240,13.26644370122631
"Helenwood CDP, Tennessee",454,402,52,47,33120,11.45374449339207
"Midtown CDP, Tennessee",716,535,181,47,48460,25.27932960893855
"Lynchburg, Moore County metropolitan government; Tennessee",3021,2602,419,47,44382,13.869579609400862
"Nashville-Davidson metropolitan government (balance), Tennessee",295259,268061,27198,47,52006,9.21157356761352
"Christiana CDP, Tennessee",1222,1099,123,47,14860,10.065466448445171
"Rockvale CDP, Tennessee",410,410,0,47,64400,0.0
"Iron City CDP, Tennessee",153,110,43,47,37360,28.104575163398692
"Bethpage CDP, Tennessee",104,97,7,47,05500,6.730769230769231
"Algood city, Tennessee",1633,1633,0,47,00640,0.0
"Andersonville CDP, Tennessee",219,219,0,47,01220,0.0
"Apison CDP, Tennessee",1176,1021,155,47,01480,13.180272108843539
"Bon Aqua Junction CDP, Tennessee",472,385,87,47,07280,18.43220338983051
"Bowman CDP, Tennessee",99,54,45,47,07620,45.45454545454545
"Bransford CDP, Tennessee",72,72,0,47,08080,0.0
"Wasta town, South Dakota",48,48,0,46,69140,0.0
"Sisseton city, South Dakota",1143,1012,131,46,59260,11.461067366579178
"White Rock town, South Dakota",6,2,4,46,71380,66.66666666666666
"Estelline city, South Dakota",369,355,14,46,19980,3.7940379403794036
"Crooks city, South Dakota",464,450,14,46,14740,3.0172413793103448
"Delmont city, South Dakota",126,111,15,46,16060,11.904761904761903
"Kadoka city, South Dakota",394,282,112,46,33180,28.426395939086298
"Wanblee CDP, South Dakota",162,130,32,46,68580,19.753086419753085
"Canistota city, South Dakota",364,307,57,46,09300,15.659340659340659
"Hitchcock town, South Dakota",55,55,0,46,29500,0.0
"White city, South Dakota",220,215,5,46,70940,2.272727272727273
"Mitchell city, South Dakota",7593,7038,555,46,43100,7.3093638877913865
"Dimock town, South Dakota",61,57,4,46,16620,6.557377049180328
"Harrison CDP, South Dakota",45,37,8,46,27300,17.77777777777778
"Bowdle city, South Dakota",231,169,62,46,06540,26.83982683982684
"Eden town, South Dakota",80,63,17,46,18180,21.25
"Ree Heights town, South Dakota",40,32,8,46,53940,20.0
"Willow Lake city, South Dakota",174,135,39,46,71940,22.413793103448278
"Lennox city, South Dakota",980,936,44,46,36380,4.489795918367347
"Broadland town, South Dakota",16,13,3,46,07420,18.75
"Wakonda town, South Dakota",150,110,40,46,68100,26.666666666666668
"Doland city, South Dakota",158,98,60,46,16820,37.9746835443038
"Sinai town, South Dakota",54,43,11,46,58900,20.37037037037037
"Hoven town, South Dakota",188,150,38,46,30300,20.212765957446805
"Quinn town, South Dakota",29,16,13,46,52500,44.827586206896555
"Vivian CDP, South Dakota",63,63,0,46,67620,0.0
"Lemmon city, South Dakota",759,592,167,46,36340,22.002635046113305
"Frederick town, South Dakota",117,83,34,46,22860,29.059829059829063
"Herreid city, South Dakota",229,189,40,46,28340,17.46724890829694
"Springfield city, South Dakota",427,346,81,46,60660,18.969555035128806
"Rosholt town, South Dakota",244,208,36,46,56340,14.754098360655737
"Sioux Falls city, South Dakota",74818,70259,4559,46,59020,6.093453447031464
"Cavour town, South Dakota",64,59,5,46,10620,7.8125
"Marty CDP, South Dakota",104,94,10,46,41180,9.615384615384617
"Buffalo town, South Dakota",221,160,61,46,08140,27.601809954751133
"La Plant CDP, South Dakota",52,47,5,46,35940,9.615384615384617
"Kranzburg town, South Dakota",79,73,6,46,34340,7.59493670886076
"Manderson-White Horse Creek CDP, South Dakota",100,63,37,46,40550,37.0
"Pringle town, South Dakota",97,67,30,46,51940,30.927835051546392
"Fairview town, South Dakota",18,16,2,46,20780,11.11111111111111
"Woonsocket city, South Dakota",330,295,35,46,72700,10.606060606060606
"Platte city, South Dakota",682,634,48,46,50260,7.038123167155426
"Rockham town, South Dakota",22,11,11,46,55540,50.0
"Watertown city, South Dakota",10346,9545,801,46,69300,7.7421225594432626
"Piedmont city, South Dakota",418,396,22,46,49500,5.263157894736842
"Worthing city, South Dakota",351,344,7,46,72820,1.9943019943019942
"Summerset city, South Dakota",881,836,45,46,62155,5.10783200908059
"Dakota Dunes CDP, South Dakota",1359,1281,78,46,15256,5.739514348785872
"Buffalo Chip town, South Dakota",0,0,0,46,08330,
"Anderson CDP, South Dakota",144,144,0,46,01450,0.0
"Brant Lake city, South Dakota",35,32,3,46,07040,8.571428571428571
"Brant Lake South CDP, South Dakota",198,96,102,46,07044,51.515151515151516
"Agency Village CDP, South Dakota",51,46,5,46,00520,9.803921568627452
"Bath CDP, South Dakota",81,81,0,46,03900,0.0
"Bath Corner CDP, South Dakota",23,23,0,46,03960,0.0
"Bijou Hills CDP, South Dakota",0,0,0,46,05580,
"Blucksberg Mountain CDP, South Dakota",222,222,0,46,06120,0.0
"Chester CDP, South Dakota",127,127,0,46,11660,0.0
"Corn Creek CDP, South Dakota",34,31,3,46,13840,8.823529411764707
"Cow Creek CDP, South Dakota",80,20,60,46,14320,75.0
"Castalian Springs CDP, Tennessee",216,207,9,47,11440,4.166666666666666
"Chesterfield CDP, Tennessee",216,193,23,47,14220,10.648148148148149
"Clarkrange CDP, Tennessee",308,282,26,47,15120,8.441558441558442
"Coalfield CDP, Tennessee",963,909,54,47,15880,5.607476635514018
"Cottontown CDP, Tennessee",146,125,21,47,17420,14.383561643835616
"Darden CDP, Tennessee",126,110,16,47,19500,12.698412698412698
"Dodson Branch CDP, Tennessee",469,452,17,47,20930,3.624733475479744
"Elgin CDP, Tennessee",171,146,25,47,23440,14.619883040935672
"Eva CDP, Tennessee",120,58,62,47,24640,51.66666666666667
"Fairfield CDP, Tennessee",66,66,0,47,24960,0.0
"Fairgarden CDP, Tennessee",162,162,0,47,24990,0.0
"Falling Water CDP, Tennessee",545,505,40,47,25560,7.339449541284404
"Fincastle CDP, Tennessee",685,583,102,47,26120,14.890510948905108
"Flat Top Mountain CDP, Tennessee",187,162,25,47,26490,13.368983957219251
"Flintville CDP, Tennessee",302,244,58,47,26580,19.205298013245034
"Graball CDP, Tennessee",86,73,13,47,30220,15.11627906976744
"Grimsley CDP, Tennessee",434,401,33,47,31420,7.603686635944701
"Hillsboro CDP, Tennessee",171,139,32,47,34700,18.71345029239766
"Lakewood Park CDP, Tennessee",571,384,187,47,40732,32.749562171628725
"Lone Oak CDP, Tennessee",447,418,29,47,43420,6.487695749440715
"Lyles CDP, Tennessee",475,367,108,47,44360,22.736842105263158
"Mooresburg CDP, Tennessee",415,385,30,47,49940,7.228915662650602
"Mowbray Mountain CDP, Tennessee",791,697,94,47,51402,11.883691529709228
"New Deal CDP, Tennessee",164,144,20,47,52520,12.195121951219512
"New Union CDP, Tennessee",550,489,61,47,53240,11.090909090909092
"Oak Grove CDP (Sumner County), Tennessee",60,60,0,47,54640,0.0
"Oak Grove CDP (Washington County), Tennessee",2183,1889,294,47,54700,13.46770499312872
"Olivet CDP, Tennessee",696,621,75,47,55820,10.775862068965516
"Park City CDP, Tennessee",1065,1008,57,47,56800,5.352112676056338
"Parker's Crossroads city, Tennessee",149,124,25,47,56870,16.778523489932887
"Pelham CDP, Tennessee",146,119,27,47,57500,18.493150684931507
"Petros CDP, Tennessee",380,303,77,47,57780,20.263157894736842
"Riceville CDP, Tennessee",521,421,100,47,62580,19.193857965451055
"Robbins CDP, Tennessee",86,86,0,47,63920,0.0
"Sale Creek CDP, Tennessee",1227,1017,210,47,66220,17.114914425427873
"Shackle Island CDP, Tennessee",1079,1052,27,47,67230,2.5023169601482853
"Summertown CDP, Tennessee",290,235,55,47,72040,18.96551724137931
"Telford CDP, Tennessee",435,413,22,47,73220,5.057471264367816
"Tellico Village CDP, Tennessee",3240,3026,214,47,73270,6.604938271604937
"Unionville CDP, Tennessee",745,687,58,47,76180,7.785234899328859
"Walland CDP, Tennessee",161,127,34,47,77700,21.11801242236025
"Walnut Grove CDP (Hardin County), Tennessee",120,87,33,47,77760,27.500000000000004
"Walnut Grove CDP (Sumner County), Tennessee",348,339,9,47,77820,2.586206896551724
"Wildwood CDP, Tennessee",393,375,18,47,80740,4.580152671755725
"Wrigley CDP, Tennessee",144,106,38,47,82120,26.38888888888889
"Moran city, Texas",176,105,71,48,49320,40.340909090909086
"Ingleside city, Texas",3899,3517,382,48,36008,9.797383944601181
"Hackberry town, Texas",592,562,30,48,31715,5.0675675675675675
"Mount Pleasant city, Texas",5761,5171,590,48,49800,10.241277555979865
"Center city, Texas",1998,1807,191,48,13732,9.55955955955956
"Claude city, Texas",561,463,98,48,15196,17.46880570409982
"Arp city, Texas",357,306,51,48,04156,14.285714285714285
"Val Verde Park CDP, Texas",815,717,98,48,74895,12.024539877300613
"Creedmoor city, Texas",83,61,22,48,17612,26.506024096385545
"Pflugerville city, Texas",20947,20266,681,48,57176,3.2510622046116393
"K-Bar Ranch CDP, Texas",238,139,99,48,38518,41.596638655462186
"Benjamin city, Texas",117,81,36,48,07636,30.76923076923077
"De Leon city, Texas",1141,995,146,48,19672,12.795793163891322
"West University Place city, Texas",5769,5424,345,48,77956,5.980239209568382
"Humble city, Texas",6283,5835,448,48,35348,7.130351742798026
"Hunters Creek Village city, Texas",1657,1565,92,48,35480,5.552202776101388
"Crocker CDP, South Dakota",37,12,25,46,14660,67.56756756756756
"Fedora CDP, South Dakota",21,21,0,46,21340,0.0
"Ortley town, South Dakota",41,26,15,46,47660,36.58536585365854
"Peever town, South Dakota",65,59,6,46,48940,9.230769230769232
"Fruitdale town, South Dakota",32,31,1,46,23140,3.125
"Iroquois city, South Dakota",180,172,8,46,32020,4.444444444444445
"Conde city, South Dakota",106,80,26,46,13700,24.528301886792452
"Tulare town, South Dakota",108,93,15,46,64300,13.88888888888889
"Hartford city, South Dakota",1174,1106,68,46,27540,5.792163543441227
"Valley Springs city, South Dakota",368,312,56,46,66260,15.217391304347828
"Newell city, South Dakota",401,318,83,46,44860,20.698254364089774
"Menno city, South Dakota",386,346,40,46,41980,10.362694300518134
"Parkston city, South Dakota",762,673,89,46,48460,11.67979002624672
"Lesterville town, South Dakota",71,61,10,46,36540,14.084507042253522
"Little Eagle CDP, South Dakota",65,59,6,46,37900,9.230769230769232
"Stockholm town, South Dakota",63,54,9,46,61740,14.285714285714285
"Fairburn town, South Dakota",52,48,4,46,20340,7.6923076923076925
"Timber Lake city, South Dakota",234,195,39,46,63620,16.666666666666664
"Milbank city, South Dakota",1591,1461,130,46,42260,8.170961659333752
"Dallas town, South Dakota",75,34,41,46,15300,54.666666666666664
"Nisland town, South Dakota",147,129,18,46,45180,12.244897959183673
"Oelrichs town, South Dakota",67,60,7,46,46500,10.44776119402985
"Armour city, South Dakota",412,351,61,46,02260,14.805825242718445
"Porcupine CDP, South Dakota",294,268,26,46,51340,8.843537414965986
"New Witten town, South Dakota",50,29,21,46,45100,42.0
"Alpena town, South Dakota",176,147,29,46,01020,16.477272727272727
"Flandreau city, South Dakota",1146,1025,121,46,21540,10.55846422338569
"Ward town, South Dakota",33,33,0,46,68660,0.0
"Midland town, South Dakota",87,62,25,46,42140,28.735632183908045
"Camp Crook town, South Dakota",41,35,6,46,09260,14.634146341463413
"Britton city, South Dakota",751,646,105,46,07380,13.981358189081226
"Lake City town, South Dakota",32,24,8,46,35220,25.0
"Veblen city, South Dakota",217,175,42,46,66540,19.35483870967742
"Custer city, South Dakota",1249,1012,237,46,15140,18.975180144115292
"Webster city, South Dakota",1088,891,197,46,69780,18.106617647058822
"Whitehorse CDP, South Dakota",38,38,0,46,71140,0.0
"La Bolt town, South Dakota",54,51,3,46,34540,5.555555555555555
"Twin Brooks town, South Dakota",26,20,6,46,64700,23.076923076923077
"Burke city, South Dakota",391,298,93,46,08700,23.785166240409207
"Herrick town, South Dakota",45,38,7,46,28420,15.555555555555555
"Finger city, Tennessee",158,125,33,47,26160,20.88607594936709
"Naples town, South Dakota",5,5,0,46,44620,0.0
"Scotts Hill town, Tennessee",468,362,106,47,66880,22.64957264957265
"Gainesboro town, Tennessee",444,353,91,47,28420,20.495495495495494
"Sunbright city, Tennessee",257,189,68,47,72140,26.459143968871597
"Wartburg city, Tennessee",447,370,77,47,78100,17.225950782997764
"Graysville town, Tennessee",790,667,123,47,30760,15.569620253164556
"Eagleville city, Tennessee",322,309,13,47,22360,4.037267080745342
"Norris city, Tennessee",676,589,87,47,53600,12.8698224852071
"Bell Buckle town, Tennessee",166,150,16,47,04460,9.63855421686747
"La Follette city, Tennessee",3446,2812,634,47,40180,18.39814277423099
"McKenzie city, Tennessee",2517,2196,321,47,44940,12.753277711561385
"Jonesborough town, Tennessee",2327,2135,192,47,38540,8.250966910184786
"Cookeville city, Tennessee",15006,13725,1281,47,16920,8.536585365853659
"Luttrell town, Tennessee",451,355,96,47,44300,21.286031042128602
"Sevierville city, Tennessee",7668,5930,1738,47,67120,22.665623369848724
"Wildwood Lake CDP, Tennessee",1452,1279,173,47,80760,11.914600550964186
"Farragut town, Tennessee",8552,8198,354,47,25760,4.139382600561272
"Ridgely town, Tennessee",867,788,79,47,63060,9.111880046136102
"Tiptonville town, Tennessee",1000,829,171,47,74540,17.1
"Post city, Texas",1401,1265,136,48,59012,9.707351891506068
"Fairfield city, Texas",1236,1007,229,48,25104,18.527508090614887
"Fredericksburg city, Texas",5437,4527,910,48,27348,16.737171234136472
"Willis city, Texas",1935,1845,90,48,79408,4.651162790697675
"Union Grove city, Texas",158,144,14,48,74312,8.860759493670885
"Madisonville city, Texas",1971,1734,237,48,45996,12.02435312024353
"Agua Dulce CDP, Texas",823,726,97,48,01390,11.7861482381531
"Rangerville village, Texas",20,20,0,48,60644,0.0
"North Cleveland city, Texas",114,87,27,48,51984,23.684210526315788
"Prosper town, Texas",6093,5584,509,48,59696,8.353848678811751
"St. Paul town, Texas",388,315,73,48,64220,18.814432989690722
"Ore City city, Texas",503,415,88,48,54216,17.495029821073558
"Havana CDP, Texas",118,118,0,48,32792,0.0
"La Joya city, Texas",1337,1209,128,48,40384,9.573672400897532
"La Villa city, Texas",780,676,104,48,41788,13.333333333333334
"Mercedes city, Texas",5823,4820,1003,48,47700,17.22479821397905
"Willow Park city, Texas",1905,1835,70,48,79492,3.674540682414698
"Weimar city, Texas",1123,843,280,48,77020,24.93321460373998
"Ross city, Texas",131,106,25,48,63380,19.083969465648856
"Karnes City city, Texas",962,750,212,48,38452,22.03742203742204
"Kyle city, Texas",13503,12930,573,48,39952,4.243501444123528
"Hamilton city, Texas",1541,1199,342,48,31952,22.19338092147956
"Lindale city, Texas",2379,2177,202,48,42820,8.490962589323244
"Linn CDP, Texas",310,214,96,48,42916,30.967741935483872
"Loma Grande CDP, Texas",41,33,8,48,43458,19.51219512195122
"Loma Linda CDP, Texas",75,75,0,48,43460,0.0
"Loma Linda East CDP (Jim Wells County), Texas",110,92,18,48,43462,16.363636363636363
"Loma Linda East CDP (Starr County), Texas",0,0,0,48,43463,
"Loma Linda West CDP, Texas",33,33,0,48,43465,0.0
"Loma Vista CDP, Texas",41,41,0,48,43474,0.0
"Longoria CDP, Texas",21,21,0,48,43822,0.0
"Loop CDP, Texas",135,105,30,48,43948,22.22222222222222
"Los Altos CDP, Texas",11,11,0,48,44038,0.0
"Los Angeles CDP, Texas",13,0,13,48,44062,100.0
"Los Arcos CDP, Texas",49,26,23,48,44072,46.93877551020408
"Los Arrieros CDP, Texas",0,0,0,48,44075,
"Los Barreras CDP, Texas",102,49,53,48,44076,51.9607843137255
"Nesbitt town, Texas",70,70,0,48,50724,0.0
"Los Centenarios CDP, Texas",8,0,8,48,44078,100.0
"Cisco city, Texas",1821,1523,298,48,15004,16.364634816035146
"Carbon town, Texas",178,117,61,48,12736,34.26966292134831
"Gruver city, Texas",494,412,82,48,31412,16.599190283400812
"Santa Maria CDP, Texas",259,219,40,48,65744,15.444015444015443
"Palm Valley city, Texas",885,762,123,48,54798,13.898305084745763
"Port Isabel city, Texas",2492,1843,649,48,58892,26.04333868378812
"Reid Hope King CDP, Texas",295,267,28,48,61466,9.491525423728813
"Villa del Sol CDP, Texas",53,33,20,48,75554,37.735849056603776
"Nolanville city, Texas",2142,1892,250,48,51708,11.671335200746965
"Pine Island town, Texas",422,348,74,48,57615,17.535545023696685
"Killeen city, Texas",60032,51887,8145,48,39148,13.567763859275054
"Little River-Academy city, Texas",728,631,97,48,43066,13.324175824175825
"Troy city, Texas",826,732,94,48,73748,11.380145278450362
"Quail CDP, Texas",8,5,3,48,60020,37.5
"Samnorwood CDP, Texas",11,7,4,48,64448,36.36363636363637
"Roscoe city, Texas",617,487,130,48,63176,21.06969205834684
"Brazos Country city, Texas",225,214,11,48,10090,4.888888888888889
"Cashion Community city, Texas",143,128,15,48,13198,10.48951048951049
"Hideaway city, Texas",1915,1537,378,48,33578,19.738903394255875
"Jarrell city, Texas",447,398,49,48,37396,10.961968680089486
"Kurten town, Texas",174,143,31,48,39940,17.81609195402299
"Petronilla city, Texas",80,56,24,48,57056,30.0
"Salado village, Texas",1113,1029,84,48,64268,7.547169811320755
"San Ygnacio CDP, Texas",273,180,93,48,65792,34.065934065934066
"Knoxville city, Tennessee",89942,79579,10363,47,40000,11.521869649329568
"Athens city, Tennessee",6225,5564,661,47,02320,10.61847389558233
"Chapel Hill town, Tennessee",649,639,10,47,12880,1.5408320493066257
"Decatur town, Tennessee",691,591,100,47,19880,14.47178002894356
"Sweetwater city, Tennessee",2488,2133,355,47,72540,14.268488745980706
"Lobelville city, Tennessee",536,462,74,47,43160,13.805970149253731
"Ducktown city, Tennessee",238,165,73,47,21740,30.672268907563026
"Dayton city, Tennessee",2701,2407,294,47,19700,10.884857460199926
"Townsend city, Tennessee",325,197,128,47,74860,39.38461538461539
"Bulls Gap town, Tennessee",392,313,79,47,09560,20.153061224489797
"Alcoa city, Tennessee",4263,3895,368,47,00540,8.632418484635233
"Rockford city, Tennessee",362,322,40,47,64160,11.049723756906078
"Newport city, Tennessee",3310,2672,638,47,53000,19.274924471299094
"Parsons city, Tennessee",1134,856,278,47,57080,24.514991181657848
"Samburg town, Tennessee",161,114,47,47,66360,29.19254658385093
"South Fulton city, Tennessee",1177,982,195,47,69900,16.567544604927782
"Hunter CDP, Tennessee",1031,890,141,47,36500,13.676042677012608
"Jasper town, Tennessee",1652,1438,214,47,37820,12.953995157384988
"Monteagle town, Tennessee",878,636,242,47,49740,27.5626423690205
"Oneida town, Tennessee",1927,1694,233,47,55860,12.091333679294241
"Garland town, Tennessee",148,126,22,47,28680,14.864864864864865
"Kingsport city, Tennessee",26279,23520,2759,47,39560,10.498877430648045
"Morrison town, Tennessee",272,224,48,47,50220,17.647058823529413
"Franklin city, Tennessee",29786,28409,1377,47,27740,4.622977237628416
"Savannah city, Tennessee",3123,2662,461,47,66720,14.761447326288824
"Morristown city, Tennessee",12759,11513,1246,47,50280,9.765655615643858
"Ethridge town, Tennessee",266,231,35,47,24460,13.157894736842104
"Bruceton town, Tennessee",591,492,99,47,08960,16.751269035532996
"Crossville city, Tennessee",5307,4649,658,47,18540,12.39871867345016
"Alexandria town, Tennessee",456,427,29,47,00620,6.359649122807018
"Centerville town, Tennessee",1626,1420,206,47,12420,12.669126691266912
"Eagleton Village CDP, Tennessee",2329,2128,201,47,22340,8.630313439244311
"Clinton city, Tennessee",4918,4441,477,47,15580,9.69906466043107
"Shelbyville city, Tennessee",8421,7387,1034,47,67760,12.27882674266714
"Wartrace town, Tennessee",306,277,29,47,78120,9.477124183006536
"Belle Meade city, Tennessee",1023,941,82,47,04620,8.01564027370479
"Trimble town, Tennessee",273,206,67,47,75160,24.54212454212454
"Oliver Springs town, Tennessee",1679,1613,66,47,55800,3.9309112567004165
"Waynesboro city, Tennessee",1196,915,281,47,78600,23.494983277591974
"Ardmore city, Tennessee",545,491,54,47,01640,9.908256880733946
"Philadelphia city, Tennessee",337,286,51,47,57900,15.133531157270031
"South Pittsburg city, Tennessee",1555,1320,235,47,70060,15.112540192926044
"Huntsville town, Tennessee",594,520,74,47,36640,12.457912457912458
"Jacksboro town, Tennessee",1194,1015,179,47,37600,14.991624790619765
"Loudon town, Tennessee",2465,2158,307,47,43780,12.454361054766734
"Mason town, Tennessee",352,295,57,47,46420,16.193181818181817
"Atoka town, Tennessee",3134,2948,186,47,02340,5.93490746649649
"Burlison town, Tennessee",149,149,0,47,09860,0.0
"Collinwood city, Tennessee",500,416,84,47,16480,16.8
"Smithville city, Tennessee",1825,1672,153,47,69320,8.383561643835616
"Friendsville city, Tennessee",386,323,63,47,28060,16.321243523316063
"Decaturville town, Tennessee",388,330,58,47,19900,14.948453608247423
"Maryville city, Tennessee",11815,10565,1250,47,46380,10.579771476936099
"Henderson city, Tennessee",2269,1941,328,47,33260,14.455707360070516
"Cottage Grove town, Tennessee",40,32,8,47,17340,20.0
"Forest Hills city, Tennessee",1909,1823,86,47,27020,4.504976427448926
"Kenton town, Tennessee",725,591,134,47,39140,18.482758620689655
"Obion town, Tennessee",573,501,72,47,55240,12.56544502617801
"Rives town, Tennessee",129,103,26,47,63800,20.155038759689923
"Kingston city, Tennessee",2640,2232,408,47,39620,15.454545454545453
"La Vergne city, Tennessee",11694,11121,573,47,41200,4.8999486916367365
"Wimberley city, Texas",1607,1296,311,48,79624,19.352831362787803
"Moody city, Texas",682,569,113,48,49200,16.568914956011728
"Kenedy city, Texas",1547,1151,396,48,38860,25.59793148028442
"Woodcreek city, Texas",843,759,84,48,80058,9.9644128113879
"Crockett city, Texas",3042,2620,422,48,17744,13.872452333990795
"Mount Vernon town, Texas",1262,999,263,48,49860,20.839936608557842
"Abilene city, Texas",49028,42327,6701,48,01000,13.667700089744637
"Lueders city, Texas",156,106,50,48,45048,32.05128205128205
"Driscoll city, Texas",261,173,88,48,21436,33.71647509578544
"Hungerford CDP, Texas",30,30,0,48,35420,0.0
"Rocksprings town, Texas",567,419,148,48,62816,26.102292768959433
"San Diego city, Texas",1944,1369,575,48,65180,29.578189300411523
"Beckville city, Texas",391,311,80,48,07108,20.460358056265985
"Gary City town, Texas",122,96,26,48,29108,21.311475409836063
"Sabinal city, Texas",642,488,154,48,64004,23.98753894080997
"Beeville city, Texas",5433,4593,840,48,07192,15.461071231363889
"Normanna CDP, Texas",80,47,33,48,51852,41.25
"Pawnee CDP, Texas",79,57,22,48,56252,27.848101265822784
"Fulton town, Texas",912,574,338,48,27888,37.06140350877193
"Marshall city, Texas",9837,7882,1955,48,46776,19.873945308529024
"Uncertain city, Texas",130,35,95,48,74240,73.07692307692307
"Navasota city, Texas",2678,2273,405,48,50472,15.123226288274832
"Cottonwood city, Texas",75,71,4,48,17200,5.333333333333334
"Oak Grove town, Texas",243,238,5,48,52902,2.05761316872428
"Port Neches city, Texas",5364,5006,358,48,58940,6.674123788217748
"Onalaska city, Texas",1793,1152,641,48,54048,35.75013943112103
"Oak Ridge town (Cooke County), Texas",66,57,9,48,53154,13.636363636363635
"Hurst city, Texas",14994,13851,1143,48,35576,7.623049219687875
"Briar CDP, Texas",2267,1901,366,48,10192,16.144684605205118
"Hudson Oaks city, Texas",936,876,60,48,35254,6.41025641025641
"Forest Hill city, Texas",4133,3735,398,48,26544,9.629808855552866
"Kennedale city, Texas",2886,2706,180,48,38896,6.237006237006238
"Millsap town, Texas",117,102,15,48,48564,12.82051282051282
"Riverside city, Texas",335,210,125,48,62408,37.3134328358209
"El Cenizo city, Texas",936,785,151,48,22905,16.132478632478634
"Rio Bravo city, Texas",1369,1214,155,48,62138,11.322132943754564
"Hudson city, Texas",1963,1718,245,48,35228,12.480896586856852
"Clyde city, Texas",1566,1229,337,48,15676,21.519795657726693
"Flatonia town, Texas",534,462,72,48,26028,13.48314606741573
"Double Oak town, Texas",1032,1013,19,48,21028,1.8410852713178296
"Lakewood Village city, Texas",208,189,19,48,41050,9.134615384615383
"Broaddus town, Texas",115,74,41,48,10384,35.65217391304348
"Sonora city, Texas",1453,1233,220,48,68756,15.141087405368204
"Doolittle CDP, Texas",882,686,196,48,20926,22.22222222222222
"Snyder city, Texas",4851,4094,757,48,68624,15.605029890744177
"Crowley city, Texas",5048,4725,323,48,17960,6.398573692551506
"Joshua city, Texas",2880,2577,303,48,38080,10.520833333333334
"Robert Lee city, Texas",690,518,172,48,62564,24.92753623188406
"Bay City city, Texas",7707,6122,1585,48,05984,20.56571947580122
"Mildred town, Texas",165,134,31,48,48372,18.787878787878785
"Clarksville city, Texas",1686,1282,404,48,15160,23.962040332147094
"Detroit town, Texas",401,320,81,48,20128,20.199501246882793
"Heath city, Texas",2906,2839,67,48,32984,2.3055746730901583
"Albany city, Texas",912,717,195,48,01648,21.38157894736842
"Barstow city, Texas",183,134,49,48,05720,26.775956284153008
"Nazareth city, Texas",132,109,23,48,50496,17.424242424242426
"Milford town, Texas",279,237,42,48,48408,15.053763440860216
"Balmorhea city, Texas",220,164,56,48,05468,25.454545454545453
"Texhoma city, Texas",216,152,64,48,72464,29.629629629629626
"Trinity city, Texas",1500,1165,335,48,73664,22.333333333333332
"Burkburnett city, Texas",5431,4618,813,48,11368,14.969618854722889
"Portland city, Texas",6607,5845,762,48,58904,11.533222339942485
"Lincoln Park town, Texas",41,40,1,48,42808,2.4390243902439024
"Gladewater city, Texas",2659,2113,546,48,29660,20.534035351635954
"Gates town, Tennessee",302,265,37,47,28740,12.251655629139073
"Collierville town, Tennessee",17458,17116,342,47,16420,1.9589872837667544
"Lakeland city, Tennessee",4471,4330,141,47,40350,3.153656900022366
"Blountville CDP, Tennessee",1106,1005,101,47,06740,9.132007233273058
"Henning town, Tennessee",546,466,80,47,33360,14.652014652014653
"Unicoi town, Tennessee",1658,1371,287,47,75820,17.310012062726177
"Burns town, Tennessee",694,598,96,47,09880,13.8328530259366
"Viola town, Tennessee",65,43,22,47,77400,33.84615384615385
"Hollow Rock town, Tennessee",386,305,81,47,35280,20.984455958549223
"Newbern town, Tennessee",1430,1246,184,47,52400,12.867132867132867
"Vanleer town, Tennessee",163,127,36,47,76860,22.085889570552148
"Decherd city, Tennessee",1294,1178,116,47,19920,8.964451313755797
"Trenton city, Tennessee",1988,1645,343,47,75000,17.253521126760564
"Altamont town, Tennessee",487,376,111,47,00940,22.79260780287474
"Tracy City town, Tennessee",757,617,140,47,74880,18.494055482166445
"Sneedville town, Tennessee",592,494,98,47,69460,16.554054054054053
"Hickory Valley town, Tennessee",82,48,34,47,33920,41.46341463414634
"Whiteville town, Tennessee",463,365,98,47,80540,21.166306695464364
"Columbia city, Tennessee",16473,14638,1835,47,16540,11.139440296242336
"Goodlettsville city, Tennessee",7326,6868,458,47,29920,6.251706251706252
"White House city, Tennessee",4356,4212,144,47,80200,3.3057851239669422
"Collegedale city, Tennessee",4490,3975,515,47,16300,11.469933184855234
"Minor Hill city, Tennessee",215,189,26,47,49360,12.093023255813954
"Pulaski city, Tennessee",3681,3083,598,47,61040,16.245585438739475
"Cornersville town, Tennessee",563,494,69,47,17180,12.25577264653641
"South Carthage town, Tennessee",590,541,49,47,69680,8.305084745762711
"Bolivar city, Tennessee",2335,2099,236,47,07180,10.107066381156317
"Parrottsville town, Tennessee",130,115,15,47,57040,11.538461538461538
"New Johnsonville city, Tennessee",874,766,108,47,52820,12.356979405034325
"Blaine city, Tennessee",849,782,67,47,06340,7.891637220259129
"Rutledge town, Tennessee",726,617,109,47,65820,15.013774104683195
"Gruetli-Laager city, Tennessee",863,773,90,47,31490,10.428736964078796
"Toone town, Tennessee",178,128,50,47,74640,28.08988764044944
"Portland city, Tennessee",4828,4343,485,47,60280,10.045567522783761
"Lakesite city, Tennessee",823,747,76,47,40540,9.234507897934387
"Walden town, Tennessee",754,694,60,47,77540,7.957559681697612
"Brownsville city, Tennessee",4641,4024,617,47,08920,13.294548588666236
"Centertown town, Tennessee",150,146,4,47,12380,2.666666666666667
"Fairview city, Tennessee",3049,2939,110,47,25440,3.607740242702526
"Spring Hill city, Tennessee",12814,12165,649,47,70580,5.0647729046355545
"La Grange town, Tennessee",65,47,18,47,40200,27.692307692307693
"Somerville town, Tennessee",1382,1199,183,47,69620,13.241678726483357
"Bells city, Tennessee",1123,911,212,47,04720,18.8780053428317
"Charlotte town, Tennessee",620,555,65,47,13080,10.483870967741936
"Huntland town, Tennessee",374,336,38,47,36600,10.16042780748663
"Palmer town, Tennessee",294,242,52,47,56560,17.687074829931973
"Yorkville city, Tennessee",134,104,30,47,82360,22.388059701492537
"Dandridge town, Tennessee",1321,1100,221,47,19380,16.729750189250566
"White Pine town, Tennessee",1006,916,90,47,80360,8.946322067594433
"Gallatin city, Tennessee",14887,13667,1220,47,28540,8.19506952374555
"Westmoreland town, Tennessee",1073,914,159,47,79420,14.818266542404473
"Lebanon city, Tennessee",12360,11414,946,47,41520,7.653721682847897
"East Cleveland CDP, Tennessee",781,571,210,47,22500,26.888604353393085
"Millington city, Tennessee",4980,4317,663,47,49060,13.313253012048193
"Brentwood city, Tennessee",14050,13553,497,47,08280,3.5373665480427046
"Braden town, Tennessee",117,103,14,47,07840,11.965811965811966
"Trezevant town, Tennessee",440,344,96,47,75100,21.818181818181817
"Alamo town, Tennessee",983,822,161,47,00440,16.378433367243133
"Winchester city, Tennessee",4274,3644,630,47,81080,14.740290126345343
"Rutherford town, Tennessee",543,443,100,47,65760,18.41620626151013
"Grand Junction city, Tennessee",154,134,20,47,30280,12.987012987012985
"Warren City city, Texas",161,131,30,48,76576,18.633540372670808
"La Paloma-Lost Creek CDP, Texas",129,116,13,48,41422,10.077519379844961
"Sandy Hollow-Escondidas CDP, Texas",150,101,49,48,65342,32.666666666666664
"Arroyo Colorado Estates CDP, Texas",242,149,93,48,04174,38.429752066115704
"Bixby CDP, Texas",117,117,0,48,08410,0.0
"Lasana CDP, Texas",38,38,0,48,41542,0.0
"Diboll city, Texas",1604,1385,219,48,20308,13.653366583541146
"Highland Village city, Texas",5446,5383,63,48,33848,1.1568123393316194
"Justin city, Texas",1261,1241,20,48,38332,1.5860428231562251
"Krum city, Texas",1703,1654,49,48,39928,2.877275396359366
"Lake Dallas city, Texas",2968,2843,125,48,40516,4.211590296495957
"Oak Point city, Texas",1467,1435,32,48,53130,2.1813224267212
"Ponder town, Texas",638,638,0,48,58664,0.0
"Lufkin city, Texas",14757,12910,1847,48,45072,12.516094057057666
"El Campo city, Texas",4525,4104,421,48,22864,9.303867403314916
"Blanket town, Texas",183,146,37,48,08596,20.21857923497268
"Brownwood city, Texas",8238,6826,1412,48,10780,17.14008254430687
"Spring CDP, Texas",21250,19847,1403,48,69596,6.60235294117647
"Lake Brownwood CDP, Texas",799,555,244,48,40456,30.538172715894866
"Coleman city, Texas",2534,1819,715,48,15916,28.216258879242307
"Eden city, Texas",566,383,183,48,22552,32.332155477031804
"Premont city, Texas",975,779,196,48,59384,20.102564102564102
"Sandia CDP, Texas",287,186,101,48,65168,35.19163763066202
"Wortham town, Texas",537,383,154,48,80296,28.677839851024206
"Lakeview town, Texas",61,31,30,48,40888,49.18032786885246
"Magnolia city, Texas",791,739,52,48,46056,6.573957016434892
"Montgomery city, Texas",379,334,45,48,49128,11.87335092348285
"Wells Branch CDP, Texas",6562,6053,509,48,77196,7.756781469064309
"Martindale city, Texas",487,432,55,48,46848,11.293634496919918
"La Feria North CDP, Texas",54,54,0,48,40210,0.0
"La Paloma CDP, Texas",829,806,23,48,41416,2.7744270205066344
"Laureles CDP, Texas",1217,1094,123,48,41728,10.106820049301561
"Hardin city, Texas",360,281,79,48,32240,21.944444444444443
"Pottsboro town, Texas",873,795,78,48,59132,8.934707903780069
"Fairview town, Texas",3719,3486,233,48,25224,6.265125033611185
"Frisco city, Texas",59273,55827,3446,48,27684,5.813776930474247
"Holland town, Texas",521,413,108,48,34508,20.72936660268714
"Brundage CDP, Texas",0,0,0,48,10852,
"Hart city, Texas",446,344,102,48,32576,22.869955156950674
"Bridge City city, Texas",3108,2785,323,48,10252,10.392535392535393
"Thorntonville town, Texas",276,212,64,48,72800,23.18840579710145
"Alma town, Texas",141,133,8,48,02044,5.673758865248227
"Waxahachie city, Texas",13011,12032,979,48,76816,7.524402428714165
"Pine Forest city, Texas",283,246,37,48,57524,13.074204946996467
"Marfa city, Texas",1071,627,444,48,46620,41.45658263305322
"Wichita Falls city, Texas",42847,36723,6124,48,79000,14.292715942773123
"Wink city, Texas",296,249,47,48,79768,15.878378378378377
"Carrizo Hill CDP, Texas",398,230,168,48,12982,42.211055276381906
"Ladonia town, Texas",345,272,73,48,40180,21.15942028985507
"Fifth Street CDP, Texas",663,635,28,48,25795,4.223227752639517
"Pecan Grove CDP, Texas",6384,6141,243,48,56482,3.806390977443609
"Pleak village, Texas",506,483,23,48,58088,4.545454545454546
"Beach City city, Texas",1005,892,113,48,06200,11.243781094527364
"Oak Ridge North city, Texas",1188,1141,47,48,53190,3.9562289562289563
"Pinehurst CDP, Texas",1853,1700,153,48,57596,8.256880733944955
"Stagecoach town, Texas",206,206,0,48,69932,0.0
"Lytle city, Texas",1020,913,107,48,45288,10.490196078431373
"Marietta town, Texas",72,50,22,48,46668,30.555555555555557
"Hillcrest village, Texas",357,340,17,48,33980,4.761904761904762
"San Juan city, Texas",10515,9644,871,48,65516,8.283404660009511
"Weslaco city, Texas",15633,12200,3433,48,77272,21.959956502270835
"Burnet city, Texas",2193,2000,193,48,11464,8.800729594163247
"Oglesby city, Texas",284,262,22,48,53520,7.746478873239436
"Middleton city, Tennessee",311,249,62,47,48340,19.935691318327976
"New Market town, Tennessee",621,557,64,47,52940,10.305958132045088
"Loretto city, Tennessee",782,733,49,47,43700,6.265984654731457
"Hendersonville city, Tennessee",22344,21238,1106,47,33280,4.949874686716791
"Halls town, Tennessee",1001,894,107,47,31820,10.68931068931069
"Cleveland city, Tennessee",17820,16317,1503,47,15400,8.434343434343434
"Camden city, Tennessee",1780,1546,234,47,10560,13.146067415730336
"Red Bank city, Tennessee",6067,5451,616,47,61960,10.153288280863688
"Adamsville town, Tennessee",916,807,109,47,00240,11.899563318777293
"Doyle town, Tennessee",308,237,71,47,21500,23.051948051948052
"Erin city, Tennessee",557,443,114,47,24320,20.46678635547576
"Dover city, Tennessee",839,726,113,47,21400,13.468414779499405
"Gleason town, Tennessee",669,614,55,47,29300,8.221225710014949
"Coopertown town, Tennessee",1490,1482,8,47,16980,0.5369127516778524
"Ridgetop city, Tennessee",833,794,39,47,63140,4.68187274909964
"Pigeon Forge city, Tennessee",5593,2482,3111,47,58080,55.62310030395137
"Selmer town, Tennessee",1887,1707,180,47,66940,9.538950715421304
"Stantonville town, Tennessee",155,128,27,47,70840,17.419354838709676
"Lewisburg city, Tennessee",4794,4333,461,47,41860,9.616186900292032
"Vonore town, Tennessee",775,702,73,47,77480,9.419354838709678
"Livingston town, Tennessee",1767,1630,137,47,43140,7.753254102999434
"Benton town, Tennessee",723,648,75,47,05040,10.37344398340249
"Copperhill city, Tennessee",394,263,131,47,17000,33.24873096446701
"Pegram town, Tennessee",872,865,7,47,57480,0.8027522935779817
"Cumberland Gap town, Tennessee",137,115,22,47,18880,16.05839416058394
"Caryville town, Tennessee",1080,971,109,47,11360,10.092592592592593
"Troy town, Tennessee",713,659,54,47,75240,7.5736325385694245
"Oak Ridge city, Tennessee",14109,12092,2017,47,55120,14.295839535048552
"Rockwood city, Tennessee",2505,2092,413,47,64440,16.487025948103792
"Smyrna town, Tennessee",18597,17774,823,47,69420,4.425444964241544
"Hohenwald city, Tennessee",1621,1463,158,47,35160,9.747069710055522
"Lenoir City city, Tennessee",3913,3398,515,47,41760,13.16125734730386
"Orme town, Tennessee",44,38,6,47,56040,13.636363636363635
"Spring City town, Tennessee",1041,954,87,47,70400,8.357348703170029
"Carthage town, Tennessee",1139,1024,115,47,11280,10.09657594381036
"Cumberland City town, Tennessee",196,142,54,47,18820,27.55102040816326
"Plainview city, Tennessee",827,737,90,47,59020,10.882708585247885
"Martin city, Tennessee",4618,3979,639,47,46240,13.837158943265482
"Sharon town, Tennessee",557,470,87,47,67540,15.61938958707361
"Gilt Edge city, Tennessee",180,168,12,47,29160,6.666666666666667
"Pikeville city, Tennessee",973,874,99,47,58120,10.174717368961973
"Cowan city, Tennessee",785,671,114,47,17700,14.522292993630574
"Estill Springs town, Tennessee",1001,932,69,47,24440,6.893106893106893
"Ridgeside city, Tennessee",217,217,0,47,63080,0.0
"Etowah city, Tennessee",1547,1248,299,47,24480,19.327731092436977
"Bloomingdale CDP, Tennessee",4399,3816,583,47,06640,13.253012048192772
"Bristol city, Tennessee",13158,11528,1630,47,08540,12.387900896792825
"Atwood town, Tennessee",457,411,46,47,02380,10.065645514223196
"Huntingdon town, Tennessee",1677,1423,254,47,36580,15.146094215861657
"Gadsden town, Tennessee",248,196,52,47,28380,20.967741935483872
"Maury City town, Tennessee",353,290,63,47,46540,17.847025495750707
"Bradford town, Tennessee",509,436,73,47,07860,14.341846758349705
"Medina city, Tennessee",1546,1425,121,47,47000,7.826649417852523
"Coalmont city, Tennessee",392,277,115,47,15920,29.336734693877553
"McMinnville city, Tennessee",6275,5492,783,47,45100,12.47808764940239
"Sparta city, Tennessee",2089,1765,324,47,70180,15.509813307802778
"Thompson's Station town, Tennessee",1830,1644,186,47,73900,10.163934426229508
"Celina city, Tennessee",919,703,216,47,12100,23.5038084874864
"Gallaway city, Tennessee",291,256,35,47,28560,12.027491408934708
"Piperton city, Tennessee",761,716,45,47,58840,5.913272010512484
"Williston city, Tennessee",152,146,6,47,81020,3.9473684210526314
"Canadian city, Texas",1133,998,135,48,12412,11.915269196822594
"Morse CDP, Texas",64,38,26,48,49440,40.625
"Seven Points city, Texas",676,471,205,48,66908,30.325443786982248
"Central Gardens CDP, Texas",2019,1826,193,48,13972,9.559187716691431
"Knippa CDP, Texas",287,218,69,48,39664,24.041811846689896
"Tuleta CDP, Texas",161,84,77,48,73856,47.82608695652174
"Utopia CDP, Texas",138,62,76,48,74576,55.072463768115945
"Blue Berry Hill CDP, Texas",268,168,100,48,08830,37.3134328358209
"Hebbronville CDP, Texas",2126,1511,615,48,33008,28.927563499529636
"Pettus CDP, Texas",196,147,49,48,57116,25.0
"Reno city (Parker and Tarrant Counties), Texas",1115,984,131,48,61604,11.748878923766815
"Carmine city, Texas",134,75,59,48,12916,44.02985074626866
"Buckholts town, Texas",218,157,61,48,11020,27.981651376146786
"Hewitt city, Texas",5413,5164,249,48,33428,4.600036948087936
"Robinson city, Texas",4241,3945,296,48,62588,6.979485970290026
"Sierra Blanca CDP, Texas",294,167,127,48,67772,43.197278911564624
"Lipan city, Texas",189,140,49,48,42940,25.925925925925924
"Tolar city, Texas",311,271,40,48,73268,12.861736334405144
"Latexo city, Texas",182,152,30,48,41644,16.483516483516482
"Big Spring city, Texas",9678,8000,1678,48,08236,17.33829303575119
"Cumby city, Texas",330,276,54,48,18128,16.363636363636363
"Sulphur Springs city, Texas",6906,6101,805,48,70904,11.656530553142195
"Agua Dulce city, Texas",315,291,24,48,01396,7.6190476190476195
"Bishop city, Texas",1252,1054,198,48,08392,15.814696485623003
"Sadler city, Texas",298,256,42,48,64088,14.093959731543624
"Daisetta city, Texas",380,290,90,48,18476,23.684210526315788
"Dayton Lakes city, Texas",42,23,19,48,19435,45.23809523809524
"Devers city, Texas",170,145,25,48,20140,14.705882352941178
"Sherman city, Texas",16877,14939,1938,48,67496,11.483083486401611
"Buffalo Springs village, Texas",325,218,107,48,11155,32.92307692307692
"Josephine city, Texas",526,502,24,48,38068,4.562737642585551
"Melissa city, Texas",2522,2522,0,48,47496,0.0
"Plano city, Texas",111066,105557,5509,48,58016,4.960113806205319
"Sweetwater city, Texas",4938,3801,1137,48,71540,23.02551640340219
"Morgan's Point Resort city, Texas",1711,1597,114,48,49392,6.662770309760374
"Rogers town, Texas",493,416,77,48,62924,15.618661257606492
"Keene city, Texas",2051,1879,172,48,38548,8.386153096050707
"Rio Vista city, Texas",365,333,32,48,62240,8.767123287671232
"Quemado CDP, Texas",106,106,0,48,60092,0.0
"Blooming Grove town, Texas",342,290,52,48,08788,15.204678362573098
"Mustang town, Texas",0,0,0,48,50184,
"Lake Meredith Estates CDP, Texas",224,105,119,48,40676,53.125
"La Loma de Falcon CDP, Texas",48,36,12,48,41086,25.0
"Lamar CDP, Texas",771,470,301,48,41092,39.0402075226978
"La Minita CDP, Texas",33,33,0,48,41170,0.0
"Lantana CDP, Texas",3018,2997,21,48,41404,0.6958250497017893
"La Paloma Addition CDP, Texas",133,101,32,48,41420,24.06015037593985
"La Paloma Ranchettes CDP, Texas",88,40,48,48,41424,54.54545454545454
"Laredo Ranchettes West CDP, Texas",0,0,0,48,41475,
"Las Haciendas CDP, Texas",0,0,0,48,41565,
"Las Palmas CDP, Texas",118,48,70,48,41579,59.32203389830508
"Las Palmas II CDP, Texas",409,409,0,48,41580,0.0
"Las Pilas CDP, Texas",42,0,42,48,41582,100.0
"Las Quintas Fronterizas CDP, Texas",504,472,32,48,41583,6.349206349206349
"La Tina Ranch CDP, Texas",237,237,0,48,41660,0.0
"Leming CDP, Texas",196,151,45,48,42256,22.95918367346939
"Ames city, Texas",499,447,52,48,03072,10.420841683366733
"Southmayd city, Texas",394,349,45,48,69104,11.421319796954315
"Whitesboro city, Texas",1909,1615,294,48,78532,15.400733368255631
"Whitewright town, Texas",849,694,155,48,78628,18.256772673733803
"Idalou city, Texas",895,761,134,48,35732,14.972067039106147
"Lubbock city, Texas",105296,94398,10898,48,45000,10.349870840297827
"Slaton city, Texas",2630,2278,352,48,68180,13.38403041825095
"Baneberry city, Tennessee",300,243,57,47,03078,19.0
"Lawrenceburg city, Tennessee",5014,4556,458,47,41340,9.134423613881133
"Three Way city, Tennessee",719,677,42,47,74100,5.84144645340751
"McLemoresville town, Tennessee",179,150,29,47,45000,16.201117318435752
"Millersville city, Tennessee",2714,2536,178,47,48980,6.5585851142225495
"Colonial Heights CDP, Tennessee",1501,1489,12,47,16500,0.7994670219853431
"Walnut Hill CDP, Tennessee",1025,927,98,47,77900,9.560975609756097
"Friendship city, Tennessee",341,279,62,47,27960,18.181818181818183
"Tullahoma city, Tennessee",8829,8191,638,47,75320,7.226186431079397
"Dyer city, Tennessee",1015,964,51,47,22180,5.024630541871921
"Gibson town, Tennessee",159,145,14,47,29020,8.80503144654088
"Milan city, Tennessee",3681,2998,683,47,48660,18.554740559630538
"Hornsby town, Tennessee",161,132,29,47,36080,18.012422360248447
"Crump city, Tennessee",691,605,86,47,18620,12.445730824891461
"Moscow city, Tennessee",289,247,42,47,50300,14.53287197231834
"Saltillo town, Tennessee",439,250,189,47,66340,43.052391799544424
"Mount Pleasant city, Tennessee",2090,1872,218,47,51080,10.430622009569378
"Banner Hill CDP, Tennessee",695,646,49,47,03120,7.0503597122302155
"Hopewell CDP, Tennessee",813,711,102,47,35880,12.546125461254611
"South Cleveland CDP, Tennessee",3207,3032,175,47,69740,5.45681322107889
"Elkton city, Tennessee",258,221,37,47,23660,14.34108527131783
"Jamestown city, Tennessee",1041,882,159,47,37780,15.273775216138327
"White Bluff town, Tennessee",1282,1213,69,47,79980,5.382215288611544
"Enville town, Tennessee",141,77,64,47,24240,45.39007092198582
"Gatlinburg city, Tennessee",6010,1747,4263,47,28800,70.93178036605657
"Mascot CDP, Tennessee",1201,966,235,47,46400,19.567027477102414
"Linden town, Tennessee",534,446,88,47,42720,16.479400749063668
"Dresden town, Tennessee",1399,1271,128,47,21540,9.1493924231594
"Niota city, Tennessee",426,371,55,47,53380,12.910798122065728
"Baxter town, Tennessee",663,594,69,47,03680,10.407239819004525
"Pittman Center town, Tennessee",563,223,340,47,58940,60.39076376554174
"Cross Plains city, Tennessee",716,683,33,47,18420,4.608938547486034
"Rogersville town, Tennessee",2015,1843,172,47,64820,8.535980148883375
"Greeneville town, Tennessee",7101,5917,1184,47,30980,16.67370792846078
"Pleasant View city, Tennessee",1546,1488,58,47,59560,3.751617076326003
"Puryear city, Tennessee",329,289,40,47,61160,12.158054711246201
"Henry town, Tennessee",236,199,37,47,33400,15.677966101694915
"Dunlap city, Tennessee",2306,1930,376,47,22000,16.305290546400695
"Mosheim town, Tennessee",1113,964,149,47,50320,13.387241689128482
"New Hope city, Tennessee",375,339,36,47,52780,9.6
"Memphis city, Tennessee",299132,250812,48320,47,48000,16.153403848468233
"Manchester city, Tennessee",4610,4199,411,47,45500,8.915401301518438
"Mountain City town, Tennessee",1309,976,333,47,50400,25.439266615737203
"Monterey town, Tennessee",1049,948,101,47,49760,9.628217349857007
"Jefferson City city, Tennessee",3140,2781,359,47,37960,11.433121019108281
"Silerton town, Tennessee",88,74,14,47,68560,15.909090909090908
"Green Hill CDP, Tennessee",2549,2498,51,47,31100,2.000784621420165
"Nolensville town, Tennessee",2240,2193,47,47,53460,2.0982142857142856
"Slayden town, Tennessee",84,60,24,47,69080,28.57142857142857
"Jackson city, Tennessee",29635,25773,3862,47,37640,13.03188797030538
"Charleston city, Tennessee",349,324,25,47,13020,7.163323782234957
"Dowelltown town, Tennessee",186,151,35,47,21420,18.817204301075268
"Central CDP, Tennessee",1193,1038,155,47,12460,12.992455993294216
"Pine Crest CDP, Tennessee",1185,1000,185,47,58240,15.611814345991561
"Pleasant Hill town, Tennessee",293,174,119,47,59240,40.61433447098976
"Liberty town, Tennessee",167,143,24,47,42040,14.37125748502994
"Baileyton town, Tennessee",249,223,26,47,02780,10.441767068273093
"Mount Carmel town, Tennessee",2219,2105,114,47,50580,5.137449301487156
"Murfreesboro city, Tennessee",51822,48639,3183,47,51560,6.142178997337038
"Parker city, Texas",1324,1237,87,48,55152,6.570996978851963
"Clarksville city, Tennessee",62176,54766,7410,47,15160,11.917781780751415
"Greenback city, Tennessee",487,394,93,47,30880,19.096509240246405
"Allen city, Texas",33759,32518,1241,48,01924,3.676056755235641
"Wheeler city, Texas",695,629,66,48,78208,9.496402877697841
"Canton city, Texas",1640,1467,173,48,12496,10.548780487804878
"Edgewood town, Texas",732,651,81,48,22612,11.065573770491802
"Bayview town, Texas",190,157,33,48,06140,17.36842105263158
"Del Mar Heights CDP, Texas",46,34,12,48,19714,26.08695652173913
"El Camino Angosto CDP, Texas",37,37,0,48,22858,0.0
"Indian Lake town, Texas",392,245,147,48,35918,37.5
"Laguna Heights CDP, Texas",972,859,113,48,40300,11.62551440329218
"Socorro city, Texas",9807,9169,638,48,68636,6.505557255021924
"Dayton city, Texas",3256,2920,336,48,19432,10.319410319410318
"Highland Park town, Texas",4087,3623,464,48,33824,11.353070712013702
"Sunnyvale town, Texas",1952,1900,52,48,71156,2.663934426229508
"Poteet city, Texas",1230,1024,206,48,59084,16.7479674796748
"Hughes Springs city, Texas",785,649,136,48,35300,17.32484076433121
"Mertzon city, Texas",355,312,43,48,47832,12.112676056338028
"Lolita CDP, Texas",488,333,155,48,43432,31.762295081967213
"Aubrey city, Texas",1284,1202,82,48,04600,6.386292834890965
"Burke city, Texas",337,312,25,48,11380,7.418397626112759
"Poynor town, Texas",128,95,33,48,59192,25.78125
"Homestead Meadows North CDP, Texas",1713,1546,167,48,34671,9.748978400467017
"Loraine town, Texas",252,168,84,48,43996,33.33333333333333
"Dublin city, Texas",1555,1141,414,48,21484,26.623794212218648
"Stephenville city, Texas",8264,6699,1565,48,70208,18.93756050338819
"Brazoria city, Texas",1310,1229,81,48,10072,6.183206106870228
"Freeport city, Texas",4765,4034,731,48,27420,15.34102833158447
"Aquilla city, Texas",51,41,10,48,03588,19.607843137254903
"Tynan CDP, Texas",97,73,24,48,74168,24.742268041237114
"Carthage city, Texas",2757,2412,345,48,13108,12.51360174102285
"Uvalde city, Texas",5838,5100,738,48,74588,12.64131551901336
"Uvalde Estates CDP, Texas",739,505,234,48,74594,31.66441136671177
"Azle city, Texas",4810,4435,375,48,05168,7.796257796257796
"Baird city, Texas",782,675,107,48,05336,13.682864450127877
"Cross Plains town, Texas",572,457,115,48,17816,20.104895104895103
"Nome city, Texas",197,150,47,48,51720,23.85786802030457
"Bailey city, Texas",105,96,9,48,05264,8.571428571428571
"Oak Valley town, Texas",185,169,16,48,53217,8.64864864864865
"Richland town, Texas",120,90,30,48,61820,25.0
"Rockwall city, Texas",15971,15218,753,48,62828,4.714795566965124
"Bruceville-Eddy city, Texas",654,511,143,48,10828,21.865443425076453
"San Antonio city, Texas",543762,497794,45968,48,65000,8.453698493090728
"Sweeny city, Texas",1617,1342,275,48,71492,17.006802721088434
"Wild Peach Village CDP, Texas",989,783,206,48,79192,20.82912032355915
"Melvin town, Texas",112,69,43,48,47568,38.392857142857146
"Covington city, Texas",103,87,16,48,17372,15.53398058252427
"Bonham city, Texas",3561,3046,515,48,09328,14.462229710755405
"Dodd City town, Texas",142,131,11,48,20680,7.746478873239436
"Honey Grove city, Texas",919,794,125,48,34700,13.601741022850925
"Sachse city, Texas",7977,7655,322,48,64064,4.036605240065187
"DeSoto city, Texas",19863,18919,944,48,20092,4.752555001762071
"Farmers Branch city, Texas",14406,13404,1002,48,25452,6.9554352353186175
"Ferris city, Texas",882,815,67,48,25752,7.596371882086168
"Castroville city, Texas",1227,1142,85,48,13312,6.927465362673186
"Port Lavaca city, Texas",5226,4326,900,48,58916,17.221584385763492
"San Perlita city, Texas",213,176,37,48,65636,17.370892018779344
"Ralls city, Texas",819,633,186,48,60356,22.71062271062271
"Bryson city, Texas",260,204,56,48,10960,21.53846153846154
"Jacksboro city, Texas",1568,1337,231,48,37168,14.732142857142858
"Reno city (Lamar County), Texas",1581,1359,222,48,61592,14.041745730550284
"Alvord town, Texas",477,404,73,48,02284,15.30398322851153
"Rhome city, Texas",594,564,30,48,61700,5.05050505050505
"Cedar Hill city, Texas",16533,15616,917,48,13492,5.546482791991774
"Tatum city, Texas",597,452,145,48,71924,24.288107202680067
"El Refugio CDP, Texas",109,83,26,48,24018,23.853211009174313
"Falcon Village CDP, Texas",0,0,0,48,25356,
"Roma city, Texas",3697,3004,693,48,63020,18.74492832025967
"Red Lick city, Texas",379,358,21,48,61172,5.540897097625329
"Wake Village city, Texas",2173,1950,223,48,76096,10.262310170271514
"Barrett CDP, Texas",1343,1249,94,48,05696,6.999255398361877
"Bunker Hill Village city, Texas",1208,1208,0,48,11300,0.0
"Crosby CDP, Texas",965,932,33,48,17756,3.419689119170984
"Galena Park city, Texas",3138,2925,213,48,27996,6.787762906309751
"Hilshire Village city, Texas",350,333,17,48,34148,4.857142857142857
"Katy city, Texas",6239,6000,239,48,38476,3.8307421061067477
"Sansom Park city, Texas",1533,1386,147,48,65660,9.58904109589041
"Trophy Club town, Texas",4013,3911,102,48,73710,2.541739347121854
"Westover Hills town, Texas",262,216,46,48,77788,17.557251908396946
"Hallettsville city, Texas",1398,1082,316,48,31868,22.603719599427755
"Siesta Shores CDP, Texas",506,403,103,48,67778,20.35573122529644
"Brushy Creek CDP, Texas",6754,6417,337,48,10897,4.989635771394729
"Weir city, Texas",125,111,14,48,77056,11.200000000000001
"China Grove town, Texas",421,393,28,48,14716,6.65083135391924
"Converse city, Texas",8166,7646,520,48,16468,6.367866764633848
"Amarillo city, Texas",84324,75563,8761,48,03000,10.389687396233576
"Timberwood Park CDP, Texas",8528,8226,302,48,73057,3.541275797373358
"Whiteface town, Texas",146,116,30,48,78328,20.54794520547945
"Bedias city, Texas",173,134,39,48,07144,22.54335260115607
"Escobares city, Texas",696,559,137,48,24552,19.68390804597701
"Horseshoe Bay city, Texas",3595,1827,1768,48,34862,49.179415855354655
"Lone Oak city, Texas",306,245,61,48,43636,19.934640522875817
"Point Venture village, Texas",722,453,269,48,58586,37.257617728531855
"Hermleigh CDP, Texas",196,172,24,48,33356,12.244897959183673
"Alvarado city, Texas",1517,1471,46,48,02260,3.032300593276203
"Burleson city, Texas",16209,15349,860,48,11428,5.305694367326794
"Eidson Road CDP, Texas",2801,2489,312,48,22810,11.138878971795787
"El Indio CDP, Texas",23,23,0,48,23080,0.0
"Kerens city, Texas",769,628,141,48,38992,18.33550065019506
"Ingleside on the Bay city, Texas",392,336,56,48,36020,14.285714285714285
"Lake City town, Texas",396,242,154,48,40472,38.88888888888889
"Noonday city, Texas",284,241,43,48,51756,15.140845070422534
"Del Rio city, Texas",13376,11376,2000,48,19792,14.952153110047847
"La Feria city, Texas",2770,2376,394,48,40204,14.223826714801444
"San Benito city, Texas",9098,7554,1544,48,65036,16.97076280501209
"Tierra Bonita CDP, Texas",41,41,0,48,72948,0.0
"Fort Davis CDP, Texas",668,457,211,48,26688,31.58682634730539
"Porter Heights CDP, Texas",640,495,145,48,58850,22.65625
"Rollingwood city, Texas",542,531,11,48,63008,2.029520295202952
"Miller's Cove town, Texas",40,36,4,48,48478,10.0
"Garfield CDP, Texas",495,438,57,48,28320,11.515151515151516
"Olton city, Texas",880,695,185,48,54012,21.022727272727273
"Springlake town, Texas",55,37,18,48,69764,32.72727272727273
"Groesbeck city, Texas",1679,1429,250,48,31280,14.889815366289458
"Thornton town, Texas",275,219,56,48,72788,20.363636363636363
"Garrison city, Texas",419,354,65,48,29060,15.513126491646778
"Higgins city, Texas",267,205,62,48,33608,23.220973782771537
"Dimmitt city, Texas",1664,1375,289,48,20464,17.36778846153846
"Ennis city, Texas",6616,6211,405,48,24348,6.121523579201934
"Pecan Plantation CDP, Texas",2615,2537,78,48,56498,2.982791586998088
"Forsan city, Texas",73,69,4,48,26640,5.47945205479452
"Easton city, Texas",183,146,37,48,22192,20.21857923497268
"Mansfield city, Texas",22752,21856,896,48,46452,3.938115330520394
"Radar Base CDP, Texas",63,63,0,48,60278,0.0
"Aransas Pass city, Texas",4342,3088,1254,48,03600,28.880700138185166
"New Summerfield city, Texas",295,205,90,48,51336,30.508474576271187
"Streetman town, Texas",133,109,24,48,70604,18.045112781954884
"Valentine town, Texas",96,38,58,48,74648,60.416666666666664
"Roby city, Texas",269,227,42,48,62612,15.613382899628252
"Lakeport city, Texas",466,401,65,48,40696,13.948497854077251
"Liberty City CDP, Texas",890,822,68,48,42616,7.640449438202247
"Crowell city, Texas",513,345,168,48,17948,32.748538011695906
"Cuney town, Texas",45,25,20,48,18152,44.44444444444444
"Terrell Hills city, Texas",1977,1828,149,48,72296,7.53667172483561
"Cross Mountain CDP, Texas",1359,1275,84,48,17811,6.181015452538632
"Live Oak city, Texas",6402,6178,224,48,43096,3.498906591690097
"Canyon city, Texas",5929,5379,550,48,12532,9.276437847866418
"Universal City city, Texas",7957,7394,563,48,74408,7.07553097901219
"Morton city, Texas",884,673,211,48,49464,23.868778280542987
"Novice city, Texas",53,35,18,48,52668,33.9622641509434
"Shepherd city, Texas",1147,961,186,48,67424,16.216216216216218
"Port Arthur city, Texas",25053,20301,4752,48,58820,18.967788288827688
"Springtown city, Texas",1245,1139,106,48,69800,8.514056224899598
"Columbus city, Texas",1918,1385,533,48,16168,27.78936392075078
"Beverly Hills city, Texas",843,756,87,48,08104,10.320284697508896
"Riesel city, Texas",454,371,83,48,62108,18.28193832599119
"Dean city, Texas",230,195,35,48,19456,15.217391304347828
"Petrolia city, Texas",382,285,97,48,57044,25.392670157068064
"Goliad city, Texas",867,650,217,48,30080,25.02883506343714
"Clear Lake Shores city, Texas",717,601,116,48,15328,16.178521617852162
"Plains town, Texas",535,411,124,48,57968,23.177570093457945
"Batesville CDP, Texas",451,306,145,48,05924,32.15077605321508
"Trent town, Texas",165,128,37,48,73580,22.424242424242426
"Itasca city, Texas",607,522,85,48,37084,14.00329489291598
"New Braunfels city, Texas",29665,26524,3141,48,50820,10.588235294117647
"Schertz city, Texas",14154,13508,646,48,66128,4.564080825208422
"Hillsboro city, Texas",3410,2777,633,48,34088,18.563049853372434
"Calvert city, Texas",676,461,215,48,11992,31.804733727810653
"Van Horn town, Texas",801,587,214,48,75032,26.716604244694132
"Port Mansfield CDP, Texas",403,45,358,48,58928,88.83374689826302
"Sun Valley city, Texas",27,23,4,48,71356,14.814814814814813
"Crosbyton city, Texas",820,635,185,48,17768,22.5609756097561
"Carrollton city, Texas",49345,47913,1432,48,13024,2.9020164150369845
"Caddo Mills city, Texas",666,590,76,48,11716,11.411411411411411
"Bridgeport city, Texas",2042,1900,142,48,10264,6.953966699314397
"Chico city, Texas",455,374,81,48,14620,17.802197802197803
"Coppell city, Texas",15958,15440,518,48,16612,3.246020804612107
"Dallas city, Texas",563993,505816,58177,48,19000,10.315198947504669
"Devine city, Texas",1734,1549,185,48,20152,10.668973471741639
"Natalia city, Texas",458,352,106,48,50400,23.144104803493452
"Dalhart city, Texas",3405,2963,442,48,18524,12.980910425844346
"San Leanna village, Texas",241,214,27,48,65552,11.20331950207469
"Jonestown city, Texas",1083,823,260,48,38020,24.007386888273317
"Manor city, Texas",2802,2472,330,48,46440,11.777301927194861
"Sanger city, Texas",3005,2784,221,48,65408,7.35440931780366
"Round Rock city, Texas",40806,37830,2976,48,63500,7.293045140420526
"The Hills village, Texas",1061,980,81,48,72578,7.634307257304431
"Big Wells city, Texas",329,239,90,48,08260,27.35562310030395
"Avinger town, Texas",162,127,35,48,05084,21.604938271604937
"Linden city, Texas",1062,877,185,48,42844,17.419962335216574
"Lefors town, Texas",288,218,70,48,42148,24.305555555555554
"Meridian city, Texas",695,578,117,48,47760,16.834532374100718
"Marlin city, Texas",2714,1852,862,48,46740,31.76123802505527
"Graham city, Texas",3932,3365,567,48,30392,14.420142421159715
"Pharr city, Texas",24624,21609,3015,48,57200,12.244152046783626
"McAllen city, Texas",51120,45065,6055,48,45384,11.844679186228483
"Muniz CDP, Texas",425,323,102,48,50058,24.0
"Aurora city, Texas",482,428,54,48,04672,11.20331950207469
"Cresson city, Texas",358,303,55,48,17648,15.363128491620111
"deCordova city, Texas",1603,1204,399,48,19570,24.890829694323145
"East Bernard city, Texas",1070,946,124,48,21988,11.588785046728972
"Gun Barrel City city, Texas",3134,2514,620,48,31592,19.783024888321634
"Meadows Place city, Texas",1552,1499,53,48,47337,3.4149484536082473
"Niederwald city, Texas",197,170,27,48,51492,13.705583756345177
"Scurry town, Texas",223,185,38,48,66368,17.040358744394617
"Iola city, Texas",147,99,48,48,36068,32.6530612244898
"Spring Valley Village city, Texas",1514,1452,62,48,69830,4.095112285336857
"Von Ormy city, Texas",291,273,18,48,75764,6.185567010309279
"Weston Lakes city, Texas",1406,1363,43,48,77746,3.058321479374111
"De Kalb city, Texas",973,705,268,48,19648,27.543679342240495
"Maud city, Texas",456,367,89,48,47088,19.517543859649123
"Port Aransas city, Texas",4569,1966,2603,48,58808,56.97089078572992
"Rancho Banquete CDP, Texas",196,196,0,48,60529,0.0
"Three Rivers city, Texas",841,612,229,48,72872,27.2294887039239
"Shenandoah city, Texas",1408,1341,67,48,67400,4.7585227272727275
"Pampa city, Texas",8342,6663,1679,48,54912,20.127067849436585
"Wilmer city, Texas",1285,1171,114,48,79576,8.8715953307393
"Butterfield CDP, Texas",17,4,13,48,11626,76.47058823529412
"Angleton city, Texas",8230,7527,703,48,03264,8.541919805589307
"Alice Acres CDP, Texas",87,70,17,48,01858,19.54022988505747
"Roxton city, Texas",324,252,72,48,63584,22.22222222222222
"Duncanville city, Texas",14179,13290,889,48,21628,6.269835672473375
"Wylie city, Texas",15343,14842,501,48,80356,3.2653327250211825
"La Porte city, Texas",13256,12563,693,48,41440,5.227821363910682
"Taylor Lake Village city, Texas",1280,1269,11,48,71960,0.8593750000000001
"West Sharyland CDP, Texas",558,517,41,48,77866,7.347670250896058
"Savoy city, Texas",368,299,69,48,66008,18.75
"El Paso city, Texas",248776,225264,23512,48,24000,9.45107245071872
"San Felipe town, Texas",376,307,69,48,65372,18.351063829787233
"Needville city, Texas",1179,1114,65,48,50628,5.51314673452078
"Horizon City city, Texas",5700,5350,350,48,34832,6.140350877192982
"Lake Worth city, Texas",1720,1575,145,48,41056,8.430232558139535
"Webster city, Texas",5390,4682,708,48,76948,13.13543599257885
"Houston city, Texas",955525,848340,107185,48,35000,11.217393579445854
"San Marcos city, Texas",25043,22775,2268,48,65600,9.056422952521663
"Vernon city, Texas",5059,4375,684,48,75308,13.520458588653883
"Lucas city, Texas",2194,2002,192,48,45012,8.751139471285324
"Fair Oaks Ranch city, Texas",3943,3845,98,48,25168,2.4854171950291657
"Fayetteville city, Texas",232,106,126,48,25644,54.310344827586206
"Channing city, Texas",173,131,42,48,14260,24.277456647398843
"Tye city, Texas",523,439,84,48,74132,16.061185468451242
"Goodrich city, Texas",129,101,28,48,30224,21.705426356589147
"Ropesville city, Texas",158,132,26,48,63140,16.455696202531644
"Bellevue city, Texas",128,106,22,48,07396,17.1875
"Dumas city, Texas",5216,4463,753,48,21556,14.436349693251534
"Cove city, Texas",163,145,18,48,17336,11.042944785276074
"Camp Swift CDP, Texas",1852,1524,328,48,12334,17.71058315334773
"Friendswood city, Texas",14241,13544,697,48,27648,4.894319219155959
"Kingsland CDP, Texas",4055,2679,1376,48,39304,33.933415536374845
"Talco city, Texas",360,283,77,48,71732,21.38888888888889
"Pecan Hill city, Texas",275,256,19,48,56485,6.909090909090909
"Lindsay CDP, Texas",150,136,14,48,42874,9.333333333333334
"Archer City city, Texas",874,710,164,48,03696,18.76430205949657
"Maypearl city, Texas",262,228,34,48,47268,12.977099236641221
"Palmview city, Texas",2058,1742,316,48,54804,15.354713313896987
"Progreso city, Texas",1600,1391,209,48,59636,13.0625
"South Alamo CDP, Texas",761,725,36,48,68846,4.730617608409987
"Marble Falls city, Texas",3163,2625,538,48,46584,17.009168510907365
"Ravenna city, Texas",106,97,9,48,60752,8.49056603773585
"Caney City town, Texas",166,70,96,48,12472,57.831325301204814
"Nederland city, Texas",7630,6909,721,48,50580,9.44954128440367
"Rancho Chico CDP, Texas",152,108,44,48,60534,28.947368421052634
"Tradewinds CDP, Texas",118,81,37,48,73526,31.35593220338983
"Tyler city, Texas",42246,36434,5812,48,74144,13.757515504426454
"Cedar Park city, Texas",24751,23463,1288,48,13552,5.203830148276838
"Sunset Valley city, Texas",230,202,28,48,71324,12.173913043478262
"Falfurrias city, Texas",2002,1477,525,48,25368,26.223776223776223
"Iredell city, Texas",162,127,35,48,36140,21.604938271604937
"Sudan city, Texas",494,392,102,48,70772,20.647773279352226
"Darrouzett town, Texas",196,166,30,48,19288,15.306122448979592
"Lipscomb CDP, Texas",37,16,21,48,42952,56.75675675675676
"Manvel city, Texas",3195,2783,412,48,46500,12.895148669796558
"Sealy city, Texas",2461,2252,209,48,66464,8.492482730597319
"Danbury city, Texas",639,519,120,48,19120,18.779342723004692
"Lake Jackson city, Texas",11292,10454,838,48,40588,7.4211831385051354
"Richwood city, Texas",1624,1356,268,48,61904,16.502463054187192
"Elsa city, Texas",2216,1954,262,48,24036,11.823104693140793
"Junction city, Texas",1342,1027,315,48,38248,23.472429210134127
"Kingsville city, Texas",10915,9015,1900,48,39352,17.407237746220797
"College Station city, Texas",44663,39908,4755,48,15976,10.646396345968698
"Alton city, Texas",4671,4436,235,48,02212,5.031042603296938
"Heidelberg CDP, Texas",478,394,84,48,33092,17.573221757322173
"Hidalgo city, Texas",3710,3479,231,48,33560,6.226415094339623
"Lopezville CDP, Texas",836,787,49,48,43972,5.861244019138756
"Mission city, Texas",29131,24340,4791,48,48768,16.446397308708935
"Monte Alto CDP, Texas",630,530,100,48,49080,15.873015873015872
"North Alamo CDP, Texas",1426,1305,121,48,51900,8.485273492286115
"Palmhurst city, Texas",982,765,217,48,54780,22.09775967413442
"Sullivan City city, Texas",1449,1281,168,48,70868,11.594202898550725
"Villa Verde CDP, Texas",232,209,23,48,75626,9.913793103448276
"Bertram city, Texas",565,513,52,48,07864,9.20353982300885
"Highland Haven city, Texas",409,271,138,48,33794,33.74083129584352
"E. Lopez CDP, Texas",35,35,0,48,23398,0.0
"J.F. Villareal CDP, Texas",0,0,0,48,37665,
"Lago Vista CDP, Texas",25,12,13,48,40262,52.0
"Ranchitos del Norte CDP, Texas",112,112,0,48,60478,0.0
"San Elizario city, Texas",2749,2391,358,48,65360,13.022917424518008
"Los Corralitos CDP, Texas",36,36,0,48,44079,0.0
"Los Ebanos CDP (Hidalgo County), Texas",86,51,35,48,44104,40.69767441860465
"Los Ebanos CDP (Starr County), Texas",117,117,0,48,44110,0.0
"Los Minerales CDP, Texas",17,10,7,48,44145,41.17647058823529
"Los Fresnos CDP, Texas",35,35,0,48,44120,0.0
"Los Huisaches CDP, Texas",6,6,0,48,44123,0.0
"Los Lobos CDP, Texas",0,0,0,48,44142,
"Los Nopalitos CDP, Texas",33,9,24,48,44146,72.72727272727273
"Los Veteranos I CDP, Texas",0,0,0,48,44167,
"Los Veteranos II CDP, Texas",25,25,0,48,44168,0.0
"McDade CDP, Texas",259,232,27,48,45564,10.424710424710424
"Macdona CDP, Texas",158,101,57,48,45576,36.075949367088604
"McKinney Acres CDP, Texas",328,294,34,48,45750,10.365853658536585
"Manchaca CDP, Texas",444,344,100,48,46308,22.52252252252252
"Manuel Garcia CDP, Texas",88,88,0,48,46492,0.0
"Manuel Garcia II CDP, Texas",0,0,0,48,46494,
"Martinez CDP, Texas",0,0,0,48,46854,
"Matagorda CDP, Texas",435,151,284,48,47016,65.28735632183908
"Mentone CDP, Texas",26,12,14,48,47676,53.84615384615385
"Mesquite CDP, Texas",108,79,29,48,47898,26.851851851851855
"Miguel Barrera CDP, Texas",43,43,0,48,48315,0.0
"Mikes CDP, Texas",187,175,12,48,48318,6.417112299465241
"Mi Ranchito Estate CDP, Texas",122,76,46,48,48750,37.704918032786885
"Montague CDP, Texas",139,121,18,48,49032,12.949640287769784
"Moraida CDP, Texas",11,11,0,48,49300,0.0
"Morgan Farm CDP, Texas",216,154,62,48,49359,28.703703703703702
"Murillo CDP, Texas",1822,1693,129,48,50092,7.0801317233809
"Myrtle Springs CDP, Texas",332,257,75,48,50232,22.590361445783135
"Narciso Pena CDP, Texas",0,0,0,48,50322,
"Netos CDP, Texas",0,0,0,48,50742,
"Nina CDP, Texas",19,8,11,48,51552,57.89473684210527
"Nocona Hills CDP, Texas",574,388,186,48,51654,32.40418118466899
"Oakhurst CDP, Texas",120,120,0,48,52992,0.0
"Oak Island CDP, Texas",145,131,14,48,53004,9.655172413793103
"Olivia Lopez de Gutierrez CDP, Texas",25,25,0,48,53946,0.0
"Olmito and Olmito CDP, Texas",67,67,0,48,53970,0.0
"Orason CDP, Texas",31,7,24,48,54186,77.41935483870968
"Owl Ranch CDP, Texas",75,47,28,48,54509,37.333333333333336
"Pablo Pena CDP, Texas",10,10,0,48,54558,0.0
"Paisano Park CDP, Texas",34,34,0,48,54666,0.0
"Palo Blanco CDP, Texas",38,19,19,48,54846,50.0
"Paloma Creek CDP, Texas",1073,1015,58,48,54868,5.405405405405405
"Paloma Creek South CDP, Texas",2380,2346,34,48,54872,1.4285714285714286
"Chandler city, Texas",1209,1168,41,48,14224,3.391232423490488
"Girard CDP, Texas",7,5,2,48,29612,28.57142857142857
"Jayton city, Texas",344,272,72,48,37468,20.930232558139537
"Midway city, Texas",149,110,39,48,48180,26.174496644295303
"Toco city, Texas",36,31,5,48,73196,13.88888888888889
"George West city, Texas",924,666,258,48,29348,27.92207792207792
"Edna city, Texas",2408,1973,435,48,22720,18.064784053156146
"Ganado city, Texas",844,715,129,48,28080,15.284360189573459
"Lake Bridgeport city, Texas",240,147,93,48,40450,38.75
"New Fairview city, Texas",450,408,42,48,50920,9.333333333333334
"Balch Springs city, Texas",7402,6591,811,48,05372,10.956498243717915
"Cockrell Hill city, Texas",1236,1123,113,48,15796,9.142394822006473
"Combine city, Texas",597,533,64,48,16216,10.720268006700168
"Rowlett city, Texas",21292,20572,720,48,63572,3.3815517565282733
"LaCoste city, Texas",524,487,37,48,40108,7.061068702290077
"Friona city, Texas",1311,1264,47,48,27660,3.585049580472922
"Texline town, Texas",217,171,46,48,72476,21.19815668202765
"Mobile City city, Texas",53,53,0,48,48858,0.0
"Imperial CDP, Texas",148,94,54,48,35828,36.486486486486484
"Ballinger city, Texas",1794,1303,491,48,05456,27.369007803790414
"Seymour city, Texas",1414,1143,271,48,66968,19.165487977369168
"Fort Stockton city, Texas",3095,2602,493,48,26808,15.92891760904685
"Cameron Park CDP, Texas",1742,1492,250,48,12045,14.351320321469574
"Combes town, Texas",1050,850,200,48,16204,19.047619047619047
"Laguna Vista town, Texas",1926,1358,568,48,40336,29.49117341640706
"San Pedro CDP, Texas",118,97,21,48,65620,17.796610169491526
"Cleveland city, Texas",3115,2762,353,48,15436,11.332263242375602
"Bells town, Texas",594,500,94,48,07420,15.824915824915825
"Collinsville town, Texas",670,584,86,48,16036,12.835820895522387
"Denison city, Texas",10416,9314,1102,48,19900,10.579877112135176
"Howe town, Texas",1116,1026,90,48,35084,8.064516129032258
"Tom Bean city, Texas",445,433,12,48,73328,2.696629213483146
"Ransom Canyon town, Texas",501,444,57,48,60672,11.377245508982035
"Wolfforth city, Texas",1689,1609,80,48,79972,4.736530491415039
"Anna city, Texas",3612,3389,223,48,03300,6.173864894795127
"Farmersville city, Texas",1612,1318,294,48,25488,18.23821339950372
"Lowry Crossing city, Texas",559,549,10,48,44308,1.7889087656529516
"Retreat town, Texas",157,144,13,48,61616,8.280254777070063
"Seven Oaks city, Texas",46,24,22,48,66884,47.82608695652174
"Benavides city, Texas",1146,697,449,48,07528,39.179755671902264
"Marathon CDP, Texas",354,193,161,48,46572,45.48022598870056
"Bastrop city, Texas",3338,3180,158,48,05864,4.733373277411624
"Elkhart town, Texas",580,493,87,48,23140,15.0
"Inez CDP, Texas",866,795,71,48,35996,8.198614318706698
"Victoria city, Texas",26679,23607,3072,48,75428,11.514674463060834
"Browndell city, Texas",157,104,53,48,10708,33.75796178343949
"Jamaica Beach city, Texas",1357,575,782,48,37252,57.6271186440678
"Botines CDP, Texas",64,22,42,48,09598,65.625
"Laredo Ranchettes CDP, Texas",9,9,0,48,41473,0.0
"Mirando City CDP, Texas",174,123,51,48,48756,29.310344827586203
"Ranchitos Las Lomas CDP, Texas",173,74,99,48,60482,57.22543352601156
"Hartley CDP, Texas",285,251,34,48,32612,11.929824561403509
"Howardwick city, Texas",374,161,213,48,35072,56.951871657754005
"Copper Canyon town, Texas",437,426,11,48,16636,2.517162471395881
"Vega city, Texas",368,315,53,48,75188,14.402173913043478
"Van city, Texas",1122,954,168,48,74912,14.973262032085561
"Winfield city, Texas",129,101,28,48,79720,21.705426356589147
"Laughlin AFB CDP, Texas",666,666,0,48,41704,0.0
"Lockney town, Texas",776,640,136,48,43252,17.525773195876287
"Mesquite city, Texas",49832,46503,3329,48,47892,6.680446299566543
"Childress city, Texas",2236,1864,372,48,14668,16.636851520572453
"Blossom city, Texas",709,595,114,48,08812,16.07898448519041
"Paris city, Texas",11998,10082,1916,48,55080,15.969328221370226
"Grand Prairie city, Texas",64803,60503,4300,48,30464,6.635495270280697
"Lewisville city, Texas",42312,38908,3404,48,42508,8.044999054641709
"Falls City city, Texas",413,343,70,48,25392,16.94915254237288
"Bear Creek village, Texas",151,151,0,48,06242,0.0
"Grapeland city, Texas",888,717,171,48,30632,19.256756756756758
"Lovelady city, Texas",307,251,56,48,44260,18.241042345276874
"Coahoma town, Texas",350,314,36,48,15700,10.285714285714285
"Tira town, Texas",122,108,14,48,73124,11.475409836065573
"Anson city, Texas",1055,815,240,48,03372,22.748815165876778
"Stamford city, Texas",1912,1418,494,48,69980,25.83682008368201
"Robstown city, Texas",4461,3728,733,48,62600,16.431293431965926
"Spofford city, Texas",95,61,34,48,69560,35.78947368421053
"Huntsville city, Texas",13711,12391,1320,48,35528,9.6273065421924
"Jasper city, Texas",3299,2593,706,48,37420,21.400424371021522
"San Leon CDP, Texas",2626,2068,558,48,65564,21.24904798172125
"Kirbyville city, Texas",1092,958,134,48,39460,12.27106227106227
"Bayou Vista city, Texas",1193,890,303,48,06060,25.39815590947192
"Kemah city, Texas",1139,1022,117,48,38776,10.272168568920105
"Santa Fe city, Texas",5247,4726,521,48,65726,9.929483514389174
"Cactus city, Texas",1192,880,312,48,11692,26.174496644295303
"Snook city, Texas",217,182,35,48,68576,16.129032258064516
"Somerville city, Texas",809,589,220,48,68720,27.19406674907293
"Sunray city, Texas",779,642,137,48,71180,17.58664955070603
"Waller city, Texas",1089,1022,67,48,76228,6.152433425160698
"Alice city, Texas",7474,6545,929,48,01852,12.42975648916243
"Sunrise Beach Village city, Texas",1062,372,690,48,71228,64.97175141242938
"Orange Grove city, Texas",593,522,71,48,54168,11.973018549747048
"Rancho Alegre CDP, Texas",530,371,159,48,60518,30.0
"Westdale CDP, Texas",53,15,38,48,77422,71.69811320754717
"Munday city, Texas",702,451,251,48,50040,35.75498575498576
"Gustine town, Texas",248,163,85,48,31628,34.274193548387096
"Stonewall CDP, Texas",341,283,58,48,70460,17.008797653958943
"Memphis city, Texas",1149,922,227,48,47616,19.756309834638817
"Turkey city, Texas",270,155,115,48,73964,42.592592592592595
"The Woodlands CDP, Texas",43901,40540,3361,48,72656,7.6558620532561905
"Tomball city, Texas",4828,4361,467,48,73316,9.672742336371169
"Woodloch town, Texas",96,73,23,48,80144,23.958333333333336
"Elgin city, Texas",3046,2773,273,48,23044,8.96257386736704
"Smithville city, Texas",1964,1657,307,48,68456,15.631364562118128
"Como town, Texas",291,258,33,48,16252,11.34020618556701
"Fowlerton CDP, Texas",126,69,57,48,27144,45.23809523809524
"Brownsville city, Texas",56892,51585,5307,48,10768,9.328200801518667
"University Park city, Texas",8502,7751,751,48,74492,8.83321571394966
"Tioga town, Texas",405,375,30,48,73112,7.4074074074074066
"Van Alstyne city, Texas",1415,1305,110,48,74924,7.773851590106007
"Odem city, Texas",917,799,118,48,53376,12.8680479825518
"Lago CDP, Texas",95,95,0,48,40258,0.0
"New Deal town, Texas",301,255,46,48,50916,15.282392026578073
"Chireno city, Texas",191,160,31,48,14776,16.230366492146597
"Brenham city, Texas",6468,5388,1080,48,10156,16.697588126159555
"Citrus City CDP, Texas",747,663,84,48,15028,11.244979919678714
"Buffalo city, Texas",828,632,196,48,11116,23.67149758454106
"Donna city, Texas",6027,4880,1147,48,20884,19.031027044964326
"Rocky Mound town, Texas",59,39,20,48,62870,33.89830508474576
"Liverpool city, Texas",273,210,63,48,43120,23.076923076923077
"New Hope town, Texas",240,228,12,48,51036,5.0
"Eastland city, Texas",1761,1372,389,48,22132,22.089721749006248
"Abernathy city, Texas",1219,1094,125,48,00160,10.254306808859722
"Fate city, Texas",3750,3627,123,48,25572,3.2800000000000002
"Selma city, Texas",3452,3353,99,48,66704,2.8679026651216684
"Blum town, Texas",133,112,21,48,09004,15.789473684210526
"Hubbard city, Texas",687,544,143,48,35180,20.815138282387192
"Brady city, Texas",2521,2084,437,48,09916,17.33439111463705
"Hearne city, Texas",1813,1498,315,48,32972,17.374517374517374
"Bailey's Prairie village, Texas",280,269,11,48,05288,3.9285714285714284
"McLendon-Chisholm city, Texas",834,830,4,48,45804,0.4796163069544364
"Industry city, Texas",153,126,27,48,35984,17.647058823529413
"Bellville city, Texas",2022,1826,196,48,07432,9.693372898120673
"Bonney village, Texas",130,105,25,48,09388,19.230769230769234
"Brookside Village city, Texas",692,587,105,48,10648,15.173410404624278
"Clute city, Texas",5129,4312,817,48,15652,15.929031000194971
"Iowa Colony village, Texas",412,337,75,48,36092,18.203883495145632
"Jones Creek village, Texas",851,731,120,48,37984,14.101057579318448
"Rice city, Texas",306,275,31,48,61736,10.130718954248366
"Oyster Creek city, Texas",604,504,100,48,54528,16.55629139072848
"Quintana town, Texas",27,9,18,48,60164,66.66666666666666
"Surfside Beach city, Texas",1037,311,726,48,71384,70.00964320154291
"Royse City city, Texas",4064,3781,283,48,63668,6.963582677165355
"Huxley city, Texas",294,193,101,48,35636,34.35374149659864
"Palisades village, Texas",149,121,28,48,54726,18.79194630872483
"Nash city, Texas",1386,1339,47,48,50352,3.3910533910533913
"Channelview CDP, Texas",12409,11794,615,48,14236,4.956080264324281
"League City city, Texas",36697,34869,1828,48,41980,4.981333624001962
"Huntington city, Texas",972,785,187,48,35492,19.238683127572017
"Throckmorton town, Texas",469,342,127,48,72896,27.078891257995735
"Early city, Texas",1218,1062,156,48,21904,12.807881773399016
"Scottsville city, Texas",169,134,35,48,66332,20.710059171597635
"Waskom city, Texas",833,598,235,48,76636,28.211284513805523
"Mabank town, Texas",1341,1162,179,48,45324,13.348247576435496
"Terrell city, Texas",6365,5812,553,48,72284,8.688138256087981
"Corrigan town, Texas",942,780,162,48,17036,17.197452229299362
"West Livingston CDP, Texas",2512,1835,677,48,77662,26.95063694267516
"Callisburg city, Texas",144,140,4,48,11968,2.7777777777777777
"Gainesville city, Texas",6752,6163,589,48,27984,8.723341232227488
"Cameron city, Texas",2533,2096,437,48,12040,17.25227003553099
"Gholson city, Texas",469,448,21,48,29408,4.477611940298507
"Conroe city, Texas",32956,29836,3120,48,16432,9.467168345673018
"Panorama Village city, Texas",1373,1306,67,48,55008,4.879825200291333
"Splendora city, Texas",723,647,76,48,69548,10.511756569847856
"Circle D-KC Estates CDP, Texas",972,861,111,48,14986,11.419753086419753
"Christine town, Texas",146,109,37,48,14860,25.34246575342466
"Bloomburg town, Texas",201,156,45,48,08752,22.388059701492537
"Domino town, Texas",52,52,0,48,20848,0.0
"McLean town, Texas",462,355,107,48,45780,23.160173160173162
"Panhandle town, Texas",1081,959,122,48,54960,11.285846438482887
"Thorndale city, Texas",609,513,96,48,72776,15.763546798029557
"Schulenburg city, Texas",1338,1015,323,48,66188,24.14050822122571
"South Fork Estates CDP, Texas",24,24,0,48,68966,0.0
"Rockdale city, Texas",2485,2175,310,48,62672,12.474849094567404
"Bellmead city, Texas",4132,3691,441,48,07408,10.672797676669893
"Crawford town, Texas",295,269,26,48,17564,8.813559322033898
"Lacy-Lakeview city, Texas",2952,2536,416,48,40168,14.092140921409213
"Lorena city, Texas",777,744,33,48,44020,4.247104247104247
"McGregor city, Texas",1908,1737,171,48,45672,8.962264150943396
"Runge town, Texas",444,330,114,48,63788,25.675675675675674
"Mountain City city, Texas",244,244,0,48,49600,0.0
"Granbury city, Texas",4987,3996,991,48,30416,19.871666332464407
"Hooks city, Texas",1149,957,192,48,34736,16.710182767624023
"San Patricio city, Texas",170,137,33,48,65612,19.411764705882355
"Bullard town, Texas",1047,937,110,48,11212,10.506208213944603
"Aldine CDP, Texas",4369,4023,346,48,01696,7.919432364385442
"Baytown city, Texas",29711,26581,3130,48,06128,10.534818753996836
"Bellaire city, Texas",7201,6644,557,48,07300,7.735036800444382
"Cloverleaf CDP, Texas",7407,6774,633,48,15628,8.54597002835156
"Hedwig Village city, Texas",1003,928,75,48,33068,7.477567298105684
"Highlands CDP, Texas",2870,2686,184,48,33836,6.411149825783973
"Lake Tanglewood village, Texas",511,378,133,48,40804,26.027397260273972
"Point Blank city, Texas",514,330,184,48,58556,35.797665369649806
"La Grulla city, Texas",568,438,130,48,40288,22.887323943661972
"La Puerta CDP, Texas",173,143,30,48,41458,17.341040462427745
"Santa Cruz CDP, Texas",8,8,0,48,65708,0.0
"Pearland city, Texas",41563,39527,2036,48,56348,4.898587686163174
"Leary city, Texas",249,223,26,48,42028,10.441767068273093
"Redwater city, Texas",504,398,106,48,61340,21.03174603174603
"Pasadena city, Texas",53751,48724,5027,48,56000,9.352384141690386
"South Houston city, Texas",5184,4713,471,48,69020,9.085648148148149
"Stafford city, Texas",7321,6897,424,48,69908,5.791558530255429
"Buchanan Dam CDP, Texas",1339,697,642,48,10984,47.9462285287528
"Goree city, Texas",162,124,38,48,30296,23.456790123456788
"Oakwood town, Texas",227,187,40,48,53232,17.62114537444934
"Mart city, Texas",919,702,217,48,46824,23.612622415669204
"Valley Mills city, Texas",534,478,56,48,74732,10.486891385767791
"Woodway city, Texas",3386,3198,188,48,80224,5.552274069698759
"Buda city, Texas",5380,5183,197,48,11080,3.661710037174721
"Dripping Springs city, Texas",1124,1051,73,48,21424,6.494661921708185
"Hays city, Texas",102,91,11,48,32906,10.784313725490197
"Dell City city, Texas",193,106,87,48,19708,45.07772020725388
"Clarksville City city, Texas",340,285,55,48,15172,16.176470588235293
"Kilgore city, Texas",6074,5221,853,48,39124,14.043463944682252
"Hawley city, Texas",272,253,19,48,32840,6.985294117647059
"Barry city, Texas",119,103,16,48,05708,13.445378151260504
"Dawson town, Texas",430,339,91,48,19420,21.16279069767442
"Goodlow city, Texas",74,57,17,48,30188,22.972972972972975
"Miles city, Texas",386,293,93,48,48396,24.093264248704664
"Winters city, Texas",1254,1006,248,48,79876,19.776714513556616
"Tenaha town, Texas",561,500,61,48,72188,10.87344028520499
"Timpson city, Texas",704,528,176,48,73076,25.0
"Grandfalls town, Texas",160,128,32,48,30440,20.0
"Wickett town, Texas",245,200,45,48,79036,18.367346938775512
"Holliday city, Texas",692,567,125,48,34532,18.063583815028903
"Pecan Gap city, Texas",98,76,22,48,56468,22.448979591836736
"Cuevitas CDP, Texas",0,0,0,48,18104,
"Abbott city, Texas",138,126,12,48,00100,8.695652173913043
"Arcola city, Texas",530,489,41,48,03708,7.735849056603773
"Four Corners CDP, Texas",3169,3110,59,48,27102,1.861786052382455
"Sienna Plantation CDP, Texas",4846,4757,89,48,67766,1.8365662401981016
"Sugar Land city, Texas",40109,38373,1736,48,70808,4.328205639632002
"Thompsons town, Texas",94,91,3,48,72740,3.1914893617021276
"Anahuac city, Texas",896,799,97,48,03144,10.825892857142858
"Winnie CDP, Texas",1670,1348,322,48,79792,19.281437125748504
"Rose Hill Acres city, Texas",198,151,47,48,63272,23.737373737373737
"Smyer town, Texas",215,192,23,48,68504,10.69767441860465
"Mineola city, Texas",1884,1589,295,48,48648,15.658174097664542
"Campbell city, Texas",303,276,27,48,12112,8.91089108910891
"Greenville city, Texas",10798,9921,877,48,30920,8.12187442118911
"Quinlan city, Texas",620,574,46,48,60140,7.419354838709677
"Wolfe City city, Texas",651,506,145,48,79948,22.27342549923195
"Marion city, Texas",395,344,51,48,46692,12.91139240506329
"Garland city, Texas",79520,75439,4081,48,29000,5.132042253521127
"Grapevine city, Texas",21142,20097,1045,48,30644,4.94276795005203
"Richardson city, Texas",45289,42723,2566,48,61796,5.6658349709642515
"Lasara CDP, Texas",269,225,44,48,41548,16.356877323420075
"Raymondville city, Texas",3165,2690,475,48,60836,15.00789889415482
"Chester town, Texas",168,115,53,48,14584,31.547619047619047
"Colmesneil city, Texas",277,236,41,48,16048,14.801444043321299
"Floresville city, Texas",2670,2352,318,48,26160,11.910112359550562
"Poth town, Texas",749,658,91,48,59096,12.149532710280374
"Wixon Valley city, Texas",104,87,17,48,79919,16.346153846153847
"Garrett town, Texas",290,276,14,48,29036,4.827586206896552
"Walnut Springs city, Texas",332,290,42,48,76348,12.650602409638553
"Los Fresnos city, Texas",2392,2006,386,48,44116,16.137123745819398
"Tehuacana town, Texas",113,88,25,48,72080,22.123893805309734
"Newcastle city, Texas",301,261,40,48,50868,13.2890365448505
"Harlingen city, Texas",24642,21015,3627,48,32372,14.718772826880935
"Oak Trail Shores CDP, Texas",1083,867,216,48,53212,19.94459833795014
"Spearman city, Texas",1416,1182,234,48,69476,16.52542372881356
"Crandall city, Texas",1263,1204,59,48,17504,4.671417260490895
"Bevil Oaks city, Texas",604,504,100,48,08128,16.55629139072848
"Booker town, Texas",580,512,68,48,09448,11.724137931034482
"Concepcion CDP, Texas",37,18,19,48,16300,51.35135135135135
"Skidmore CDP, Texas",450,380,70,48,68132,15.555555555555555
"Aledo city, Texas",1185,1085,100,48,01744,8.438818565400844
"Cool city, Texas",77,73,4,48,16540,5.194805194805195
"Weatherford city, Texas",11903,10718,1185,48,76864,9.95547341006469
"La Grange city, Texas",2127,1575,552,48,40276,25.952045133991536
"West city, Texas",1347,1087,260,48,77332,19.302152932442464
"Todd Mission city, Texas",36,18,18,48,73224,50.0
"Boerne city, Texas",5505,5176,329,48,09160,5.976385104450499
"Bynum town, Texas",118,77,41,48,11656,34.74576271186441
"Franklin city, Texas",854,650,204,48,27288,23.88758782201405
"Windom town, Texas",89,79,10,48,79684,11.235955056179774
"Coffee City town, Texas",168,133,35,48,15820,20.833333333333336
"Trinidad city, Texas",494,391,103,48,73652,20.850202429149796
"New Berlin city, Texas",281,276,5,48,50796,1.7793594306049825
"Indian Hills CDP, Texas",766,547,219,48,35915,28.590078328981722
"La Homa CDP, Texas",3603,3126,477,48,40342,13.238967527060783
"Mila Doce CDP, Texas",1754,1585,169,48,48320,9.635119726339795
"Olivarez CDP, Texas",909,890,19,48,53934,2.0902090209020905
"Pilot Point city, Texas",1814,1736,78,48,57476,4.299889746416759
"Corpus Christi city, Texas",131136,116562,14574,48,17000,11.113653001464128
"North San Pedro CDP, Texas",277,277,0,48,52404,0.0
"Annetta South town, Texas",183,177,6,48,03342,3.278688524590164
"East Tawakoni city, Texas",391,295,96,48,22276,24.55242966751918
"Oilton CDP, Texas",205,117,88,48,53556,42.926829268292686
"Timbercreek Canyon village, Texas",201,181,20,48,73030,9.950248756218906
"Nocona city, Texas",1482,1198,284,48,51648,19.163292847503374
"La Victoria CDP, Texas",41,41,0,48,41782,0.0
"Hedley city, Texas",210,124,86,48,33044,40.95238095238095
"Rockport city, Texas",6960,3967,2993,48,62804,43.002873563218394
"Beaumont city, Texas",52555,46233,6322,48,07000,12.029302635334412
"Waco city, Texas",54164,48050,6114,48,76000,11.28794032937006
"Winnsboro city, Texas",1373,1183,190,48,79816,13.838310269482884
"Serenada CDP, Texas",523,508,15,48,66806,2.8680688336520075
"Falcon Heights CDP, Texas",26,14,12,48,25344,46.15384615384615
"La Rosita CDP, Texas",10,10,0,48,41503,0.0
"Rule town, Texas",373,256,117,48,63752,31.36729222520107
"Celeste city, Texas",386,305,81,48,13672,20.984455958549223
"Glenn Heights city, Texas",3873,3659,214,48,29840,5.525432481280661
"Rising Star town, Texas",483,265,218,48,62252,45.13457556935818
"Lake Kiowa CDP, Texas",1347,1182,165,48,40624,12.24944320712695
"Lexington town, Texas",613,533,80,48,42532,13.050570962479608
"Stinnett city, Texas",798,474,324,48,70340,40.6015037593985
"Runaway Bay city, Texas",829,718,111,48,63782,13.38962605548854
"Farwell city, Texas",687,576,111,48,25548,16.157205240174672
"Charlotte city, Texas",672,542,130,48,14404,19.345238095238095
"Hawk Cove city, Texas",219,175,44,48,32810,20.091324200913242
"McQueeney CDP, Texas",1494,1156,338,48,45948,22.623828647925034
"Seguin city, Texas",11336,10126,1210,48,66644,10.673959068454481
"Palo Pinto CDP, Texas",70,47,23,48,54876,32.857142857142854
"Fresno CDP, Texas",7222,6907,315,48,27540,4.3616726668512875
"Sandy Oaks city, Texas",1171,1031,140,48,65344,11.955593509820666
"Sonterra CDP, Texas",1036,986,50,48,68762,4.826254826254826
"Pena CDP, Texas",9,9,0,48,56644,0.0
"Perezville CDP, Texas",2368,1625,743,48,56804,31.37668918918919
"Perrin CDP, Texas",161,128,33,48,56864,20.496894409937887
"Pine Harbor CDP, Texas",521,377,144,48,57566,27.63915547024952
"Placedo CDP, Texas",259,230,29,48,57932,11.196911196911197
"Pleasant Hill CDP, Texas",301,241,60,48,58232,19.93355481727575
"Port O'Connor CDP, Texas",1656,289,1367,48,58952,82.54830917874396
"Powderly CDP, Texas",481,456,25,48,59156,5.197505197505198
"Preston CDP, Texas",1712,1030,682,48,59420,39.83644859813084
"Pueblo East CDP, Texas",7,0,7,48,59794,100.0
"Pueblo Nuevo CDP, Texas",163,127,36,48,59798,22.085889570552148
"Quail Creek CDP, Texas",696,696,0,48,60026,0.0
"Quesada CDP, Texas",0,0,0,48,60098,
"Rafael Pena CDP, Texas",0,0,0,48,60290,
"Ramireno CDP, Texas",29,9,20,48,60380,68.96551724137932
"Ramirez-Perez CDP, Texas",23,23,0,48,60408,0.0
"Ramos CDP, Texas",96,84,12,48,60422,12.5
"Ranchitos East CDP, Texas",147,118,29,48,60480,19.727891156462583
"Rancho Viejo CDP, Texas",35,35,0,48,60554,0.0
"Randolph AFB CDP, Texas",304,283,21,48,60608,6.907894736842106
"Redfield CDP, Texas",142,122,20,48,61040,14.084507042253522
"Redland CDP, Texas",439,415,24,48,61124,5.466970387243736
"Regino Ramirez CDP, Texas",35,35,0,48,61454,0.0
"Ricardo CDP, Texas",209,176,33,48,61724,15.789473684210526
"Rivereno CDP, Texas",19,19,0,48,62318,0.0
"Riviera CDP, Texas",233,193,40,48,62468,17.167381974248926
"Rosharon CDP, Texas",579,521,58,48,63332,10.01727115716753
"Rosita CDP, Texas",844,793,51,48,63350,6.042654028436019
"Saline�o North CDP, Texas",69,31,38,48,64322,55.072463768115945
"Sammy Martinez CDP, Texas",5,5,0,48,64442,0.0
"Sam Rayburn CDP, Texas",1090,363,727,48,64460,66.69724770642202
"San Carlos I CDP, Texas",33,24,9,48,65049,27.27272727272727
"San Carlos II CDP, Texas",73,73,0,48,65050,0.0
"Sandoval CDP, Texas",12,0,12,48,65210,100.0
"Sand Springs CDP, Texas",378,314,64,48,65240,16.93121693121693
"San Fernando CDP, Texas",39,39,0,48,65378,0.0
"San Juan CDP, Texas",23,23,0,48,65532,0.0
"Santa Anna CDP, Texas",9,9,0,48,65678,0.0
"Santa Rosa CDP, Texas",83,69,14,48,65774,16.867469879518072
"Santel CDP, Texas",5,5,0,48,65777,0.0
"Sarita CDP, Texas",198,176,22,48,65876,11.11111111111111
"Savannah CDP, Texas",2067,2014,53,48,66000,2.564102564102564
"Kingsbury city, Texas",21,21,0,48,39292,0.0
"Plantersville city, Texas",281,244,37,48,58040,13.167259786476867
"Roman Forest city, Texas",635,603,32,48,63044,5.039370078740157
"Spring Branch city, Texas",10,10,0,48,69608,0.0
"Seco Mines CDP, Texas",183,156,27,48,66536,14.754098360655737
"Shadybrook CDP, Texas",869,713,156,48,67010,17.951668584579977
"Sherwood Shores CDP, Texas",945,550,395,48,67554,41.7989417989418
"Siesta Acres CDP, Texas",737,674,63,48,67775,8.548168249660787
"South La Paloma CDP, Texas",167,129,38,48,69072,22.75449101796407
"Spring Gardens CDP, Texas",178,178,0,48,69708,0.0
"Staples city, Texas",104,100,4,48,70052,3.8461538461538463
"Study Butte CDP, Texas",107,97,10,48,70688,9.345794392523365
"Tanquecitos South Acres CDP, Texas",70,32,38,48,71820,54.285714285714285
"Sunset CDP (Montague County), Texas",175,157,18,48,71264,10.285714285714285
"Sunset CDP (Starr County), Texas",3,3,0,48,71274,0.0
"Sunset Acres CDP, Texas",14,0,14,48,71289,100.0
"Tanquecitos South Acres II CDP, Texas",9,0,9,48,71824,100.0
"Terlingua CDP, Texas",45,41,4,48,72248,8.88888888888889
"Thompsonville CDP, Texas",74,56,18,48,72758,24.324324324324326
"Thunderbird Bay CDP, Texas",811,274,537,48,72902,66.21454993834772
"Tierra Dorada CDP, Texas",0,0,0,48,72950,
"Tierra Verde CDP, Texas",120,120,0,48,72954,0.0
"Tilden CDP, Texas",151,92,59,48,72992,39.0728476821192
"Tivoli CDP, Texas",329,200,129,48,73148,39.209726443769
"Travis Ranch CDP, Texas",1065,1065,0,48,73562,0.0
"Valle Hermoso CDP, Texas",0,0,0,48,74667,
"Valle Verde CDP, Texas",0,0,0,48,74668,
"Valle Vista CDP, Texas",158,129,29,48,74670,18.354430379746837
"Valley View city, Texas",343,326,17,48,74756,4.956268221574344
"Victoria Vera CDP, Texas",24,24,0,48,75432,0.0
"Villarreal CDP, Texas",35,35,0,48,75617,0.0
"Warren CDP, Texas",337,267,70,48,76564,20.77151335311573
"Welch CDP, Texas",106,64,42,48,77080,39.62264150943396
"West Alto Bonito CDP, Texas",188,141,47,48,77336,25.0
"Western Lake CDP, Texas",328,315,13,48,77490,3.9634146341463414
"Westminster CDP, Texas",352,305,47,48,77680,13.352272727272727
"Westwood Shores CDP, Texas",886,644,242,48,78040,27.313769751693002
"Wildwood CDP, Texas",634,542,92,48,79204,14.511041009463725
"Zarate CDP, Texas",20,20,0,48,80724,0.0
"C�sar Ch�vez CDP, Texas",519,413,106,48,14038,20.423892100192678
"Coyote Flats city, Texas",154,132,22,48,17429,14.285714285714285
"Providence Village town, Texas",2050,2050,0,48,59748,0.0
"Sandy Point city, Texas",69,46,23,48,65345,33.33333333333333
"San Saba city, Texas",1149,921,228,48,65648,19.843342036553523
"Abram CDP, Texas",561,506,55,48,01060,9.803921568627452
"Aguilares CDP, Texas",0,0,0,48,01420,
"Airport Heights CDP, Texas",6,6,0,48,01500,0.0
"Alfred CDP, Texas",18,0,18,48,01816,100.0
"Alto Bonito Heights CDP, Texas",111,45,66,48,02194,59.45945945945946
"Amada Acres CDP, Texas",12,0,12,48,02286,100.0
"Amargosa CDP, Texas",38,38,0,48,02290,0.0
"Amaya CDP, Texas",25,17,8,48,03008,32.0
"Amistad CDP, Texas",126,21,105,48,03096,83.33333333333334
"Anacua CDP, Texas",8,8,0,48,03126,0.0
"Arroyo Gardens CDP, Texas",113,71,42,48,04176,37.16814159292036
"B and E CDP, Texas",105,68,37,48,05520,35.23809523809524
"Banquete CDP, Texas",299,204,95,48,05576,31.77257525083612
"Barrera CDP, Texas",28,28,0,48,05690,0.0
"Bee Cave city, Texas",3150,2738,412,48,07156,13.079365079365079
"Benjamin Perez CDP, Texas",39,39,0,48,07642,0.0
"Big Thicket Lake Estates CDP, Texas",265,174,91,48,08240,34.33962264150943
"Bluetown CDP, Texas",136,131,5,48,08908,3.6764705882352944
"Boling CDP, Texas",419,397,22,48,09232,5.250596658711217
"Bonanza Hills CDP, Texas",44,23,21,48,09310,47.72727272727273
"Box Canyon CDP, Texas",119,28,91,48,09656,76.47058823529412
"Boys Ranch CDP, Texas",54,37,17,48,09796,31.48148148148148
"Bristol CDP, Texas",174,174,0,48,10336,0.0
"Buchanan Lake Village CDP, Texas",881,434,447,48,10990,50.73779795686719
"Buena Vista CDP, Texas",11,11,0,48,11102,0.0
"Burton city, Texas",258,213,45,48,11536,17.441860465116278
"Canyon Creek CDP, Texas",534,369,165,48,12562,30.89887640449438
"Callender Lake CDP, Texas",634,457,177,48,11940,27.917981072555204
"Camargito CDP, Texas",164,135,29,48,12010,17.682926829268293
"Campo Verde CDP, Texas",45,45,0,48,12226,0.0
"Cape Royale CDP, Texas",733,258,475,48,12600,64.80218281036835
"Carlsbad CDP, Texas",198,144,54,48,12892,27.27272727272727
"Casa Blanca CDP, Texas",0,0,0,48,13128,
"Casas CDP, Texas",5,5,0,48,13150,0.0
"Rosenberg city, Texas",13599,12015,1584,48,63284,11.647915287888816
"Old River-Winfree city, Texas",756,699,57,48,53824,7.5396825396825395
"Lumberton city, Texas",5051,4556,495,48,45120,9.80003959611958
"Opdyke West town, Texas",90,85,5,48,54075,5.555555555555555
"Sundown city, Texas",514,423,91,48,71060,17.704280155642024
"Centerville city, Texas",427,334,93,48,13900,21.779859484777518
"Leona city, Texas",78,50,28,48,42340,35.8974358974359
"Hawkins city, Texas",602,489,113,48,32816,18.77076411960133
"Yantis town, Texas",192,164,28,48,80440,14.583333333333334
"Crane city, Texas",1338,1184,154,48,17516,11.509715994020926
"Paradise city, Texas",194,178,16,48,55056,8.24742268041237
"O'Donnell city, Texas",432,322,110,48,53436,25.462962962962965
"Cross Roads town, Texas",436,419,17,48,17852,3.89908256880734
"Livingston town, Texas",2513,2089,424,48,43132,16.872264226024672
"Kaufman city, Texas",2432,2188,244,48,38488,10.032894736842106
"Post Oak Bend City town, Texas",177,157,20,48,59066,11.299435028248588
"Perryton city, Texas",3540,3031,509,48,56912,14.378531073446327
"Muenster city, Texas",624,561,63,48,49932,10.096153846153847
"Milano city, Texas",195,159,36,48,48336,18.461538461538463
"Eagle Lake city, Texas",1235,1074,161,48,21844,13.036437246963562
"Hallsburg city, Texas",198,160,38,48,31880,19.19191919191919
"Leroy city, Texas",132,127,5,48,42400,3.787878787878788
"Aspermont town, Texas",519,378,141,48,04408,27.167630057803464
"Edom city, Texas",99,84,15,48,22744,15.151515151515152
"Grand Saline city, Texas",1182,978,204,48,30476,17.258883248730964
"Los Ybanez city, Texas",12,12,0,48,44170,0.0
"Westlake town, Texas",341,310,31,48,77620,9.090909090909092
"Shiner city, Texas",1056,818,238,48,67640,22.53787878787879
"Medina CDP, Texas",1543,1313,230,48,47406,14.906027219701878
"Gardendale CDP, Texas",772,653,119,48,28200,15.414507772020725
"Ackerly city, Texas",73,64,9,48,01108,12.32876712328767
"Trenton city, Texas",337,296,41,48,73592,12.166172106824925
"Athens city, Texas",4693,4014,679,48,04504,14.468357127636905
"Berryville town, Texas",568,446,122,48,07852,21.47887323943662
"Enchanted Oaks town, Texas",339,157,182,48,24228,53.687315634218294
"Log Cabin city, Texas",384,268,116,48,43354,30.208333333333332
"Canutillo CDP, Texas",1668,1436,232,48,12508,13.908872901678656
"Morning Glory CDP, Texas",119,119,0,48,49411,0.0
"Westbrook city, Texas",91,70,21,48,77380,23.076923076923077
"Edgecliff Village town, Texas",1032,988,44,48,22588,4.263565891472868
"Brazos Bend city, Texas",177,163,14,48,10087,7.909604519774012
"Celina city, Texas",3039,2865,174,48,13684,5.725567620927937
"Daingerfield city, Texas",1102,967,135,48,18464,12.250453720508167
"DISH town, Texas",160,160,0,48,20540,0.0
"Lavon city, Texas",946,946,0,48,41800,0.0
"Little Elm city, Texas",14073,13622,451,48,43012,3.2047182548141833
"Oak Leaf city, Texas",506,486,20,48,53115,3.9525691699604746
"San Augustine city, Texas",1053,766,287,48,65024,27.255460588793923
"Taylor Landing city, Texas",106,88,18,48,71966,16.9811320754717
"Volente village, Texas",295,230,65,48,75752,22.033898305084744
"Freer city, Texas",1165,820,345,48,27432,29.613733905579398
"West Tawakoni city, Texas",1085,867,218,48,77896,20.092165898617512
"Green Valley Farms CDP, Texas",198,181,17,48,30890,8.585858585858585
"Grays Prairie village, Texas",105,89,16,48,30752,15.238095238095239
"Round Top town, Texas",106,49,57,48,63524,53.77358490566038
"Yznaga CDP, Texas",36,36,0,48,80686,0.0
"Shallowater city, Texas",899,815,84,48,67136,9.343715239154617
"Harker Heights city, Texas",11876,10375,1501,48,32312,12.638935668575277
"Fruitvale city, Texas",151,147,4,48,27804,2.6490066225165565
"Lakeway city, Texas",6327,5684,643,48,40984,10.16279437332069
"Uhland city, Texas",424,405,19,48,74216,4.481132075471698
"Jefferson city, Texas",1135,1000,135,48,37528,11.894273127753303
"Corral City town, Texas",7,1,6,48,17024,85.71428571428571
"Follett city, Texas",200,160,40,48,26328,20.0
"Bardwell city, Texas",215,188,27,48,05612,12.558139534883722
"Rosebud city, Texas",563,398,165,48,63188,29.307282415630553
"Stockdale city, Texas",544,434,110,48,70376,20.22058823529412
"Lakeside town (San Patricio County), Texas",204,131,73,48,40738,35.78431372549019
"Santa Rosa town, Texas",826,745,81,48,65768,9.806295399515738
"Olmito CDP, Texas",452,361,91,48,53964,20.13274336283186
"Ratamosa CDP, Texas",57,57,0,48,60686,0.0
"White Deer town, Texas",295,245,50,48,78316,16.94915254237288
"Jourdanton city, Texas",1520,1290,230,48,38116,15.131578947368421
"Douglassville town, Texas",125,91,34,48,21112,27.200000000000003
"Queen City city, Texas",826,649,177,48,60080,21.428571428571427
"Adrian city, Texas",78,43,35,48,01324,44.871794871794876
"Hitchcock city, Texas",3324,2666,658,48,34220,19.79542719614922
"Hondo city, Texas",2524,2182,342,48,34676,13.549920760697306
"Encinal city, Texas",356,278,78,48,24240,21.910112359550563
"Palestine city, Texas",7715,6617,1098,48,54708,14.23201555411536
"Byers city, Texas",212,182,30,48,11644,14.150943396226415
"Bolivar Peninsula CDP, Texas",3086,1035,2051,48,09250,66.46143875567077
"La Marque city, Texas",6925,5860,1065,48,41116,15.379061371841155
"Paducah town, Texas",809,561,248,48,54600,30.655129789864027
"Tiki Island village, Texas",1058,500,558,48,72989,52.74102079395085
"Giddings city, Texas",2162,1827,335,48,29432,15.49491211840888
"Bruni CDP, Texas",174,105,69,48,10876,39.6551724137931
"Naples city, Texas",725,557,168,48,50316,23.17241379310345
"Crystal City city, Texas",2505,2234,271,48,18020,10.818363273453095
"La Pryor CDP, Texas",668,481,187,48,41452,27.994011976047904
"Lawn town, Texas",145,119,26,48,41872,17.93103448275862
"North Pearsall CDP, Texas",404,332,72,48,52302,17.82178217821782
"Jacksonville city, Texas",6114,5202,912,48,37216,14.91658488714426
"Rusk city, Texas",1492,1300,192,48,63848,12.868632707774799
"Troup city, Texas",782,628,154,48,73724,19.69309462915601
"Pantego town, Texas",1227,1135,92,48,55020,7.497962510187449
"Pelican Bay city, Texas",710,560,150,48,56640,21.12676056338028
"White Settlement city, Texas",6736,6378,358,48,78544,5.314726840855107
"Ector city, Texas",332,311,21,48,22516,6.325301204819277
"Leonard city, Texas",878,805,73,48,42352,8.314350797266515
"Moore Station city, Texas",141,100,41,48,49272,29.078014184397162
"Tool city, Texas",1640,975,665,48,73352,40.54878048780488
"Cuero city, Texas",2923,2488,435,48,18092,14.88197057817311
"Yorktown city, Texas",1009,692,317,48,80584,31.41724479682854
"Anthony town, Texas",1530,1450,80,48,03432,5.228758169934641
"Clint town, Texas",288,258,30,48,15544,10.416666666666668
"Fabens CDP, Texas",2042,1779,263,48,25032,12.879529872673851
"Vinton village, Texas",458,424,34,48,75668,7.423580786026202
"Newark city, Texas",403,373,30,48,50772,7.444168734491314
"Blue Mound city, Texas",1038,977,61,48,08860,5.8766859344894025
"Flower Mound town, Texas",24754,24033,721,48,26232,2.9126605801082657
"Lakeside town (Tarrant County), Texas",668,632,36,48,40744,5.389221556886228
"North Richland Hills city, Texas",27551,26051,1500,48,52356,5.444448477369242
"Rendon CDP, Texas",5304,4638,666,48,61568,12.55656108597285
"Kendleton city, Texas",170,146,24,48,38848,14.117647058823529
"Newton city, Texas",1102,812,290,48,51372,26.31578947368421
"Pinewood Estates CDP, Texas",639,588,51,48,57752,7.981220657276995
"Levelland city, Texas",5556,4763,793,48,42448,14.272858171346293
"Dalworthington Gardens city, Texas",902,856,46,48,19084,5.099778270509978
"Euless city, Texas",23710,21707,2003,48,24768,8.447912273302403
"Cumings CDP, Texas",583,583,0,48,18134,0.0
"Fulshear city, Texas",2490,2308,182,48,27876,7.309236947791165
"Orchard city, Texas",134,118,16,48,54192,11.940298507462686
"Richmond city, Texas",3984,3591,393,48,61892,9.864457831325302
"Simonton city, Texas",343,248,95,48,67964,27.696793002915456
"Stowell CDP, Texas",508,463,45,48,70520,8.858267716535433
"Alba town, Texas",282,255,27,48,01636,9.574468085106384
"South Toledo Bend CDP, Texas",700,199,501,48,69326,71.57142857142857
"Anton city, Texas",483,401,82,48,03540,16.977225672877847
"Normangee town, Texas",370,229,141,48,51840,38.108108108108105
"Blanco city, Texas",1047,837,210,48,08536,20.057306590257877
"Cedar Point CDP, Texas",573,327,246,48,13570,42.93193717277487
"Chaparrito CDP, Texas",42,42,0,48,14266,0.0
"Chapeno CDP, Texas",12,6,6,48,14290,50.0
"Chilton CDP, Texas",316,223,93,48,14692,29.430379746835445
"China Spring CDP, Texas",452,371,81,48,14740,17.920353982300885
"Chula Vista CDP (Cameron County), Texas",112,112,0,48,14880,0.0
"Chula Vista CDP (Maverick County), Texas",1327,1228,99,48,14881,7.46043707611153
"Chula Vista CDP (Zavala County), Texas",204,204,0,48,14882,0.0
"Colorado Acres CDP, Texas",68,26,42,48,16110,61.76470588235294
"Country Acres CDP, Texas",90,66,24,48,17236,26.666666666666668
"Delmita CDP, Texas",69,41,28,48,19732,40.57971014492754
"Del Sol CDP, Texas",20,20,0,48,19808,0.0
"D'Hanis CDP, Texas",369,285,84,48,20248,22.76422764227642
"Dorchester city, Texas",37,32,5,48,20932,13.513513513513514
"Driftwood CDP, Texas",38,38,0,48,21412,0.0
"East Alto Bonito CDP, Texas",227,195,32,48,21958,14.096916299559473
"Edgewater Estates CDP, Texas",39,39,0,48,22593,0.0
"El Brazil CDP, Texas",24,24,0,48,22853,0.0
"El Castillo CDP, Texas",26,26,0,48,22892,0.0
"El Cenizo CDP, Texas",41,41,0,48,22898,0.0
"El Chaparral CDP, Texas",100,90,10,48,22920,10.0
"Elias-Fela Solis CDP, Texas",8,8,0,48,23062,0.0
"El Mesquite CDP, Texas",0,0,0,48,23278,
"Elmo CDP, Texas",418,374,44,48,23356,10.526315789473683
"El Quiote CDP, Texas",76,76,0,48,24013,0.0
"El Rancho Vela CDP, Texas",100,100,0,48,24015,0.0
"El Socio CDP, Texas",21,10,11,48,24055,52.38095238095239
"Emerald Bay CDP, Texas",682,616,66,48,24158,9.67741935483871
"Eugenio Saenz CDP, Texas",60,60,0,48,24738,0.0
"Evergreen CDP, Texas",29,29,0,48,24894,0.0
"Fabrica CDP, Texas",374,245,129,48,25038,34.49197860962567
"Falconaire CDP, Texas",40,40,0,48,25338,0.0
"Falman CDP, Texas",8,8,0,48,25397,0.0
"Fannett CDP, Texas",1067,935,132,48,25404,12.371134020618557
"Fernando Salinas CDP, Texas",25,13,12,48,25744,48.0
"Fronton Ranchettes CDP, Texas",43,43,0,48,27748,0.0
"Flor del Rio CDP, Texas",51,51,0,48,26130,0.0
"Fort Clark Springs CDP, Texas",913,525,388,48,26680,42.49726177437021
"Four Points CDP, Texas",7,0,7,48,27124,100.0
"Gail CDP, Texas",136,89,47,48,27972,34.55882352941176
"Garciasville CDP, Texas",14,14,0,48,28152,0.0
"Garden City CDP, Texas",162,139,23,48,28176,14.19753086419753
"Garza-Salinas II CDP, Texas",146,146,0,48,29114,0.0
"Glidden CDP, Texas",296,217,79,48,29912,26.68918918918919
"Guthrie CDP, Texas",89,63,26,48,31640,29.213483146067414
"Gutierrez CDP, Texas",49,36,13,48,31646,26.53061224489796
"Hargill CDP, Texas",297,238,59,48,32300,19.865319865319865
"H. Cuellar Estates CDP, Texas",21,21,0,48,32910,0.0
"Hillside Acres CDP, Texas",0,0,0,48,34105,
"Hilltop CDP (Frio County), Texas",128,88,40,48,34130,31.25
"Hilltop CDP (Starr County), Texas",59,59,0,48,34133,0.0
"Hilltop Lakes CDP, Texas",474,386,88,48,34136,18.565400843881857
"Holiday Beach CDP, Texas",657,335,322,48,34478,49.01065449010654
"Holly Lake Ranch CDP, Texas",1840,1231,609,48,34586,33.09782608695652
"Hornsby Bend CDP, Texas",2306,2156,150,48,34856,6.504770164787511
"Horseshoe Bend CDP, Texas",553,287,266,48,34865,48.10126582278481
"Hull CDP, Texas",324,239,85,48,35324,26.234567901234566
"Iago CDP, Texas",105,57,48,48,35684,45.714285714285715
"Iglesia Antigua CDP, Texas",126,86,40,48,35754,31.746031746031743
"Indian Springs CDP, Texas",463,331,132,48,35954,28.509719222462206
"Indio CDP, Texas",0,0,0,48,35966,
"Ivanhoe city, Texas",913,566,347,48,37112,38.0065717415115
"Jardin de San Julian CDP, Texas",6,6,0,48,37390,0.0
"Juarez CDP, Texas",293,293,0,48,38168,0.0
"Kemp city, Texas",410,339,71,48,38788,17.317073170731707
"Coupland city, Texas",106,88,18,48,17312,16.9811320754717
"Guadalupe Guerra CDP, Texas",18,18,0,48,31442,0.0
"Lost Creek CDP, Texas",396,369,27,48,44162,6.8181818181818175
"Knollwood city, Texas",313,275,38,48,39680,12.140575079872203
"La Carla CDP, Texas",37,24,13,48,39994,35.13513513513514
"La Casita CDP, Texas",0,0,0,48,40000,
"La Chuparosa CDP, Texas",11,11,0,48,40018,0.0
"La Coma CDP, Texas",27,19,8,48,40100,29.629629629629626
"La Escondida CDP, Texas",90,44,46,48,40186,51.11111111111111
"La Esperanza CDP, Texas",23,23,0,48,40188,0.0
"Laguna Park CDP, Texas",1025,593,432,48,40312,42.146341463414636
"Lake Bryan CDP, Texas",631,530,101,48,40462,16.00633914421553
"Lake Cherokee CDP, Texas",1741,1105,636,48,40468,36.530729465824244
"Lake Colorado City CDP, Texas",734,167,567,48,40475,77.24795640326975
"Lake Dunlap CDP, Texas",835,747,88,48,40522,10.538922155688622
"Lake Medina Shores CDP, Texas",969,608,361,48,40674,37.254901960784316
"Fort Hancock CDP, Texas",600,387,213,48,26724,35.5
"Kennard city, Texas",174,109,65,48,38884,37.35632183908046
"Longview city, Texas",34634,30610,4024,48,43888,11.618640642143559
"White Oak city, Texas",2228,2110,118,48,78436,5.296229802513465
"Brackettville city, Texas",731,511,220,48,09868,30.095759233926128
"Galveston city, Texas",31780,20920,10860,48,28068,34.1724354940214
"La Presa CDP, Texas",147,64,83,48,41449,56.4625850340136
"Ranchos Penitas West CDP, Texas",324,246,78,48,60539,24.074074074074073
"Caldwell city, Texas",1685,1509,176,48,11836,10.445103857566766
"Bishop Hills town, Texas",120,112,8,48,08398,6.666666666666667
"Bandera city, Texas",467,318,149,48,05528,31.905781584582442
"Lakehills CDP, Texas",2819,1900,919,48,40576,32.600212841433134
"Cinco Ranch CDP, Texas",5875,5625,250,48,14929,4.25531914893617
"Miami city, Texas",224,180,44,48,47988,19.642857142857142
"Hemphill city, Texas",632,465,167,48,33188,26.424050632911396
"Pineland city, Texas",368,260,108,48,57644,29.347826086956523
"Jersey Village city, Texas",4146,3895,251,48,37612,6.054027978774722
"Southside Place city, Texas",582,541,41,48,69272,7.0446735395189
"Coyote Acres CDP, Texas",220,220,0,48,17426,0.0
"Knox City town, Texas",583,420,163,48,39700,27.958833619210978
"Paint Rock town, Texas",117,72,45,48,54636,38.46153846153847
"Clarendon city, Texas",924,701,223,48,15112,24.134199134199132
"Putnam town, Texas",46,37,9,48,59984,19.565217391304348
"Guerra CDP, Texas",0,0,0,48,31484,
"Ingram city, Texas",744,633,111,48,36032,14.919354838709678
"Moore CDP, Texas",157,132,25,48,49224,15.92356687898089
"Milam CDP, Texas",1108,573,535,48,48324,48.285198555956676
"Happy town, Texas",312,248,64,48,32156,20.51282051282051
"Buffalo Gap town, Texas",210,157,53,48,11128,25.238095238095237
"Potosi CDP, Texas",1129,1044,85,48,59108,7.528786536758194
"Alto town, Texas",597,462,135,48,02188,22.613065326633166
"Ranger city, Texas",1275,909,366,48,60632,28.705882352941174
"Comfort CDP, Texas",939,795,144,48,16228,15.335463258785943
"Forney city, Texas",6205,5970,235,48,26604,3.7872683319903304
"Oak Ridge town (Kaufman County), Texas",169,165,4,48,53160,2.366863905325444
"Rosser village, Texas",125,94,31,48,63404,24.8
"China city, Texas",455,424,31,48,14704,6.813186813186813
"Cut and Shoot city, Texas",451,419,32,48,18260,7.095343680709535
"Encantada-Ranchito-El Calaboz CDP, Texas",535,409,126,48,24223,23.551401869158877
"Lindsay city, Texas",449,444,5,48,42868,1.1135857461024499
"Lope�o CDP, Texas",47,33,14,48,43960,29.78723404255319
"Saline�o CDP, Texas",44,31,13,48,64316,29.545454545454547
"Talty town, Texas",739,671,68,48,71756,9.201623815967523
"Union Valley city, Texas",142,125,17,48,74372,11.971830985915492
"Relampago CDP, Texas",89,89,0,48,61532,0.0
"Lampasas city, Texas",3411,2901,510,48,41188,14.951627088830255
"Stanton city, Texas",880,775,105,48,70040,11.931818181818182
"Jolly city, Texas",91,80,11,48,37924,12.087912087912088
"Weinert city, Texas",148,95,53,48,77044,35.810810810810814
"Bacliff CDP, Texas",4062,3614,448,48,05180,11.029049729197439
"Tierra Grande CDP, Texas",99,99,0,48,72952,0.0
"Buna CDP, Texas",982,739,243,48,11236,24.745417515274948
"Evadale CDP, Texas",588,482,106,48,24840,18.027210884353742
"Laredo city, Texas",76283,69908,6375,48,41464,8.357038920860479
"Richland Springs town, Texas",207,110,97,48,61880,46.85990338164252
"Kress city, Texas",318,263,55,48,39904,17.29559748427673
"Merkel town, Texas",1267,1002,265,48,47796,20.91554853985793
"Denver City town, Texas",1721,1541,180,48,19984,10.459035444509006
"Gonzales city, Texas",2982,2626,356,48,30116,11.938296445338699
"Nixon city, Texas",978,867,111,48,51588,11.349693251533742
"Smiley city, Texas",231,200,31,48,68300,13.41991341991342
"Roaring Springs town, Texas",137,106,31,48,62528,22.62773722627737
"Prado Verde CDP, Texas",86,86,0,48,59210,0.0
"Colorado City city, Texas",2225,1512,713,48,16120,32.04494382022472
"Benbrook city, Texas",10238,9533,705,48,07552,6.886110568470405
"Fort Worth city, Texas",319650,291739,27911,48,27000,8.731737838260598
"Hico city, Texas",690,484,206,48,33548,29.855072463768117
"Johnson City city, Texas",846,760,86,48,37780,10.16548463356974
"Woodbranch city, Texas",633,537,96,48,80044,15.165876777251185
"Atlanta city, Texas",2765,2232,533,48,04516,19.276672694394215
"Texarkana city, Texas",16880,14114,2766,48,72368,16.386255924170616
"Morgan's Point city, Texas",128,112,16,48,49380,12.5
"Atascocita CDP, Texas",25575,24614,961,48,04462,3.7575757575757573
"Deer Park city, Texas",12076,11176,900,48,19624,7.452798940046374
"Jacinto City city, Texas",3468,3170,298,48,37156,8.592848904267589
"Seabrook city, Texas",5985,5474,511,48,66392,8.538011695906434
"Sheldon CDP, Texas",685,522,163,48,67376,23.795620437956206
"Gregory city, Texas",749,645,104,48,31064,13.885180240320427
"Mathis city, Texas",1862,1551,311,48,47040,16.702470461868955
"Wills Point city, Texas",1401,1195,206,48,79564,14.703783012134188
"Winona town, Texas",233,196,37,48,79828,15.879828326180256
"Cienegas Terrace CDP, Texas",1048,914,134,48,14927,12.786259541984732
"Austin city, Texas",404262,370043,34219,48,05000,8.46456011200657
"Carl's Corner town, Texas",93,75,18,48,12895,19.35483870967742
"Westway CDP, Texas",1101,1005,96,48,78016,8.71934604904632
"Bedford city, Texas",22250,21120,1130,48,07132,5.078651685393258
"Mullin town, Texas",50,36,14,48,49992,28.000000000000004
"Bremond city, Texas",591,418,173,48,10144,29.272419627749578
"Goldsmith city, Texas",134,115,19,48,30044,14.17910447761194
"Argyle city, Texas",1539,1476,63,48,03768,4.093567251461988
"Northlake town, Texas",1031,951,80,48,52212,7.75945683802134
"Glen Rose city, Texas",1283,1092,191,48,29876,14.886983632112235
"Zavalla city, Texas",358,280,78,48,80728,21.787709497206702
"Elbert CDP, Texas",6,6,0,48,22840,0.0
"San Isidro CDP, Texas",80,58,22,48,65432,27.500000000000004
"Los Indios town, Texas",339,271,68,48,44128,20.058997050147493
"Kanarraville town, Utah",145,127,18,49,40030,12.413793103448276
"Cannonville town, Utah",99,78,21,49,10330,21.21212121212121
"Panguitch city, Utah",781,567,214,49,57740,27.40076824583867
"Halls Crossing CDP, Utah",16,0,16,49,33027,100.0
"La Sal CDP, Utah",171,108,63,49,43110,36.84210526315789
"Mexican Hat CDP, Utah",14,0,14,49,49380,100.0
"Orderville town, Utah",235,183,52,49,57080,22.127659574468083
"Amalga town, Utah",172,167,5,49,01090,2.9069767441860463
"Newton town, Utah",254,235,19,49,54550,7.480314960629922
"Trenton town, Utah",162,143,19,49,77230,11.728395061728394
"Corinne city, Utah",258,233,25,49,15830,9.689922480620156
"Garland city, Utah",848,802,46,49,28150,5.4245283018867925
"Honeyville city, Utah",459,432,27,49,36290,5.88235294117647
"Perry city, Utah",1366,1329,37,49,59390,2.7086383601756956
"South Willard CDP, Utah",653,619,34,49,71255,5.206738131699847
"Willard city, Utah",623,571,52,49,84710,8.346709470304976
"Bountiful city, Utah",15034,14313,721,49,07690,4.7957961952906745
"South Weber city, Utah",2056,1962,94,49,71180,4.571984435797665
"Sunset city, Utah",1803,1691,112,49,74480,6.211869107043816
"Fillmore city, Utah",924,842,82,49,25510,8.874458874458876
"Kanosh town, Utah",225,176,49,49,40250,21.777777777777775
"Escalante city, Utah",530,327,203,49,23750,38.301886792452834
"Woodruff town, Utah",69,53,16,49,85260,23.18840579710145
"Montezuma Creek CDP, Utah",103,86,17,49,51470,16.50485436893204
"Cleveland town, Utah",226,187,39,49,14070,17.25663716814159
"Emery town, Utah",139,101,38,49,22870,27.33812949640288
"Big Water town, Utah",263,197,66,49,05534,25.09505703422053
"Joseph town, Utah",173,139,34,49,39370,19.653179190751445
"Monroe city, Utah",970,891,79,49,51360,8.144329896907216
"Millville city, Utah",589,571,18,49,50370,3.0560271646859083
"Nibley city, Utah",1739,1685,54,49,54660,3.105232892466935
"River Heights city, Utah",670,670,0,49,64120,0.0
"Snowville town, Utah",54,42,12,49,69970,22.22222222222222
"Fruit Heights city, Utah",1992,1888,104,49,27490,5.220883534136546
"White City CDP, Utah",1823,1823,0,49,84050,0.0
"Layton city, Utah",24574,23577,997,49,43660,4.0571335557906725
"Clinton city, Utah",6602,6353,249,49,14290,3.77158436837322
"West Jordan city, Utah",34085,33121,964,49,82950,2.8282235587501834
"Plymouth town, Utah",121,101,20,49,61260,16.528925619834713
"Woods Cross city, Utah",3535,3482,53,49,85370,1.4992927864214993
"Myton city, Utah",260,209,51,49,53340,19.615384615384617
"Green River city, Utah",456,294,162,49,31670,35.526315789473685
"Leamington town, Utah",102,91,11,49,43880,10.784313725490197
"Lynndyl town, Utah",53,38,15,49,46740,28.30188679245283
"Scipio town, Utah",173,129,44,49,67880,25.43352601156069
"Alta town, Utah",314,86,228,49,00650,72.61146496815286
"Kearns CDP, Utah",10086,9918,168,49,40470,1.665675193337299
"Levan town, Utah",355,297,58,49,44650,16.338028169014084
"Rocky Ridge town, Utah",166,158,8,49,64590,4.819277108433735
"Gunnison city, Utah",478,401,77,49,32660,16.10878661087866
"Mount Pleasant city, Utah",1218,1053,165,49,53010,13.546798029556651
"Minersville town, Utah",368,313,55,49,50590,14.945652173913043
"Samak CDP, Utah",329,165,164,49,67400,49.848024316109424
"Midvale city, Utah",13519,12412,1107,49,49710,8.188475478955544
"Milford city, Utah",661,557,104,49,50040,15.73373676248109
"Stockton town, Utah",280,258,22,49,73050,7.857142857142857
"Lyman town, Utah",155,116,39,49,46410,25.161290322580644
"Henefer town, Utah",281,255,26,49,34640,9.252669039145907
"Kamas city, Utah",741,698,43,49,39810,5.802968960863698
"Park City city, Utah",9826,3214,6612,49,58070,67.29086098107064
"Rockville town, Utah",202,138,64,49,64560,31.683168316831683
"Virgin town, Utah",249,194,55,49,80530,22.08835341365462
"Benjamin CDP, Utah",306,306,0,49,04720,0.0
"Draper city, Utah",14221,13542,679,49,20120,4.774629069685677
"Palmyra CDP, Utah",196,196,0,49,57630,0.0
"Santaquin city, Utah",2843,2830,13,49,67770,0.4572634540977841
"Wales town, Utah",99,83,16,49,80860,16.161616161616163
"Lake Shore CDP, Utah",256,251,5,49,42230,1.953125
"South Ogden city, Utah",6753,6200,553,49,70960,8.188953057900193
"West Mountain CDP, Utah",273,273,0,49,83252,0.0
"North Ogden city, Utah",6218,5872,346,49,55100,5.564490189771631
"Manila town, Utah",469,42,427,49,47620,91.04477611940298
"Mayfield town, Utah",186,144,42,49,48720,22.58064516129032
"East Carbon city, Utah",818,535,283,49,20890,34.59657701711492
"Wellington city, Utah",723,616,107,49,82510,14.79944674965422
"Circleville town, Utah",274,194,80,49,12970,29.1970802919708
"Murray city, Utah",20025,19014,1011,49,53230,5.048689138576779
"Dammeron Valley CDP, Utah",328,328,0,49,18090,0.0
"Deseret CDP, Utah",89,62,27,49,19020,30.337078651685395
"Echo CDP, Utah",50,17,33,49,21880,66.0
"Eden CDP, Utah",282,240,42,49,21990,14.893617021276595
"Emigration Canyon CDP, Utah",748,681,67,49,22875,8.957219251336898
"Enterprise CDP, Utah",215,215,0,49,23310,0.0
"Flaming Gorge CDP, Utah",133,31,102,49,25910,76.69172932330827
"Fremont CDP, Utah",122,86,36,49,27270,29.508196721311474
"Hoytsville CDP, Utah",182,151,31,49,36730,17.032967032967033
"Jensen CDP, Utah",43,43,0,49,39040,0.0
"Kenilworth CDP, Utah",168,143,25,49,41020,14.880952380952381
"Liberty CDP, Utah",549,407,142,49,44870,25.865209471766846
"Marion CDP, Utah",229,197,32,49,48170,13.973799126637553
"Mountain Green CDP, Utah",1052,976,76,49,52460,7.224334600760455
"Newcastle CDP, Utah",177,136,41,49,54330,23.163841807909606
"Oasis CDP, Utah",10,10,0,49,55760,0.0
"Silver Summit CDP, Utah",1689,1291,398,49,69280,23.564239194789817
"Peoa CDP, Utah",175,175,0,49,59280,0.0
"Pine Valley CDP, Utah",518,84,434,49,60270,83.78378378378379
"Randolph town, Utah",250,165,85,49,63020,34.0
"Snyderville CDP, Utah",4655,2601,2054,49,70190,44.12459720730397
"Spring Glen CDP, Utah",514,468,46,49,72060,8.949416342412452
"Summit CDP, Utah",111,111,0,49,74040,0.0
"Sutherland CDP, Utah",15,15,0,49,74590,0.0
"Teasdale CDP, Utah",76,49,27,49,75470,35.526315789473685
"Thatcher CDP, Utah",230,224,6,49,75800,2.608695652173913
"Thompson Springs CDP, Utah",58,24,34,49,76180,58.620689655172406
"Veyo CDP, Utah",170,170,0,49,80310,0.0
"Wanship CDP, Utah",172,172,0,49,81190,0.0
"West Wood CDP, Utah",231,231,0,49,83730,0.0
"Wolf Creek CDP, Utah",1234,546,688,49,84950,55.753646677471636
"Toquerville city, Utah",644,521,123,49,76900,19.099378881987576
"Magna CDP, Utah",8400,8076,324,49,47290,3.8571428571428568
"Sandy city, Utah",32107,30722,1385,49,67440,4.313701062073691
"Grantsville city, Utah",3261,3075,186,49,31120,5.703771849126035
"Tooele city, Utah",11314,10731,583,49,76680,5.15290790171469
"Loa town, Utah",242,175,67,49,45530,27.685950413223143
"La Verkin city, Utah",1448,1267,181,49,43440,12.5
"Syracuse city, Utah",7958,7702,256,49,74810,3.2168886654938422
"Duchesne city, Utah",746,658,88,49,20340,11.796246648793565
"Granite CDP, Utah",304,304,0,49,30900,0.0
"Salt Lake City city, Utah",84784,78229,6555,49,67000,7.7314115870919045
"Payson city, Utah",5811,5481,330,49,58730,5.678884873515746
"Heber city, Utah",4432,4287,145,49,34200,3.2716606498194944
"Centerfield town, Utah",498,449,49,49,11870,9.839357429718875
"Vernon town, Utah",124,97,27,49,80200,21.774193548387096
"Midway city, Utah",2487,1848,639,49,49820,25.69360675512666
"Wallsburg town, Utah",109,97,12,49,80970,11.009174311926607
"Salem city, Utah",2030,1977,53,49,65770,2.610837438423645
"Fountain Green city, Utah",424,386,38,49,26720,8.962264150943396
"Tabiona town, Utah",92,58,34,49,74920,36.95652173913043
"Spanish Fork city, Utah",10243,9924,319,49,71290,3.1143219759835987
"Logan city, Utah",18437,16895,1542,49,45860,8.363616640451268
"Spanish Valley CDP, Utah",188,167,21,49,71455,11.170212765957446
"Nephi city, Utah",2028,1948,80,49,54220,3.9447731755424065
"Fielding town, Utah",175,167,8,49,25290,4.571428571428571
"Castle Valley town, Utah",399,237,162,49,11000,40.6015037593985
"Garden CDP, Utah",795,92,703,49,27902,88.42767295597484
"Riverside CDP, Utah",291,291,0,49,64230,0.0
"Cedar City city, Utah",11630,10347,1283,49,11320,11.031814273430783
"Halchita CDP, Utah",94,69,25,49,33002,26.595744680851062
"Tropic town, Utah",262,195,67,49,77560,25.572519083969464
"Morgan city, Utah",1297,1278,19,49,51910,1.4649190439475714
"Bluff CDP, Utah",159,69,90,49,06700,56.60377358490566
"Navajo Mountain CDP, Utah",114,74,40,49,53890,35.08771929824561
"White Mesa CDP, Utah",87,64,23,49,84095,26.436781609195403
"Clawson town, Utah",86,67,19,49,13300,22.093023255813954
"Ferron city, Utah",657,556,101,49,25180,15.37290715372907
"Huntington city, Utah",866,716,150,49,36950,17.321016166281755
"Orangeville city, Utah",565,487,78,49,56860,13.805309734513274
"Alton town, Utah",70,36,34,49,00870,48.57142857142857
"Annabella town, Utah",261,249,12,49,01750,4.597701149425287
"Aurora city, Utah",313,304,9,49,02740,2.8753993610223643
"Glenwood town, Utah",210,183,27,49,29580,12.857142857142856
"Koosharem town, Utah",177,75,102,49,41680,57.6271186440678
"Mendon city, Utah",355,339,16,49,49160,4.507042253521127
"Richfield city, Utah",2827,2511,316,49,63570,11.177927131234524
"Benson CDP, Utah",535,479,56,49,05050,10.46728971962617
"Hyrum city, Utah",2333,2224,109,49,37500,4.672096013716246
"Providence city, Utah",2302,2294,8,49,62360,0.3475238922675934
"Wellsville city, Utah",1011,990,21,49,82620,2.0771513353115725
"Antimony town, Utah",102,47,55,49,01860,53.92156862745098
"Henrieville town, Utah",110,89,21,49,34750,19.090909090909093
"Blanding city, Utah",1171,969,202,49,06370,17.25021349274125
"Monticello city, Utah",876,692,184,49,51580,21.00456621004566
"Oljato-Monument Valley CDP, Utah",277,220,57,49,56440,20.577617328519857
"Tselakai Dezza CDP, Utah",51,27,24,49,77697,47.05882352941176
"Castle Dale city, Utah",585,493,92,49,10660,15.726495726495726
"Elmo town, Utah",149,125,24,49,22540,16.10738255033557
"Elsinore town, Utah",350,307,43,49,22650,12.285714285714286
"Avon CDP, Utah",103,81,22,49,02960,21.35922330097087
"Lewiston city, Utah",659,630,29,49,44760,4.400606980273141
"Smithfield city, Utah",3186,3032,154,49,69640,4.833647206528562
"Elwood town, Utah",347,309,38,49,22760,10.951008645533141
"Tremonton city, Utah",2690,2587,103,49,77120,3.8289962825278807
"Centerville city, Utah",5773,5555,218,49,11980,3.7761995496275764
"Aneth CDP, Utah",149,103,46,49,01530,30.87248322147651
"Kaysville city, Utah",8580,8491,89,49,40360,1.0372960372960374
"West Bountiful city, Utah",1849,1768,81,49,82840,4.380746349378042
"Roosevelt city, Utah",2527,2222,305,49,64670,12.069647803719825
"Moab city, Utah",2388,2086,302,49,50700,12.646566164154105
"Bluffdale city, Utah",3147,3024,123,49,06810,3.9084842707340326
"Holladay city, Utah",12016,11213,803,49,36070,6.682756324900133
"Hatch town, Utah",124,60,64,49,33760,51.61290322580645
"Sigurd town, Utah",204,200,4,49,68650,1.9607843137254901
"Eureka city, Utah",270,209,61,49,24080,22.59259259259259
"Manti city, Utah",1169,1083,86,49,47730,7.356715141146279
"Spring City city, Utah",486,400,86,49,71730,17.695473251028808
"New Harmony town, Utah",102,77,25,49,54440,24.509803921568626
"Summit Park CDP, Utah",3296,2905,391,49,74095,11.862864077669903
"Fort Duchesne CDP, Utah",268,161,107,49,26610,39.92537313432835
"Naples city, Utah",925,784,141,49,53560,15.243243243243242
"Springdale town, Utah",323,193,130,49,71840,40.24767801857585
"Junction town, Utah",79,34,45,49,39590,56.9620253164557
"Cedar Fort town, Utah",106,96,10,49,11430,9.433962264150944
"Spring Lake CDP, Utah",154,154,0,49,72170,0.0
"Ogden city, Utah",33346,30477,2869,49,55980,8.603730582378697
"Marysvale town, Utah",295,169,126,49,48610,42.71186440677966
"Sterling town, Utah",96,90,6,49,72940,6.25
"Coalville city, Utah",550,489,61,49,14840,11.090909090909092
"Oakley city, Utah",563,466,97,49,55650,17.2291296625222
"Rush Valley town, Utah",221,176,45,49,65240,20.361990950226243
"Vernal city, Utah",4377,3405,972,49,80090,22.206991089787525
"Torrey town, Utah",239,122,117,49,77010,48.95397489539749
"Hurricane city, Utah",6669,5765,904,49,37170,13.555255660518819
"Washington city, Utah",9961,8363,1598,49,81960,16.042566007428974
"Goshen town, Utah",355,338,17,49,30130,4.788732394366197
"Lindon city, Utah",2953,2812,141,49,45090,4.774805282763292
"Riverdale city, Utah",3427,3257,170,49,64010,4.960606944849723
"Plain City city, Utah",1942,1804,138,49,60710,7.106076210092688
"Highland city, Utah",4594,4344,250,49,35190,5.44188071397475
"Pleasant Grove city, Utah",11436,11040,396,49,60930,3.4627492130115427
"Timber Lakes CDP, Utah",985,266,719,49,76280,72.99492385786802
"Pleasant View city, Utah",2805,2723,82,49,61150,2.9233511586452763
"Washington Terrace city, Utah",3587,3246,341,49,82070,9.506551435740173
"Roy city, Utah",12527,12196,331,49,65110,2.642292647880578
"Scofield town, Utah",84,12,72,49,67990,85.71428571428571
"Helper city, Utah",1146,885,261,49,34530,22.774869109947645
"West Haven city, Utah",4129,3884,245,49,82930,5.933640106563332
"Kingston town, Utah",69,52,17,49,41350,24.637681159420293
"Riverton city, Utah",11560,11370,190,49,64340,1.6435986159169549
"South Jordan city, Utah",20827,20028,799,49,70850,3.836366255341624
"South Salt Lake city, Utah",9856,9245,611,49,71070,6.19926948051948
"West Valley City city, Utah",38894,37584,1310,49,83470,3.3681287602200856
"Dugway CDP, Utah",424,177,247,49,20450,58.25471698113207
"Stansbury Park CDP, Utah",2652,2639,13,49,72720,0.49019607843137253
"Richford CDP, Vermont",749,652,97,50,59050,12.950600801068092
"Fairfax CDP, Vermont",408,361,47,50,24850,11.519607843137255
"Northfield CDP, Vermont",816,769,47,50,50200,5.759803921568627
"Ascutney CDP, Vermont",234,208,26,50,01750,11.11111111111111
"Barnet CDP, Vermont",37,37,0,50,02800,0.0
"Beecher Falls CDP, Vermont",120,100,20,50,04150,16.666666666666664
"Benson CDP, Vermont",147,107,40,50,05125,27.2108843537415
"Bethel CDP, Vermont",300,272,28,50,05725,9.333333333333334
"Cambridge village, Vermont",115,97,18,50,11425,15.65217391304348
"Montpelier city, Vermont",4094,3726,368,50,46000,8.98876404494382
"Newbury village, Vermont",186,153,33,50,48100,17.741935483870968
"Lyndonville village, Vermont",740,642,98,50,41950,13.243243243243244
"Jeffersonville village, Vermont",337,319,18,50,36475,5.341246290801187
"Westminster village, Vermont",133,133,0,50,81325,0.0
"Springfield CDP, Vermont",1983,1823,160,50,69475,8.068582955118506
"Island Pond CDP, Vermont",575,358,217,50,35725,37.73913043478261
"Rutland city, Vermont",8122,7062,1060,50,61225,13.050972666830829
"Newport city, Vermont",2272,1887,385,50,48850,16.945422535211268
"Marshfield village, Vermont",130,103,27,50,43525,20.76923076923077
"Wells River village, Vermont",225,190,35,50,78025,15.555555555555555
"Bellows Falls village, Vermont",1494,1336,158,50,04225,10.575635876840696
"Newfane village, Vermont",85,65,20,50,48325,23.52941176470588
"Woodstock village, Vermont",716,620,96,50,85900,13.40782122905028
"Manchester village, Vermont",767,437,330,50,42700,43.02477183833116
"Brandon CDP, Vermont",672,602,70,50,07675,10.416666666666668
"Fair Haven CDP, Vermont",983,904,79,50,25450,8.036622583926754
"Poultney village, Vermont",572,488,84,50,56800,14.685314685314685
"Arlington CDP, Vermont",640,539,101,50,01375,15.78125
"Bennington CDP, Vermont",4075,3667,408,50,04750,10.012269938650306
"Manchester Center CDP, Vermont",1236,862,374,50,42925,30.258899676375407
"Jericho village, Vermont",605,582,23,50,36625,3.8016528925619832
"North Troy village, Vermont",360,310,50,50,52075,13.88888888888889
"Morrisville village, Vermont",1149,1020,129,50,46825,11.22715404699739
"West Brattleboro CDP, Vermont",1345,1211,134,50,78850,9.962825278810408
"Ludlow village, Vermont",716,382,334,50,41200,46.64804469273743
"Middlebury CDP, Vermont",2288,2093,195,50,44275,8.522727272727272
"Barre city, Vermont",4225,4031,194,50,03175,4.591715976331361
"West Burke village, Vermont",192,159,33,50,79150,17.1875
"Saxtons River village, Vermont",225,180,45,50,62950,20.0
"White River Junction CDP, Vermont",1309,1114,195,50,83575,14.896867838044308
"Albany village, Vermont",88,67,21,50,00400,23.863636363636363
"Derby Line village, Vermont",398,339,59,50,17500,14.824120603015075
"Wallingford CDP, Vermont",439,380,59,50,75850,13.439635535307518
"West Rutland CDP, Vermont",952,858,94,50,82375,9.873949579831933
"Orleans village, Vermont",401,363,38,50,53575,9.476309226932669
"Barton village, Vermont",434,290,144,50,03475,33.17972350230415
"Old Bennington village, Vermont",90,75,15,50,53125,16.666666666666664
"Johnson village, Vermont",553,506,47,50,37000,8.499095840867993
"Burlington city, Vermont",16979,16197,782,50,10675,4.605689381000059
"South Barre CDP, Vermont",541,480,61,50,66025,11.275415896487985
"Enosburg Falls village, Vermont",639,531,108,50,24025,16.901408450704224
"Swanton village, Vermont",1070,952,118,50,71650,11.02803738317757
"Jacksonville village, Vermont",126,94,32,50,36025,25.396825396825395
"Wilder CDP, Vermont",752,694,58,50,84025,7.712765957446808
"Essex Junction village, Vermont",4443,4264,179,50,24400,4.028809363042989
"Vergennes city, Vermont",1233,1163,70,50,74650,5.6772100567721
"Brattleboro CDP, Vermont",3581,3266,315,50,07975,8.796425579447082
"North Bennington village, Vermont",562,518,44,50,49075,7.829181494661921
"Winooski city, Vermont",3276,3164,112,50,85150,3.418803418803419
"South Shaftsbury CDP, Vermont",339,274,65,50,68200,19.174041297935105
"South Burlington city, Vermont",9017,8685,332,50,66175,3.6819341244316295
"Waterbury village, Vermont",798,772,26,50,76900,3.258145363408521
"Perkinsville village, Vermont",55,46,9,50,54850,16.363636363636363
"Hyde Park village, Vermont",208,198,10,50,34975,4.807692307692308
"St. Johnsbury CDP, Vermont",2938,2568,370,50,62125,12.59360108917631
"Canaan CDP, Vermont",202,148,54,50,11725,26.732673267326735
"Castleton CDP, Vermont",352,330,22,50,11875,6.25
"Cavendish CDP, Vermont",101,73,28,50,12175,27.722772277227726
"Chester CDP, Vermont",595,466,129,50,13600,21.680672268907564
"Concord CDP, Vermont",142,114,28,50,15175,19.718309859154928
"Coventry CDP, Vermont",25,25,0,50,16075,0.0
"Danville CDP, Vermont",173,173,0,50,17050,0.0
"Dorset CDP, Vermont",220,135,85,50,17650,38.63636363636363
"East Barre CDP, Vermont",335,259,76,50,19075,22.686567164179106
"East Burke CDP, Vermont",77,34,43,50,19600,55.84415584415584
"East Middlebury CDP, Vermont",237,237,0,50,21700,0.0
"East Montpelier CDP, Vermont",24,24,0,50,21850,0.0
"Fairlee CDP, Vermont",94,88,6,50,25600,6.382978723404255
"Glover CDP, Vermont",124,124,0,50,28000,0.0
"Graniteville CDP, Vermont",463,435,28,50,29425,6.047516198704104
"Greensboro CDP, Vermont",430,72,358,50,30100,83.25581395348837
"Greensboro Bend CDP, Vermont",87,71,16,50,30325,18.39080459770115
"Groton CDP, Vermont",185,153,32,50,30475,17.2972972972973
"Hardwick CDP, Vermont",641,453,188,50,31750,29.329173166926676
"Hartland CDP, Vermont",120,120,0,50,32350,0.0
"Irasburg CDP, Vermont",78,61,17,50,35500,21.794871794871796
"Lowell CDP, Vermont",108,78,30,50,40450,27.77777777777778
"St. Albans city, Vermont",3106,2763,343,50,61675,11.043142305215712
"Derby Center village, Vermont",298,271,27,50,17425,9.060402684563758
"Bradford CDP, Vermont",257,207,50,50,07225,19.45525291828794
"Milton CDP, Vermont",931,931,0,50,45175,0.0
"Bristol CDP, Vermont",831,831,0,50,08950,0.0
"Newport Center CDP, Vermont",158,143,15,50,49000,9.49367088607595
"North Hartland CDP, Vermont",71,71,0,50,50500,0.0
"North Springfield CDP, Vermont",310,310,0,50,51925,0.0
"Norwich CDP, Vermont",322,293,29,50,52825,9.006211180124224
"Pittsford CDP, Vermont",420,346,74,50,55525,17.61904761904762
"Plainfield CDP, Vermont",260,201,59,50,55750,22.692307692307693
"Proctorsville CDP, Vermont",387,178,209,50,57400,54.00516795865633
"Putney CDP, Vermont",288,277,11,50,57625,3.8194444444444446
"Quechee CDP, Vermont",409,80,329,50,57775,80.440097799511
"Randolph CDP, Vermont",1180,946,234,50,58000,19.830508474576273
"Shelburne CDP, Vermont",258,258,0,50,64225,0.0
"Readsboro CDP, Vermont",144,111,33,50,58525,22.916666666666664
"Richmond CDP, Vermont",251,229,22,50,59200,8.764940239043826
"Rochester CDP, Vermont",166,145,21,50,60025,12.650602409638553
"South Royalton CDP, Vermont",372,331,41,50,68050,11.021505376344086
"Stowe CDP, Vermont",380,233,147,50,70450,38.68421052631579
"Troy CDP, Vermont",31,15,16,50,73450,51.61290322580645
"Waitsfield CDP, Vermont",116,96,20,50,75250,17.24137931034483
"Websterville CDP, Vermont",220,194,26,50,77800,11.818181818181818
"Wells CDP, Vermont",246,159,87,50,77875,35.36585365853659
"Williamstown CDP, Vermont",562,514,48,50,84100,8.540925266903916
"Wilmington CDP, Vermont",237,166,71,50,84625,29.957805907172997
"Windsor CDP, Vermont",1023,901,122,50,85000,11.925708699902248
"Worcester CDP, Vermont",36,27,9,50,86050,25.0
"Hinesburg CDP, Vermont",376,376,0,50,33400,0.0
"Alburgh village, Vermont",390,263,127,50,00850,32.56410256410256
"North Westminster CDP, Vermont",138,110,28,50,52375,20.28985507246377
"Cabot CDP, Vermont",105,94,11,50,11050,10.476190476190476
"Chelsea CDP, Vermont",182,155,27,50,13450,14.835164835164836
"North Shore CDP, Virginia",3216,1395,1821,51,57531,56.623134328358205
"Glen Allen CDP, Virginia",6638,6336,302,51,31200,4.549563121422115
"Lakeside CDP, Virginia",5487,5185,302,51,43464,5.503918352469473
"Arlington CDP, Virginia",113084,104716,8368,51,03000,7.399808991546107
"Harrisonburg city, Virginia",18186,16768,1418,51,35624,7.797206642472232
"Rich Creek town, Virginia",367,312,55,51,66896,14.986376021798364
"Adwolf CDP, Virginia",738,683,55,51,00468,7.452574525745257
"Atkins CDP, Virginia",457,436,21,51,03512,4.595185995623632
"Jarratt town, Virginia",471,398,73,51,40536,15.498938428874734
"Newport News city, Virginia",77664,69324,8340,51,56000,10.738566131025957
"Edinburg town, Virginia",540,491,49,51,25008,9.074074074074074
"New Market town, Virginia",1021,992,29,51,55848,2.840352595494613
"Poquoson city, Virginia",4785,4615,170,51,63768,3.5527690700104495
"Scottsville town, Virginia",312,215,97,51,70800,31.08974358974359
"Burkeville town, Virginia",326,265,61,51,11560,18.711656441717793
"Alberta town, Virginia",201,151,50,51,00724,24.875621890547265
"Dungannon town, Virginia",197,140,57,51,23952,28.934010152284262
"Lynchburg city, Virginia",32364,28069,4295,51,47672,13.270918304288715
"Radford city, Virginia",6525,5438,1087,51,65392,16.659003831417625
"Lovettsville town, Virginia",802,772,30,51,47208,3.7406483790523692
"Phenix town, Virginia",113,99,14,51,61896,12.389380530973451
"Glen Lyn town, Virginia",55,37,18,51,31376,32.72727272727273
"Independence town, Virginia",633,524,109,51,39528,17.21958925750395
"Troutdale town, Virginia",102,92,10,51,79456,9.803921568627452
"Middleburg town, Virginia",411,338,73,51,51448,17.761557177615572
"Falls Church city, Virginia",5901,5262,639,51,27200,10.828673106253177
"Hillsboro town, Virginia",59,52,7,51,37288,11.864406779661017
"Purcellville town, Virginia",2993,2953,40,51,65008,1.3364517206815905
"Orange town, Virginia",1916,1793,123,51,59496,6.419624217118998
"Toms Brook town, Virginia",147,136,11,51,79024,7.482993197278912
"Fancy Gap CDP, Virginia",140,37,103,51,27296,73.57142857142858
"Boydton town, Virginia",142,121,21,51,09016,14.788732394366196
"Haymarket town, Virginia",533,495,38,51,35976,7.129455909943714
"Manassas city, Virginia",13583,12749,834,51,48952,6.140027976146654
"Fieldale CDP, Virginia",532,388,144,51,27744,27.06766917293233
"Bristol city, Virginia",8737,7402,1335,51,09816,15.279844340162526
"Floyd town, Virginia",274,237,37,51,28544,13.503649635036496
"Abingdon town, Virginia",4233,3842,391,51,00148,9.236947791164658
"Middletown town, Virginia",581,530,51,51,51512,8.777969018932874
"The Plains town, Virginia",107,92,15,51,78192,14.018691588785046
"Surry town, Virginia",147,117,30,51,76880,20.408163265306122
"Appalachia town, Virginia",821,618,203,51,02040,24.725943970767357
"Dayton town, Virginia",659,618,41,51,21648,6.22154779969651
"Drakes Branch town, Virginia",291,224,67,51,23376,23.02405498281787
"Fincastle town, Virginia",175,149,26,51,27824,14.857142857142858
"Stephens City town, Virginia",882,778,104,51,75344,11.791383219954648
"Timberville town, Virginia",1146,1070,76,51,78736,6.631762652705062
"Staunton city, Virginia",11814,10520,1294,51,75216,10.953106483832741
"Charlotte Court House town, Virginia",260,216,44,51,14952,16.923076923076923
"Fairfax city, Virginia",8906,8553,353,51,26496,3.963620031439479
"Virginia Beach city, Virginia",183906,169290,14616,51,82000,7.947538416364883
"Lexington city, Virginia",2312,1984,328,51,45512,14.186851211072666
"Bassett CDP, Virginia",626,428,198,51,04872,31.629392971246006
"Oak Level CDP, Virginia",383,348,35,51,58312,9.138381201044385
"Ridgeway town, Virginia",436,389,47,51,67208,10.77981651376147
"Courtland town, Virginia",743,688,55,51,19600,7.402422611036339
"Smithfield town, Virginia",3566,3236,330,51,73200,9.254066180594505
"Dahlgren Center CDP, Virginia",198,177,21,51,21016,10.606060606060606
"Dante CDP, Virginia",560,278,282,51,21312,50.357142857142854
"Deep Creek CDP, Virginia",57,13,44,51,21776,77.19298245614034
"Deerfield CDP, Virginia",57,57,0,51,21872,0.0
"Deltaville CDP, Virginia",1127,466,661,51,22064,58.651286601597164
"Dranesville CDP, Virginia",3949,3802,147,51,23392,3.7224613826285133
"Draper CDP, Virginia",167,126,41,51,23408,24.550898203592812
"Dulles Town Center CDP, Virginia",2034,1869,165,51,23732,8.112094395280236
"East Lexington CDP, Virginia",490,429,61,51,24544,12.448979591836734
"Ebony CDP, Virginia",176,93,83,51,24816,47.159090909090914
"Elliston CDP, Virginia",393,252,141,51,25488,35.87786259541985
"Emory CDP, Virginia",279,248,31,51,25792,11.11111111111111
"Enon CDP, Virginia",1737,1578,159,51,25877,9.153713298791018
"Esmont CDP, Virginia",291,267,24,51,25968,8.24742268041237
"Fairfax Station CDP, Virginia",4029,3917,112,51,26592,2.7798461156614542
"Fair Lakes CDP, Virginia",3306,3154,152,51,26701,4.597701149425287
"Fair Oaks CDP, Virginia",14825,14160,665,51,26875,4.485666104553119
"Fairview CDP, Virginia",114,36,78,51,26944,68.42105263157895
"Flint Hill CDP, Virginia",206,177,29,51,28496,14.077669902912621
"Floris CDP, Virginia",2681,2652,29,51,28528,1.081685938082805
"Franklin Farm CDP, Virginia",6038,5989,49,51,29628,0.8115269956939384
"Free Union CDP, Virginia",87,87,0,51,29840,0.0
"Gargatha CDP, Virginia",121,83,38,51,30384,31.40495867768595
"Gasburg CDP, Virginia",619,232,387,51,30480,62.52019386106623
"George Mason CDP, Virginia",1732,1670,62,51,30618,3.5796766743648964
"Glenvar CDP, Virginia",455,405,50,51,31488,10.989010989010989
"Goochland CDP, Virginia",295,273,22,51,31808,7.457627118644068
"Gratton CDP, Virginia",419,419,0,51,32320,0.0
"Greenbackville CDP, Virginia",97,0,97,51,32560,100.0
"Greenbriar CDP, Virginia",3174,3021,153,51,32592,4.8204158790170135
"Greenbush CDP, Virginia",96,76,20,51,32624,20.833333333333336
"Gwynn CDP, Virginia",540,193,347,51,33824,64.25925925925927
"Hampden-Sydney CDP, Virginia",168,149,19,51,34304,11.30952380952381
"Hanover CDP, Virginia",116,99,17,51,35160,14.655172413793101
"Harborton CDP, Virginia",155,68,87,51,35240,56.12903225806451
"Harriston CDP, Virginia",550,550,0,51,35640,0.0
"Hayfield CDP, Virginia",1499,1474,25,51,35912,1.6677785190126753
"Heathsville CDP, Virginia",98,63,35,51,36216,35.714285714285715
"Horntown CDP, Virginia",752,170,582,51,38504,77.3936170212766
"Henry Fork CDP, Virginia",665,514,151,51,36445,22.706766917293233
"Hiwassee CDP, Virginia",252,165,87,51,37544,34.523809523809526
"Hollymead CDP, Virginia",3248,3118,130,51,38032,4.002463054187192
"Hot Springs CDP, Virginia",592,263,329,51,38632,55.57432432432432
"Independent Hill CDP, Virginia",2755,2749,6,51,39544,0.21778584392014522
"Innsbrook CDP, Virginia",3395,3201,194,51,39920,5.714285714285714
"Ivanhoe CDP, Virginia",284,162,122,51,40216,42.95774647887324
"Ivy CDP, Virginia",186,148,38,51,40248,20.43010752688172
"King and Queen Court House CDP, Virginia",83,83,0,51,42536,0.0
"King George CDP, Virginia",1790,1645,145,51,42568,8.100558659217876
"Kings Park CDP, Virginia",1520,1474,46,51,42664,3.026315789473684
"Kings Park West CDP, Virginia",4417,4340,77,51,42680,1.7432646592709984
"Kingstowne CDP, Virginia",7016,6836,180,51,42746,2.565564424173318
"King William CDP, Virginia",115,115,0,51,42792,0.0
"Lafayette CDP, Virginia",347,347,0,51,43224,0.0
"Lake Caroline CDP, Virginia",1049,816,233,51,43359,22.21163012392755
"Lake Holiday CDP, Virginia",766,749,17,51,43392,2.219321148825065
"Lake Land'Or CDP, Virginia",1557,1473,84,51,43420,5.394990366088632
"Lake of the Woods CDP, Virginia",3744,3288,456,51,43430,12.179487179487179
"Lake Wilderness CDP, Virginia",884,817,67,51,43600,7.579185520361991
"Lansdowne CDP, Virginia",4750,4539,211,51,44048,4.442105263157894
"Laurel Hill CDP, Virginia",2806,2664,142,51,44430,5.0605844618674265
"Lee Mont CDP, Virginia",37,17,20,51,44952,54.054054054054056
"Long Branch CDP, Virginia",2826,2745,81,51,46760,2.8662420382165608
"Loudoun Valley Estates CDP, Virginia",2250,2145,105,51,47136,4.666666666666667
"Lovingston CDP, Virginia",239,239,0,51,47224,0.0
"Lowes Island CDP, Virginia",3598,3531,67,51,47296,1.8621456364647027
"Lunenburg CDP, Virginia",83,83,0,51,47496,0.0
"McMullin CDP, Virginia",224,202,22,51,48445,9.821428571428571
"McNair CDP, Virginia",8286,7725,561,51,48450,6.770456191165822
"Makemie Park CDP, Virginia",115,115,0,51,48776,0.0
"Manchester CDP, Virginia",4875,4500,375,51,48996,7.6923076923076925
"Mappsburg CDP, Virginia",33,33,0,51,49320,0.0
"Mappsville CDP, Virginia",166,126,40,51,49336,24.096385542168676
"Marshall CDP, Virginia",631,598,33,51,49656,5.229793977812995
"Marumsco CDP, Virginia",13280,12192,1088,51,49792,8.19277108433735
"Mason Neck CDP, Virginia",806,756,50,51,49998,6.20347394540943
"Massanetta Springs CDP, Virginia",2301,2222,79,51,50020,3.43328987396784
"Mathews CDP, Virginia",348,313,35,51,50104,10.057471264367816
"Maurertown CDP, Virginia",384,384,0,51,50200,0.0
"Meadowbrook CDP, Virginia",7301,6809,492,51,50568,6.73880290371182
"Meadow View CDP, Virginia",503,468,35,51,50776,6.958250497017893
"Metompkin CDP, Virginia",307,213,94,51,51362,30.618892508143325
"Middlebrook CDP, Virginia",36,17,19,51,51432,52.77777777777778
"Midland CDP, Virginia",81,27,54,51,51544,66.66666666666666
"Modest Town CDP, Virginia",97,97,0,51,52408,0.0
"Montvale CDP, Virginia",346,227,119,51,52968,34.39306358381503
"Moorefield Station CDP, Virginia",642,603,39,51,53031,6.074766355140187
"Motley CDP, Virginia",476,421,55,51,53480,11.554621848739496
"Mountain Road CDP, Virginia",472,394,78,51,53584,16.52542372881356
"West Falls Church CDP, Virginia",10471,10081,390,51,84368,3.7245726291662686
"Lancaster CDP, Virginia",31,31,0,51,43704,0.0
"Pantops CDP, Virginia",2100,1868,232,51,60512,11.047619047619047
"Powhatan CDP, Virginia",205,205,0,51,64384,0.0
"Bedford town, Virginia",2888,2493,395,51,05544,13.677285318559557
"Southampton Meadows CDP, Virginia",209,152,57,51,73624,27.27272727272727
"Buchanan town, Virginia",619,529,90,51,10744,14.539579967689823
"Cloverdale CDP, Virginia",1445,1364,81,51,17680,5.6055363321799305
"Onancock town, Virginia",852,615,237,51,59336,27.816901408450708
"Onley town, Virginia",358,298,60,51,59384,16.75977653631285
"Daleville CDP, Virginia",1350,1350,0,51,21152,0.0
"Santa Clara city, Texas",279,268,11,48,65690,3.942652329749104
"Edcouch city, Texas",1219,1018,201,48,22528,16.488925348646433
"Granjeno city, Texas",136,116,20,48,30608,14.705882352941178
"Llano Grande CDP, Texas",1155,713,442,48,43150,38.268398268398265
"Doffing CDP, Texas",1396,1214,182,48,20734,13.03724928366762
"Faysville CDP, Texas",0,0,0,48,25656,
"San Carlos CDP, Texas",1108,912,196,48,65048,17.689530685920577
"Scissors CDP, Texas",907,855,52,48,66248,5.733186328555679
"Wellman city, Texas",105,81,24,48,77164,22.857142857142858
"Lometa city, Texas",331,196,135,48,43516,40.78549848942598
"Cottonwood Shores city, Texas",606,442,164,48,17208,27.062706270627064
"Meadowlakes city, Texas",1073,969,104,48,47330,9.692451071761417
"Brownsboro city, Texas",464,379,85,48,10756,18.318965517241377
"Malakoff city, Texas",1087,945,142,48,46224,13.063477460901565
"Star Harbor city, Texas",330,189,141,48,70076,42.72727272727273
"Yoakum city, Texas",2620,2245,375,48,80560,14.31297709923664
"Texas City city, Texas",19602,16875,2727,48,72392,13.911845730027547
"Deweyville CDP, Texas",498,289,209,48,20212,41.967871485943775
"Decatur city, Texas",2641,2480,161,48,19528,6.096175691026127
"Wallis city, Texas",672,585,87,48,76240,12.946428571428573
"Alvin city, Texas",10199,9291,908,48,02272,8.902833611138346
"Brownfield city, Texas",3546,3000,546,48,10720,15.397631133671744
"Beasley city, Texas",243,210,33,48,06272,13.580246913580247
"Kountze city, Texas",872,697,175,48,39868,20.068807339449542
"Eustace city, Texas",483,376,107,48,24828,22.15320910973085
"Murchison city, Texas",232,195,37,48,50076,15.948275862068966
"Fort Bliss CDP, Texas",2083,1760,323,48,26664,15.506481036965914
"Sparks CDP, Texas",1180,1060,120,48,69432,10.16949152542373
"Tornillo CDP, Texas",356,295,61,48,73376,17.134831460674157
"Bloomington CDP, Texas",855,661,194,48,08800,22.690058479532162
"Malone town, Texas",128,82,46,48,46260,35.9375
"Penelope town, Texas",71,56,15,48,56672,21.12676056338028
"Goldthwaite city, Texas",1013,788,225,48,30056,22.211253701875616
"McCamey city, Texas",962,762,200,48,45432,20.79002079002079
"Plainview city, Texas",8386,7054,1332,48,57980,15.883615549725732
"Quanah city, Texas",1363,1030,333,48,60044,24.43140132061629
"Everman city, Texas",2163,1943,220,48,24912,10.171058714748035
"Nordheim city, Texas",148,108,40,48,51792,27.027027027027028
"Homestead Meadows South CDP, Texas",1920,1673,247,48,34673,12.864583333333332
"Colleyville city, Texas",9067,8903,164,48,15988,1.8087570309915078
"Haslet city, Texas",594,556,38,48,32720,6.397306397306397
"Watauga city, Texas",7893,7732,161,48,76672,2.0397820853921194
"Moulton town, Texas",495,388,107,48,49560,21.616161616161616
"Morales-Sanchez CDP, Texas",52,20,32,48,49314,61.53846153846154
"Georgetown city, Texas",27026,25649,1377,48,29336,5.0950936135573155
"Hutto city, Texas",7467,7043,424,48,35624,5.678317932235168
"Alamo Heights city, Texas",3703,3151,552,48,01600,14.906832298136646
"Leakey city, Texas",266,191,75,48,42004,28.195488721804512
"Shavano Park city, Texas",1304,1217,87,48,67268,6.671779141104295
"Overton city, Texas",1082,888,194,48,54432,17.929759704251385
"Fronton CDP, Texas",81,67,14,48,27744,17.28395061728395
"Las Lomas CDP, Texas",739,665,74,48,41566,10.013531799729364
"Borger city, Texas",6242,4298,1944,48,09556,31.143864146107013
"Lorenzo city, Texas",452,373,79,48,44032,17.47787610619469
"Hutchins city, Texas",1227,1158,69,48,35612,5.623471882640587
"Round Mountain town, Texas",123,98,25,48,63476,20.32520325203252
"Boyd town, Texas",542,477,65,48,09748,11.992619926199263
"Addison town, Texas",9856,8689,1167,48,01240,11.840503246753247
"Irving city, Texas",90770,84772,5998,48,37000,6.607910102456758
"Lancaster city, Texas",14046,13177,869,48,41212,6.186814751530685
"Seagoville city, Texas",4415,4219,196,48,66428,4.439411098527747
"Menard city, Texas",1042,697,345,48,47628,33.10940499040307
"Point Comfort city, Texas",385,288,97,48,58568,25.19480519480519
"Lyford city, Texas",819,719,100,48,45228,12.21001221001221
"Ranchette Estates CDP, Texas",46,46,0,48,60458,0.0
"Mission Bend CDP, Texas",11308,10836,472,48,48772,4.1740360806508665
"Missouri City city, Texas",25258,24417,841,48,48804,3.3296381344524506
"Nassau Bay city, Texas",2146,1832,314,48,50376,14.631873252562908
"Piney Point Village city, Texas",1254,1195,59,48,57800,4.704944178628389
"Shoreacres city, Texas",664,596,68,48,67688,10.240963855421686
"Llano city, Texas",1386,1023,363,48,43144,26.190476190476193
"Harper CDP, Texas",574,384,190,48,32456,33.10104529616725
"Estelline town, Texas",73,49,24,48,24636,32.87671232876712
"Patton Village city, Texas",557,451,106,48,56156,19.03052064631957
"Webberville village, Texas",153,139,14,48,76924,9.15032679738562
"Westworth Village city, Texas",1253,1140,113,48,78076,9.018355945730248
"Bartonville town, Texas",618,581,37,48,05768,5.9870550161812295
"Annetta North town, Texas",242,225,17,48,03340,7.024793388429752
"Pleasanton city, Texas",4154,3570,584,48,58280,14.058738565238324
"Fairchilds village, Texas",306,297,9,48,25068,2.941176470588235
"Sour Lake city, Texas",912,789,123,48,68828,13.486842105263158
"Quitman city, Texas",927,813,114,48,60188,12.297734627831716
"Midway South CDP, Texas",645,611,34,48,48280,5.271317829457364
"Kempner city, Texas",511,386,125,48,38800,24.46183953033268
"Payne Springs town, Texas",424,320,104,48,56276,24.528301886792452
"Taft Southwest CDP, Texas",395,312,83,48,71696,21.012658227848103
"Spade CDP, Texas",48,48,0,48,69380,0.0
"Woodville town, Texas",1321,1011,310,48,80212,23.467070401211203
"Airport Road Addition CDP, Texas",75,47,28,48,01514,37.333333333333336
"Eureka city, Texas",145,128,17,48,24816,11.724137931034482
"Joaquin city, Texas",460,373,87,48,37684,18.913043478260867
"Refugio town, Texas",1347,1019,328,48,61436,24.35040831477357
"Cantu Addition CDP, Texas",64,23,41,48,12502,64.0625
"Red Oak city, Texas",4235,3995,240,48,61196,5.667060212514758
"Toyah town, Texas",49,27,22,48,73496,44.89795918367347
"Kermit city, Texas",2524,2184,340,48,39004,13.47068145800317
"Sanderson CDP, Texas",663,338,325,48,65084,49.01960784313725
"Reklaw city, Texas",180,140,40,48,61508,22.22222222222222
"Cushing city, Texas",310,237,73,48,18224,23.548387096774192
"Dickinson city, Texas",8849,7604,1245,48,20344,14.069386371341395
"Pearsall city, Texas",2929,2423,506,48,56384,17.275520655513827
"Evant town, Texas",228,191,37,48,24864,16.228070175438596
"Andrews city, Texas",4753,4224,529,48,03216,11.129812749842205
"Groom town, Texas",316,281,35,48,31292,11.075949367088606
"Skellytown town, Texas",307,189,118,48,68120,38.43648208469055
"Wells town, Texas",321,270,51,48,77176,15.887850467289718
"Bartlett city, Texas",536,453,83,48,05732,15.485074626865671
"Granger city, Texas",493,433,60,48,30548,12.170385395537526
"Taylor city, Texas",6216,5732,484,48,71948,7.786357786357787
"Cibolo city, Texas",8691,8435,256,48,14920,2.945575883097457
"St. Hedwig town, Texas",677,604,73,48,64172,10.782865583456426
"Scenic Oaks CDP, Texas",2056,1799,257,48,66089,12.5
"Flowella CDP, Texas",34,21,13,48,26220,38.23529411764706
"Mount Enterprise city, Texas",235,205,30,48,49728,12.76595744680851
"Amherst city, Texas",362,271,91,48,03084,25.13812154696133
"Megargel town, Texas",154,113,41,48,47460,26.623376623376622
"La Ward city, Texas",97,72,25,48,41848,25.773195876288657
"Sanford town, Texas",73,44,29,48,65384,39.726027397260275
"Vanderbilt CDP, Texas",199,104,95,48,74984,47.73869346733669
"Richland Hills city, Texas",3398,3069,329,48,61844,9.682165979988229
"Alpine city, Texas",3404,2615,789,48,02104,23.1786133960047
"Edmonson town, Texas",41,22,19,48,22708,46.34146341463415
"Chillicothe city, Texas",400,269,131,48,14680,32.75
"Wyldwood CDP, Texas",867,811,56,48,80350,6.459054209919262
"Tuscola city, Texas",312,286,26,48,74048,8.333333333333332
"Bigfoot CDP, Texas",152,152,0,48,08164,0.0
"Seagraves city, Texas",896,771,125,48,66440,13.950892857142858
"Seminole city, Texas",2652,2389,263,48,66764,9.917043740573153
"Waelder city, Texas",497,410,87,48,76024,17.50503018108652
"Matador town, Texas",425,281,144,48,47004,33.88235294117647
"Thrall city, Texas",250,202,48,48,72824,19.2
"Camp Wood city, Texas",353,272,81,48,12388,22.946175637393768
"Hill Country Village city, Texas",241,228,13,48,33968,5.394190871369295
"Kirby city, Texas",3264,3102,162,48,39448,4.963235294117647
"Lackland AFB CDP, Texas",471,402,69,48,40036,14.64968152866242
"Santa Anna town, Texas",541,421,120,48,65672,22.181146025878004
"Haltom City city, Texas",15423,14288,1135,48,31928,7.359138948323932
"Balcones Heights city, Texas",1633,1435,198,48,05384,12.124923453766074
"Castle Hills city, Texas",1979,1694,285,48,13276,14.401212733703892
"Grey Forest city, Texas",210,202,8,48,31100,3.8095238095238098
"Windcrest city, Texas",2466,2137,329,48,79672,13.341443633414437
"Coldspring city, Texas",365,283,82,48,15892,22.465753424657535
"Garceno CDP, Texas",144,144,0,48,28128,0.0
"New Boston city, Texas",2274,1788,486,48,50808,21.372031662269126
"El Lago city, Texas",1114,994,120,48,23164,10.771992818671453
"Rio Hondo city, Texas",1092,911,181,48,62180,16.575091575091573
"Olney city, Texas",1576,1269,307,48,54000,19.47969543147208
"Lozano CDP, Texas",47,47,0,48,44344,0.0
"Primera town, Texas",1566,1324,242,48,59540,15.453384418901662
"Rancho Viejo town, Texas",1471,1034,437,48,60544,29.707681849082256
"Villa Pancho CDP, Texas",108,108,0,48,75614,0.0
"Liberty city, Texas",3565,3146,419,48,42568,11.753155680224404
"Plum Grove city, Texas",255,211,44,48,58448,17.254901960784313
"Gunter city, Texas",398,353,45,48,31616,11.306532663316583
"Big Sandy town, Texas",707,617,90,48,08224,12.729844413012732
"Nevada city, Texas",295,270,25,48,50760,8.47457627118644
"Princeton city, Texas",3488,3275,213,48,59576,6.1066513761467895
"Nacogdoches city, Texas",14146,12063,2083,48,50256,14.725010603704227
"Lakeshore Gardens-Hidden Acres CDP, Texas",466,291,175,48,40714,37.553648068669524
"St. Paul CDP, Texas",261,182,79,48,64244,30.268199233716476
"Sterling City city, Texas",463,377,86,48,70232,18.57451403887689
"Falcon Lake Estates CDP, Texas",623,314,309,48,25348,49.59871589085072
"Cranfills Gap city, Texas",186,154,32,48,17540,17.20430107526882
"Morgan city, Texas",227,168,59,48,49356,25.991189427312776
"Italy town, Texas",769,648,121,48,37072,15.734720416124837
"Rose City city, Texas",226,161,65,48,63200,28.761061946902654
"Graford city, Texas",244,211,33,48,30380,13.524590163934427
"Presidio city, Texas",2021,1514,507,48,59396,25.086590796635328
"Redford CDP, Texas",66,17,49,48,61076,74.24242424242425
"Austwell city, Texas",114,64,50,48,05036,43.859649122807014
"Scotland city, Texas",162,142,20,48,66284,12.345679012345679
"Prairie View city, Texas",1092,793,299,48,59336,27.380952380952383
"Electra city, Texas",1765,1322,443,48,22984,25.09915014164306
"Iowa Park city, Texas",2632,2469,163,48,36104,6.193009118541033
"Windthorst town, Texas",172,148,24,48,79696,13.953488372093023
"Hereford city, Texas",5455,4931,524,48,33320,9.605866177818514
"Damon CDP, Texas",144,111,33,48,19108,22.916666666666664
"Brookshire city, Texas",1599,1445,154,48,10636,9.631019387116948
"Pleasant Valley town, Texas",160,135,25,48,58400,15.625
"Cleburne city, Texas",11793,10915,878,48,15364,7.445094547612991
"Grandview city, Texas",807,734,73,48,30512,9.045848822800496
"Fritch city, Texas",1114,796,318,48,27696,28.545780969479356
"Deport city, Texas",336,285,51,48,20020,15.178571428571427
"Wharton city, Texas",3854,3309,545,48,78136,14.14115204981837
"Bangs city, Texas",706,608,98,48,05552,13.881019830028329
"Anderson city, Texas",121,109,12,48,03192,9.917355371900827
"Groves city, Texas",6648,5992,656,48,31328,9.8676293622142
"Los Alvarez CDP, Texas",83,55,28,48,44044,33.734939759036145
"North Escobares CDP, Texas",40,40,0,48,52068,0.0
"Rio Grande City city, Texas",4959,4102,857,48,62168,17.281710022181894
"Hamlin city, Texas",951,711,240,48,31964,25.236593059936908
"Odessa city, Texas",44608,40319,4289,48,53388,9.614867288378766
"West Odessa CDP, Texas",8422,7524,898,48,77728,10.662550463072904
"Petersburg city, Texas",513,367,146,48,56996,28.460038986354775
"Seth Ward CDP, Texas",866,584,282,48,66848,32.5635103926097
"Tulsita CDP, Texas",8,0,8,48,73904,100.0
"Annetta town, Texas",996,969,27,48,03336,2.710843373493976
"Sanctuary town, Texas",109,99,10,48,65066,9.174311926605505
"Dickens city, Texas",151,99,52,48,20332,34.437086092715234
"Henrietta city, Texas",1370,1148,222,48,33284,16.204379562043798
"O'Brien city, Texas",77,43,34,48,53304,44.15584415584416
"Coyanosa CDP, Texas",70,70,0,48,17408,0.0
"Point city, Texas",345,305,40,48,58532,11.594202898550725
"New Waverly city, Texas",521,407,114,48,51396,21.8809980806142
"Big Lake city, Texas",1124,985,139,48,08212,12.366548042704627
"New Falcon CDP, Texas",150,104,46,48,50924,30.666666666666664
"Realitos CDP, Texas",166,111,55,48,60932,33.13253012048193
"Eldorado city, Texas",1012,853,159,48,22960,15.711462450592887
"Mineral Wells city, Texas",6167,5020,1147,48,48684,18.598994648937893
"Las Lomitas CDP, Texas",89,39,50,48,41569,56.17977528089888
"Quitaque city, Texas",278,173,105,48,60176,37.76978417266187
"South Mountain town, Texas",193,164,29,48,69120,15.025906735751295
"Garden Ridge city, Texas",1442,1422,20,48,28248,1.3869625520110958
"Mertens town, Texas",74,59,15,48,47820,20.27027027027027
"Mount Calm city, Texas",143,117,26,48,49692,18.181818181818183
"Whitney town, Texas",883,763,120,48,78664,13.590033975084935
"Mason city, Texas",1110,815,295,48,46968,26.576576576576578
"Rankin city, Texas",392,348,44,48,60668,11.224489795918368
"Lakeside City town, Texas",434,415,19,48,40756,4.377880184331797
"Cooper city, Texas",971,814,157,48,16564,16.168898043254377
"Geronimo CDP, Texas",350,270,80,48,29384,22.857142857142858
"Alamo city, Texas",7678,5901,1777,48,01576,23.144047929148215
"Edinburg city, Texas",29376,26603,2773,48,22660,9.439678649237472
"La Blanca CDP, Texas",670,565,105,48,39988,15.671641791044777
"Laguna Seca CDP, Texas",84,77,7,48,40320,8.333333333333332
"Midway North CDP, Texas",1247,1144,103,48,48272,8.2598235765838
"Penitas city, Texas",1444,1238,206,48,56696,14.265927977839334
"Progreso Lakes city, Texas",112,95,17,48,59642,15.178571428571427
"Mont Belvieu city, Texas",2173,1974,199,48,49068,9.157846295444086
"Zuehl CDP, Texas",122,122,0,48,80836,0.0
"Silsbee city, Texas",3091,2550,541,48,67832,17.502426399223552
"Marquez city, Texas",140,119,21,48,46752,15.0
"Redwood CDP, Texas",1141,1044,97,48,61352,8.501314636283961
"Palmview South CDP, Texas",2247,1734,513,48,54810,22.83044058744993
"Meadow town, Texas",260,231,29,48,47316,11.153846153846155
"Copperas Cove city, Texas",13963,12300,1663,48,16624,11.910047983957602
"Pittsburg city, Texas",1809,1549,260,48,57908,14.372581536760642
"Granite Shoals city, Texas",2607,1548,1059,48,30584,40.62140391254315
"Spur city, Texas",695,417,278,48,69848,40.0
"Cotulla city, Texas",1866,1509,357,48,17216,19.131832797427652
"Holiday Lakes town, Texas",431,317,114,48,34502,26.450116009280745
"Silverton city, Texas",371,285,86,48,67904,23.180592991913745
"Gatesville city, Texas",3254,2771,483,48,29168,14.843269821757838
"Canyon Lake CDP, Texas",12855,9835,3020,48,12580,23.492804356281603
"Bulverde city, Texas",1762,1678,84,48,11224,4.767309875141884
"Coolidge town, Texas",380,281,99,48,16552,26.052631578947366
"Shady Hollow CDP, Texas",1654,1647,7,48,67082,0.42321644498186217
"Clifton city, Texas",1517,1268,249,48,15472,16.413974950560316
"Littlefield city, Texas",2566,2066,500,48,43024,19.485580670303975
"Kosse town, Texas",272,221,51,48,39844,18.75
"Mexia city, Texas",2764,2353,411,48,47916,14.869753979739508
"Grape Creek CDP, Texas",1230,1045,185,48,30629,15.040650406504067
"San Angelo city, Texas",41082,36854,4228,48,64472,10.29161189815491
"Millican town, Texas",101,84,17,48,48516,16.831683168316832
"Arlington city, Texas",146962,134984,11978,48,04000,8.15040622746016
"Keller city, Texas",15533,15230,303,48,38632,1.9506856370308376
"Pecan Acres CDP, Texas",1804,1670,134,48,56462,7.427937915742794
"River Oaks city, Texas",2907,2719,188,48,62384,6.467148262813898
"Saginaw city, Texas",7970,7631,339,48,64112,4.253450439146801
"Southlake city, Texas",9439,9132,307,48,69032,3.252463184659392
"Kenefick town, Texas",198,164,34,48,38872,17.17171717171717
"Solis CDP, Texas",176,164,12,48,68678,6.8181818181818175
"South Padre Island town, Texas",7604,1527,6077,48,69140,79.9184639663335
"South Point CDP, Texas",288,288,0,48,69194,0.0
"Blue Ridge city, Texas",381,336,45,48,08872,11.811023622047244
"McKinney city, Texas",62615,59580,3035,48,45744,4.847081370278687
"Mobeetie city, Texas",64,48,16,48,48852,25.0
"Edroy CDP, Texas",154,130,24,48,22768,15.584415584415584
"Kerrville city, Texas",10440,9666,774,48,39040,7.413793103448276
"Corinth city, Texas",7562,7239,323,48,16696,4.271356783919598
"Denton city, Texas",50730,46561,4169,48,19972,8.218016952493594
"Hebron town, Texas",112,95,17,48,33020,15.178571428571427
"Hickory Creek town, Texas",1675,1607,68,48,33476,4.059701492537314
"Krugerville city, Texas",631,603,28,48,39916,4.437400950871632
"Roanoke city, Texas",2807,2683,124,48,62504,4.41752760954756
"Shady Shores town, Texas",1001,923,78,48,67100,7.792207792207792
"The Colony city, Texas",16892,16244,648,48,72530,3.836135448733128
"Woodson town, Texas",119,92,27,48,80188,22.689075630252102
"Louise CDP, Texas",347,331,16,48,44212,4.610951008645533
"Gorman city, Texas",555,347,208,48,30308,37.47747747747748
"Hallsville city, Texas",1524,1421,103,48,31904,6.758530183727034
"Jewett city, Texas",461,313,148,48,37648,32.10412147505423
"Commerce city, Texas",3565,2931,634,48,16240,17.78401122019635
"Neylandville town, Texas",31,19,12,48,51444,38.70967741935484
"Muleshoe city, Texas",1833,1618,215,48,49968,11.729405346426622
"Lamesa city, Texas",4236,3589,647,48,41164,15.273843248347498
"Frankston town, Texas",545,430,115,48,27300,21.100917431192663
"Haskell city, Texas",1408,1093,315,48,32696,22.37215909090909
"Emory city, Texas",545,484,61,48,24216,11.192660550458717
"Rochester town, Texas",219,152,67,48,62636,30.59360730593607
"Midland city, Texas",49852,46552,3300,48,48072,6.619593998234776
"Iraan city, Texas",481,414,67,48,36128,13.92931392931393
"Rotan city, Texas",812,636,176,48,63464,21.67487684729064
"Hale Center city, Texas",927,785,142,48,31820,15.318230852211434
"Floydada city, Texas",1421,1115,306,48,26268,21.534130893736805
"Gordon city, Texas",237,193,44,48,30272,18.565400843881857
"Midlothian city, Texas",8081,7801,280,48,48096,3.46491770820443
"Mauriceville CDP, Texas",1335,1149,186,48,47100,13.93258426966292
"West Orange city, Texas",1559,1316,243,48,77752,15.586914688903143
"Strawn city, Texas",346,257,89,48,70580,25.722543352601157
"Bayside town, Texas",323,177,146,48,06104,45.20123839009288
"Hempstead city, Texas",2846,2559,287,48,33200,10.084328882642305
"Monahans city, Texas",2977,2570,407,48,48936,13.671481357070878
"Briaroaks city, Texas",227,213,14,48,10216,6.167400881057269
"Cross Timber town, Texas",119,112,7,48,17917,5.88235294117647
"Avery town, Texas",276,224,52,48,05072,18.84057971014493
"Eagle Pass city, Texas",9776,8674,1102,48,21892,11.272504091653028
"Blessing CDP, Texas",270,220,50,48,08668,18.51851851851852
"Powell town, Texas",65,43,22,48,59168,33.84615384615385
"Annona town, Texas",164,136,28,48,03360,17.073170731707318
"Pyote town, Texas",72,57,15,48,59996,20.833333333333336
"Asherton city, Texas",428,326,102,48,04300,23.83177570093458
"Lockhart city, Texas",4571,4277,294,48,43240,6.431852986217458
"Barton Creek CDP, Texas",1576,1346,230,48,05750,14.593908629441623
"Hudson Bend CDP, Texas",1402,1011,391,48,35253,27.888730385164052
"Lago Vista city, Texas",3404,2812,592,48,40264,17.391304347826086
"Leander city, Texas",14717,13905,812,48,42016,5.5174288238092
"Ozona CDP, Texas",1377,1137,240,48,54552,17.429193899782135
"Christoval CDP, Texas",205,189,16,48,14872,7.804878048780488
"La Vernia city, Texas",495,389,106,48,41764,21.41414141414141
"Bryan city, Texas",33039,29985,3054,48,10912,9.24362117497503
"Luling city, Texas",2208,2008,200,48,45096,9.057971014492754
"Belton city, Texas",7679,7102,577,48,07492,7.513999218648261
"Temple city, Texas",30430,26926,3504,48,72176,11.514952349654946
"Wellington city, Texas",1008,780,228,48,77152,22.61904761904762
"Blackwell city, Texas",153,115,38,48,08488,24.836601307189543
"Woodsboro town, Texas",738,574,164,48,80176,22.22222222222222
"Pattison city, Texas",214,182,32,48,56108,14.953271028037381
"Golinda city, Texas",263,192,71,48,30092,26.996197718631176
"Lott city, Texas",340,241,99,48,44176,29.117647058823533
"New Chapel Hill city, Texas",313,272,41,48,50876,13.099041533546327
"Whitehouse city, Texas",2797,2614,183,48,78388,6.542724347515194
"Lake View CDP, Texas",177,89,88,48,40966,49.717514124293785
"Briarcliff village, Texas",751,613,138,48,10197,18.375499334221036
"West Lake Hills city, Texas",1377,1309,68,48,77632,4.938271604938271
"Encino CDP, Texas",82,27,55,48,24252,67.07317073170732
"Earth city, Texas",513,394,119,48,21928,23.196881091617932
"Mustang Ridge city, Texas",404,374,30,48,50200,7.425742574257425
"Dodson town, Texas",58,37,21,48,20716,36.206896551724135
"Venus town, Texas",920,832,88,48,75236,9.565217391304348
"Bronte town, Texas",547,450,97,48,10528,17.73308957952468
"Markham CDP, Texas",587,502,85,48,46716,14.480408858603067
"Palacios city, Texas",2102,1751,351,48,54684,16.69838249286394
"Corsicana city, Texas",9442,8228,1214,48,17060,12.857445456471087
"Frost city, Texas",324,263,61,48,27768,18.82716049382716
"Navarro town, Texas",97,81,16,48,50448,16.49484536082474
"Sinton city, Texas",2207,1923,284,48,68036,12.868146805618485
"Palmer town, Texas",697,632,65,48,54744,9.32568149210904
"Taft city, Texas",1254,1062,192,48,71684,15.311004784688995
"Breckenridge city, Texas",2552,1953,599,48,10132,23.4717868338558
"Pecos city, Texas",3387,2818,569,48,56516,16.799527605550637
"New Home city, Texas",223,211,12,48,51012,5.381165919282512
"Vidor city, Texas",4505,3887,618,48,75476,13.7180910099889
"Carrizo Springs city, Texas",2124,1889,235,48,12988,11.064030131826742
"Catarina CDP, Texas",144,70,74,48,13324,51.388888888888886
"Godley city, Texas",433,374,59,48,29972,13.625866050808314
"Elm Creek CDP, Texas",675,643,32,48,23254,4.7407407407407405
"West Columbia city, Texas",1615,1351,264,48,77416,16.346749226006192
"Fort Hood CDP, Texas",6415,3746,2669,48,26736,41.60561184723305
"Tahoka city, Texas",1249,1018,231,48,71708,18.494795836669336
"Wilson city, Texas",162,124,38,48,79612,23.456790123456788
"Orange city, Texas",9503,7886,1617,48,54132,17.01567925918131
"Pinehurst city, Texas",1094,935,159,48,57608,14.53382084095064
"Mingus city, Texas",166,112,54,48,48720,32.53012048192771
"Stratford city, Texas",855,730,125,48,70544,14.619883040935672
"Groveton city, Texas",590,423,167,48,31340,28.30508474576271
"Liberty Hill city, Texas",463,395,68,48,42664,14.686825053995682
"Falcon Mesa CDP, Texas",320,76,244,48,25352,76.25
"Zapata CDP, Texas",2199,1663,536,48,80716,24.374715779899955
"Florence city, Texas",402,323,79,48,26136,19.65174129353234
"Elmendorf city, Texas",647,623,24,48,23272,3.7094281298299845
"Helotes city, Texas",2659,2638,21,48,33146,0.7897705904475367
"Hollywood Park town, Texas",1365,1336,29,48,34628,2.1245421245421245
"Leon Valley city, Texas",4287,4153,134,48,42388,3.125728947982272
"Olmos Park city, Texas",877,748,129,48,53988,14.709236031927023
"Somerset city, Texas",518,468,50,48,68708,9.652509652509652
"Henderson city, Texas",4457,4011,446,48,33212,10.006730984967467
"New London city, Texas",482,371,111,48,51168,23.029045643153527
"Murphy city, Texas",5488,5426,62,48,50100,1.129737609329446
"East Mountain city, Texas",375,346,29,48,22168,7.733333333333333
"Weston city, Texas",150,126,24,48,77740,16.0
"Gilmer city, Texas",2077,1770,307,48,29564,14.78093403948002
"Shamrock city, Texas",1072,910,162,48,67160,15.111940298507461
"Bowie city, Texas",2336,2107,229,48,09640,9.803082191780822
"St. Jo city, Texas",437,357,80,48,64184,18.306636155606405
"Appleby city, Texas",258,230,28,48,03564,10.852713178294573
"Ovilla city, Texas",1474,1372,102,48,54444,6.919945725915875
"Bovina city, Texas",610,500,110,48,09628,18.0327868852459
"Seadrift city, Texas",792,399,393,48,66416,49.621212121212125
"Santa Monica CDP, Texas",21,4,17,48,65756,80.95238095238095
"Sebastian CDP, Texas",697,542,155,48,66512,22.23816355810617
"Zapata Ranch CDP, Texas",24,24,0,48,80722,0.0
"Lone Star city, Texas",853,693,160,48,43684,18.757327080890974
"Omaha city, Texas",499,406,93,48,54024,18.637274549098194
"Tulia city, Texas",1799,1459,340,48,73868,18.899388549193997
"Impact town, Texas",24,16,8,48,35816,33.33333333333333
"Dilley city, Texas",974,735,239,48,20428,24.53798767967146
"Gallatin city, Texas",126,118,8,48,28008,6.349206349206349
"Comanche city, Texas",2066,1554,512,48,16192,24.78218780251694
"Kirvin town, Texas",80,69,11,48,39520,13.750000000000002
"Teague city, Texas",1680,1264,416,48,72020,24.761904761904763
"Van Vleck CDP, Texas",775,600,175,48,75068,22.58064516129032
"Angus city, Texas",168,155,13,48,03288,7.738095238095238
"Emhouse town, Texas",67,54,13,48,24168,19.402985074626866
"Bogata city, Texas",619,490,129,48,09172,20.84006462035541
"Taylorsville city, Utah",20694,19950,744,49,75360,3.5952449985503043
"American Fork city, Utah",8574,8325,249,49,01310,2.9041287613715885
"Erda CDP, Utah",701,694,7,49,23640,0.9985734664764622
"Ballard town, Utah",311,282,29,49,03345,9.32475884244373
"Santa Clara city, Utah",2377,2130,247,49,67660,10.39124947412705
"Genola town, Utah",396,358,38,49,28810,9.595959595959595
"Lehi city, Utah",16514,15922,592,49,44320,3.5848371079084416
"Orem city, Utah",30026,28177,1849,49,57300,6.1579964031172985
"Provo city, Utah",34906,32870,2036,49,62470,5.832808113218358
"Bicknell town, Utah",171,96,75,49,05490,43.859649122807014
"Enterprise city, Utah",534,490,44,49,23420,8.239700374531834
"Alpine city, Utah",2849,2744,105,49,00540,3.6855036855036856
"Elberta CDP, Utah",22,22,0,49,22210,0.0
"Mapleton city, Utah",2604,2464,140,49,47950,5.376344086021505
"Springville city, Utah",9434,9056,378,49,72280,4.006783972864109
"Vineyard town, Utah",1475,1350,125,49,80420,8.47457627118644
"Farr West city, Utah",2210,2047,163,49,24850,7.375565610859729
"Harrisville city, Utah",2122,1994,128,49,33540,6.032045240339302
"Huntsville town, Utah",348,288,60,49,37060,17.24137931034483
"Marriott-Slaterville city, Utah",709,689,20,49,48300,2.8208744710860367
"Uintah town, Utah",488,478,10,49,77890,2.0491803278688523
"Francis town, Utah",420,403,17,49,26940,4.0476190476190474
"Woodland CDP, Utah",116,97,19,49,85040,16.379310344827587
"Charleston town, Utah",216,200,16,49,12420,7.4074074074074066
"Wendover city, Utah",556,405,151,49,82730,27.15827338129496
"Maeser CDP, Utah",1587,1224,363,49,47180,22.873345935727787
"Randlett CDP, Utah",88,38,50,49,62910,56.81818181818182
"Whiterocks CDP, Utah",99,59,40,49,84160,40.4040404040404
"Hildale city, Utah",462,336,126,49,35300,27.27272727272727
"Leeds town, Utah",396,326,70,49,44100,17.67676767676768
"St. George city, Utah",35586,28998,6588,49,65330,18.512898330804248
"Cache CDP, Utah",0,0,0,49,09725,
"Paradise town, Utah",333,314,19,49,57850,5.7057057057057055
"Peter CDP, Utah",174,174,0,49,59555,0.0
"Howell town, Utah",107,106,1,49,36620,0.9345794392523363
"Clearfield city, Utah",9983,9265,718,49,13850,7.192226785535411
"Paragonah town, Utah",205,162,43,49,57960,20.975609756097562
"Delta city, Utah",1389,1210,179,49,18910,12.8869690424766
"Meadow town, Utah",149,104,45,49,48830,30.201342281879196
"Oak City town, Utah",254,222,32,49,55430,12.598425196850393
"Price city, Utah",3511,3028,483,49,62030,13.756764454571346
"Boulder town, Utah",143,83,60,49,07470,41.95804195804196
"Garden City town, Utah",1097,112,985,49,27930,89.79033728350045
"Laketown town, Utah",142,73,69,49,42560,48.59154929577465
"Redmond town, Utah",301,265,36,49,63240,11.960132890365449
"Salina city, Utah",1110,970,140,49,65880,12.612612612612612
"Cove CDP, Utah",166,157,9,49,16490,5.421686746987952
"Hyde Park city, Utah",1284,1251,33,49,37390,2.570093457943925
"Richmond city, Utah",874,817,57,49,63680,6.521739130434782
"Bear River City city, Utah",262,246,16,49,03950,6.106870229007633
"Cedar Hills city, Utah",2511,2493,18,49,11440,0.7168458781362007
"Eagle Mountain city, Utah",7166,7020,146,49,20810,2.0373988277979347
"Elk Ridge city, Utah",923,862,61,49,22370,6.608884073672806
"Hanksville town, Utah",122,98,24,49,33100,19.672131147540984
"Hooper city, Utah",2476,2442,34,49,36400,1.3731825525040386
"Mona city, Utah",440,414,26,49,51140,5.909090909090909
"Saratoga Springs city, Utah",6577,6516,61,49,67825,0.9274745324616087
"Woodland Hills city, Utah",388,377,11,49,85050,2.8350515463917527
"Bryce Canyon City town, Utah",99,48,51,49,08787,51.515151515151516
"Hideout town, Utah",353,320,33,49,35120,9.34844192634561
"Central Valley town, Utah",230,214,16,49,12260,6.956521739130435
"Independence town, Utah",89,56,33,49,37690,37.07865168539326
"Herriman city, Utah",9745,9162,583,49,34970,5.982555156490508
"Ivins city, Utah",3604,3134,470,49,38710,13.041065482796894
"Cottonwood Heights city, Utah",13867,12974,893,49,16270,6.439749044494122
"Fairfield town, Utah",46,43,3,49,24410,6.521739130434782
"Apple Valley town, Utah",338,245,93,49,01905,27.514792899408285
"Daniel town, Utah",384,327,57,49,18140,14.84375
"Dutch John town, Utah",95,17,78,49,20780,82.10526315789474
"Interlaken town, Utah",173,89,84,49,37924,48.554913294797686
"Millcreek city, Utah",25443,24056,1387,49,50150,5.451401171245529
"Cedar Highlands town, Utah",77,48,29,49,11435,37.66233766233766
"Ophir CDP, Utah",25,12,13,49,56750,52.0
"Beryl Junction CDP, Utah",65,37,28,49,05380,43.07692307692308
"Bluebell CDP, Utah",105,83,22,49,06590,20.952380952380953
"Bonanza CDP, Utah",40,0,40,49,06920,100.0
"Carbonville CDP, Utah",665,616,49,49,10440,7.368421052631578
"Central CDP, Utah",405,368,37,49,12200,9.135802469135802
"Clear Creek CDP, Utah",45,14,31,49,13740,68.88888888888889
"Copperton CDP, Utah",431,431,0,49,15720,0.0
"Portage town, Utah",106,81,25,49,61590,23.58490566037736
"Parowan city, Utah",1487,1094,393,49,58510,26.429051782111635
"Hinckley town, Utah",249,204,45,49,35740,18.072289156626507
"Holden town, Utah",202,168,34,49,35960,16.831683168316832
"Brigham City city, Utah",7078,6695,383,49,08460,5.411133088443063
"Mantua town, Utah",241,236,5,49,47840,2.0746887966804977
"Farmington city, Utah",6763,6507,256,49,24740,3.785302380600325
"West Point city, Utah",2907,2886,21,49,83390,0.7223942208462332
"Enoch city, Utah",1837,1665,172,49,23200,9.363091997822536
"Beaver city, Utah",1262,1091,171,49,04060,13.549920760697306
"Ephraim city, Utah",2088,1862,226,49,23530,10.82375478927203
"Fayette town, Utah",111,93,18,49,25070,16.216216216216218
"Glendale town, Utah",152,81,71,49,29360,46.71052631578947
"Kanab city, Utah",2088,1703,385,49,39920,18.438697318007662
"Clarkston town, Utah",252,216,36,49,13190,14.285714285714285
"Cornish town, Utah",66,63,3,49,15940,4.545454545454546
"Fairview city, Utah",553,455,98,49,24630,17.72151898734177
"Moroni city, Utah",521,483,38,49,52130,7.293666026871401
"North Logan city, Utah",3415,3126,289,49,54990,8.462664714494876
"Deweyville town, Utah",153,138,15,49,19680,9.803921568627452
"North Salt Lake city, Utah",6707,6492,215,49,55210,3.2056060831966606
"Altamont town, Utah",91,72,19,49,00760,20.87912087912088
"Neola CDP, Utah",142,130,12,49,54110,8.450704225352112
"Brian Head town, Utah",1732,36,1696,49,08020,97.92147806004618
"Suquamish CDP, Washington",2068,1867,201,53,69170,9.71953578336557
"Waverly town, Washington",40,36,4,53,76720,10.0
"Fairchild AFB CDP, Washington",802,759,43,53,22955,5.361596009975062
"Latah town, Washington",75,55,20,53,38495,26.666666666666668
"Rockford town, Washington",249,175,74,53,59145,29.71887550200803
"Grays River CDP, Washington",185,185,0,53,28450,0.0
"Green Bluff CDP, Washington",234,186,48,53,28590,20.51282051282051
"Hansville CDP, Washington",1797,1564,233,53,29430,12.96605453533667
"Hat Island CDP, Washington",263,28,235,53,30030,89.35361216730038
"Hazel Dell CDP, Washington",8635,8096,539,53,30305,6.24203821656051
"Herron Island CDP, Washington",317,33,284,53,30690,89.58990536277602
"High Bridge CDP, Washington",1166,1096,70,53,30750,6.003430531732419
"Hogans Corner CDP, Washington",61,19,42,53,31540,68.85245901639344
"Home CDP, Washington",808,575,233,53,31985,28.836633663366335
"Keller CDP, Washington",89,71,18,53,34960,20.224719101123593
"Hoodsport CDP, Washington",148,108,40,53,32125,27.027027027027028
"Jamestown CDP, Washington",207,194,13,53,33890,6.280193236714976
"Kapowsin CDP, Washington",124,94,30,53,34890,24.193548387096776
"Ketron Island CDP, Washington",0,0,0,53,35450,
"Key Center CDP, Washington",1654,1410,244,53,35555,14.752116082224909
"Keyport CDP, Washington",205,205,0,53,35625,0.0
"La Grande CDP, Washington",110,72,38,53,36920,34.54545454545455
"Lake Cassidy CDP, Washington",1356,1287,69,53,37100,5.0884955752212395
"Lake Holm CDP, Washington",1281,1281,0,53,37345,0.0
"Lake Stickney CDP, Washington",3755,3531,224,53,37917,5.96537949400799
"Lake Tapps CDP, Washington",4749,4454,295,53,37920,6.211834070330595
"Larch Way CDP, Washington",1512,1474,38,53,38420,2.513227513227513
"Laurier CDP, Washington",0,0,0,53,38705,
"Lofall CDP, Washington",980,901,79,53,39930,8.061224489795919
"Longbranch CDP, Washington",1890,1430,460,53,40105,24.33862433862434
"Loomis CDP, Washington",82,56,26,53,40350,31.70731707317073
"Loon Lake CDP, Washington",517,337,180,53,40385,34.81624758220503
"Lower Elochoman CDP, Washington",122,122,0,53,40570,0.0
"McKenna CDP, Washington",282,273,9,53,41645,3.1914893617021276
"McMillin CDP, Washington",715,705,10,53,41785,1.3986013986013985
"Malo CDP, Washington",9,9,0,53,42310,0.0
"Malone CDP, Washington",161,133,28,53,42345,17.391304347826086
"Malott CDP, Washington",224,196,28,53,42380,12.5
"Manson CDP, Washington",1091,574,517,53,42835,47.38771769019248
"Maplewood CDP, Washington",2250,2029,221,53,43255,9.822222222222223
"Mead CDP, Washington",2938,2752,186,53,44480,6.330837304288632
"Meadowdale CDP, Washington",1054,1040,14,53,44585,1.3282732447817838
"Methow CDP, Washington",89,35,54,53,45355,60.67415730337079
"Mill Creek East CDP, Washington",7216,7035,181,53,45870,2.5083148558758315
"Mineral CDP, Washington",223,193,30,53,46090,13.452914798206278
"Monroe North CDP, Washington",620,592,28,53,46725,4.516129032258064
"Nile CDP, Washington",57,57,0,53,49030,0.0
"North Fort Lewis CDP, Washington",986,944,42,53,49765,4.259634888438134
"Hatton town, Washington",51,48,3,53,30060,5.88235294117647
"Lind town, Washington",274,211,63,53,39510,22.99270072992701
"South Wenatchee CDP, Washington",533,533,0,53,66185,0.0
"Orting city, Washington",2781,2581,200,53,52005,7.191657677094571
"Bell Hill CDP, Washington",423,381,42,53,05245,9.929078014184398
"Blyn CDP, Washington",41,12,29,53,06855,70.73170731707317
"Bickleton CDP, Washington",32,29,3,53,05980,9.375
"Mabton city, Washington",565,533,32,53,40980,5.663716814159292
"Naches town, Washington",355,303,52,53,47805,14.647887323943662
"Poulsbo city, Washington",4482,4250,232,53,55995,5.176260597947345
"East Cathlamet CDP, Washington",266,266,0,53,19290,0.0
"Harrington city, Washington",269,201,68,53,29745,25.27881040892193
"Wilbur town, Washington",494,358,136,53,78680,27.530364372469634
"Deming CDP, Washington",95,49,46,53,17495,48.421052631578945
"Marietta-Alderwood CDP, Washington",1922,1658,264,53,43491,13.735691987513007
"Otis Orchards-East Farms CDP, Washington",2437,2265,172,53,52267,7.057858022158392
"Spokane city, Washington",97825,89626,8199,53,67000,8.381293125479171
"Mesa city, Washington",138,124,14,53,45180,10.144927536231885
"Langley city, Washington",713,608,105,53,38355,14.726507713884992
"Oak Harbor city, Washington",10058,9380,678,53,50360,6.74090276396898
"Neah Bay CDP, Washington",380,338,42,53,48295,11.052631578947368
"Naselle CDP, Washington",218,188,30,53,48015,13.761467889908257
"Basin City CDP, Washington",267,223,44,53,04405,16.479400749063668
"Country Homes CDP, Washington",2034,1884,150,53,15150,7.374631268436578
"Camano CDP, Washington",8819,6990,1829,53,09365,20.739312847261594
"Brinnon CDP, Washington",1145,350,795,53,08080,69.43231441048034
"Sudden Valley CDP, Washington",3392,3069,323,53,68200,9.522405660377359
"Odessa town, Washington",557,444,113,53,50745,20.287253141831236
"Fords Prairie CDP, Washington",832,761,71,53,24565,8.533653846153847
"Mossyrock city, Washington",353,299,54,53,47315,15.29745042492918
"Pe Ell town, Washington",254,199,55,53,53930,21.653543307086615
"Everett city, Washington",45425,42883,2542,53,22640,5.596037424325812
"West Side Highway CDP, Washington",2156,2085,71,53,77745,3.293135435992579
"Brady CDP, Washington",271,228,43,53,07590,15.867158671586715
"Cohassett Beach CDP, Washington",463,311,152,53,13595,32.82937365010799
"Taholah CDP, Washington",249,206,43,53,70175,17.269076305220885
"Moxee city, Washington",1103,1065,38,53,47665,3.445149592021759
"Union Gap city, Washington",2247,2054,193,53,73290,8.589230084557187
"Wapato city, Washington",1382,1297,85,53,76125,6.150506512301012
"Yakima city, Washington",35658,33557,2101,53,80010,5.892085927421617
"Connell city, Washington",1293,1216,77,53,14485,5.955143078112916
"Port Hadlock-Irondale CDP, Washington",1704,1520,184,53,55620,10.7981220657277
"North Lynnwood CDP, Washington",8651,8124,527,53,49940,6.091781296959889
"North Puyallup CDP, Washington",854,819,35,53,50115,4.098360655737705
"Northwest Stanwood CDP, Washington",42,42,0,53,50195,0.0
"Onalaska CDP, Washington",225,225,0,53,51410,0.0
"Orient CDP, Washington",121,89,32,53,51830,26.446280991735538
"Outlook CDP, Washington",61,61,0,53,52285,0.0
"Oyehut CDP, Washington",85,0,85,53,52378,100.0
"Pacific Beach CDP, Washington",182,139,43,53,52530,23.626373626373624
"Packwood CDP, Washington",332,153,179,53,52600,53.915662650602414
"Parker CDP, Washington",43,43,0,53,53265,0.0
"Picnic Point CDP, Washington",3588,3439,149,53,54213,4.15273132664437
"Pine Grove CDP, Washington",43,43,0,53,54405,0.0
"Point Roberts CDP, Washington",2136,671,1465,53,55015,68.58614232209737
"Porter CDP, Washington",129,86,43,53,55540,33.33333333333333
"Prairie Heights CDP, Washington",1437,1301,136,53,56150,9.464161447459986
"Puget Island CDP, Washington",474,341,133,53,56555,28.059071729957807
"Purdy CDP, Washington",733,682,51,53,56660,6.957708049113233
"Queets CDP, Washington",63,53,10,53,56905,15.873015873015872
"Qui-nai-elt Village CDP, Washington",20,20,0,53,57030,0.0
"Raft Island CDP, Washington",226,201,25,53,57140,11.061946902654867
"Rocky Point CDP, Washington",758,723,35,53,59390,4.617414248021108
"Rosburg CDP, Washington",250,152,98,53,59845,39.2
"Rosedale CDP, Washington",1279,1232,47,53,59880,3.674745895230649
"Ryderwood CDP, Washington",342,262,80,53,60580,23.391812865497073
"Santiago CDP, Washington",30,11,19,53,61235,63.33333333333333
"Seabeck CDP, Washington",612,537,75,53,62120,12.254901960784313
"Sekiu CDP, Washington",33,21,12,53,63245,36.36363636363637
"Shadow Lake CDP, Washington",946,862,84,53,63545,8.879492600422834
"Silver Firs CDP, Washington",7255,7004,251,53,64380,3.459682977257064
"Sisco Heights CDP, Washington",894,840,54,53,64610,6.0402684563758395
"Skamokawa Valley CDP, Washington",176,176,0,53,64755,0.0
"South Creek CDP, Washington",1235,1177,58,53,65810,4.696356275303644
"Southworth CDP, Washington",936,835,101,53,66220,10.790598290598291
"Stansberry Lake CDP, Washington",835,810,25,53,67435,2.9940119760479043
"Steptoe CDP, Washington",95,90,5,53,67805,5.263157894736842
"Summit View CDP, Washington",3196,2998,198,53,68410,6.195244055068836
"Sunday Lake CDP, Washington",263,239,24,53,68480,9.125475285171103
"Torboy CDP, Washington",29,29,0,53,71995,0.0
"Swede Heaven CDP, Washington",531,408,123,53,69280,23.163841807909606
"Tampico CDP, Washington",103,103,0,53,70245,0.0
"Tanglewilde CDP, Washington",2436,2283,153,53,70280,6.280788177339902
"Twin Lakes CDP, Washington",264,37,227,53,73065,85.98484848484848
"Union CDP, Washington",364,211,153,53,73255,42.032967032967036
"Upper Elochoman CDP, Washington",51,51,0,53,73580,0.0
"Valley CDP, Washington",52,52,0,53,73885,0.0
"Vaughn CDP, Washington",269,225,44,53,74445,16.356877323420075
"Wauna CDP, Washington",1755,1609,146,53,76615,8.31908831908832
"Whidbey Island Station CDP, Washington",123,123,0,53,78155,0.0
"Wilderness Rim CDP, Washington",624,569,55,53,78780,8.814102564102564
"Willapa CDP, Washington",100,85,15,53,78995,15.0
"Wollochet CDP, Washington",2950,2662,288,53,79555,9.76271186440678
"Browns Point CDP, Washington",588,483,105,53,08325,17.857142857142858
"Dollars Corner CDP, Washington",436,328,108,53,18198,24.770642201834864
"Kayak Point CDP, Washington",693,639,54,53,34915,7.792207792207792
"Port Gamble Tribal Community CDP, Washington",361,352,9,53,55612,2.4930747922437675
"Mattawa city, Washington",972,906,66,53,44165,6.790123456790123
"Millwood city, Washington",791,745,46,53,45985,5.815423514538559
"Tieton city, Washington",408,369,39,53,71400,9.558823529411764
"Glenwood CDP, Washington",106,88,18,53,27225,16.9811320754717
"Quilcene CDP, Washington",298,212,86,53,56975,28.859060402684566
"Olympia city, Washington",23555,22351,1204,53,51300,5.1114413075780085
"Colton town, Washington",200,188,12,53,13890,6.0
"Tekoa city, Washington",312,266,46,53,70560,14.743589743589745
"Bucoda town, Washington",289,250,39,53,08605,13.494809688581316
"Alger CDP, Washington",95,95,0,53,01255,0.0
"Marblemount CDP, Washington",22,0,22,53,43325,100.0
"Mount Vernon city, Washington",12772,12115,657,53,47560,5.144065142499217
"Bremerton city, Washington",18730,16798,1932,53,07695,10.315002669514147
"Kingston CDP, Washington",1144,1027,117,53,35870,10.227272727272728
"Ellensburg city, Washington",8495,7812,683,53,21240,8.040023543260743
"South Cle Elum town, Washington",263,256,7,53,65765,2.6615969581749046
"Ione town, Washington",256,188,68,53,33560,26.5625
"Graham CDP, Washington",9508,8992,516,53,27785,5.4270088346655445
"Prairie Ridge CDP, Washington",4385,4165,220,53,56170,5.017103762827822
"Puyallup city, Washington",16607,15728,879,53,56695,5.292948756548443
"University Place city, Washington",13550,12933,617,53,73465,4.553505535055351
"Wilkeson town, Washington",198,186,12,53,78925,6.0606060606060606
"Cherry Grove CDP, Washington",169,169,0,53,12015,0.0
"Conway CDP, Washington",0,0,0,53,14520,
"Tumwater city, Washington",9812,9336,476,53,72905,4.8512026090501426
"Bay View CDP, Washington",341,306,35,53,04790,10.263929618768328
"Hartline town, Washington",87,63,24,53,29920,27.586206896551722
"Royal City city, Washington",429,405,24,53,60230,5.594405594405594
"Soap Lake city, Washington",922,593,329,53,65345,35.68329718004338
"Kittitas city, Washington",612,577,35,53,36045,5.718954248366013
"George city, Washington",210,174,36,53,26455,17.142857142857142
"Newport city, Washington",983,904,79,53,48820,8.036622583926754
"Lake Shore CDP, Washington",2732,2629,103,53,37830,3.7701317715959006
"Oakesdale town, Washington",197,168,29,53,50325,14.720812182741117
"Fircrest city, Washington",2729,2640,89,53,23970,3.261267863686332
"Skokomish CDP, Washington",187,168,19,53,64775,10.16042780748663
"Clyde Hill city, Washington",1240,1130,110,53,13365,8.870967741935484
"Arlington city, Washington",7467,7083,384,53,02585,5.142627561269586
"Buckley city, Washington",2059,1915,144,53,08570,6.9936862554638175
"Town and Country CDP, Washington",2088,2006,82,53,72170,3.9272030651340994
"Sprague city, Washington",241,209,32,53,67175,13.278008298755188
"Thorp CDP, Washington",123,114,9,53,71225,7.317073170731707
"Elbe CDP, Washington",54,54,0,53,20890,0.0
"Barberton CDP, Washington",2677,2557,120,53,04195,4.482629809488233
"Othello city, Washington",2436,2254,182,53,52215,7.471264367816093
"Leavenworth city, Washington",1498,1044,454,53,38845,30.307076101468628
"Sunnyslope CDP, Washington",1485,1409,76,53,68785,5.117845117845118
"Ritzville city, Washington",862,748,114,53,58725,13.225058004640372
"Stevenson city, Washington",745,646,99,53,67875,13.288590604026846
"Chewelah city, Washington",1324,1134,190,53,12140,14.350453172205437
"Marcus town, Washington",87,71,16,53,43395,18.39080459770115
"East Renton Highlands CDP, Washington",4452,4425,27,53,19857,0.6064690026954178
"Enumclaw city, Washington",5102,4897,205,53,22045,4.018032144257154
"Hobart CDP, Washington",2640,2601,39,53,31495,1.4772727272727273
"Lake Marcel-Stillwater CDP, Washington",602,551,51,53,37538,8.471760797342192
"Milton city, Washington",3169,3030,139,53,46020,4.3862417166298515
"Seattle city, Washington",344503,323446,21057,53,63000,6.112283492451445
"Tanner CDP, Washington",326,326,0,53,70315,0.0
"Yarrow Point town, Washington",465,423,42,53,80150,9.032258064516128
"Aberdeen Gardens CDP, Washington",107,107,0,53,00135,0.0
"Cosmopolis city, Washington",675,628,47,53,14870,6.962962962962963
"Elma city, Washington",1389,1315,74,53,21450,5.327573794096472
"Hoquiam city, Washington",4325,3704,621,53,32300,14.358381502890175
"Neilton CDP, Washington",109,109,0,53,48330,0.0
"Oakville city, Washington",331,292,39,53,50430,11.782477341389729
"Ocean Shores city, Washington",5232,2901,2331,53,50570,44.55275229357798
"Touchet CDP, Washington",206,186,20,53,72030,9.70873786407767
"Wallula CDP, Washington",58,58,0,53,75985,0.0
"Blaine city, Washington",2388,2138,250,53,06505,10.469011725293132
"Glacier CDP, Washington",825,52,773,53,26875,93.6969696969697
"Airway Heights city, Washington",2375,2170,205,53,00905,8.631578947368421
"Oroville city, Washington",998,887,111,53,51970,11.122244488977955
"Pateros city, Washington",240,213,27,53,53720,11.25
"North Sultan CDP, Washington",81,81,0,53,50183,0.0
"Oso CDP, Washington",111,111,0,53,52110,0.0
"Sultan city, Washington",2071,1907,164,53,68260,7.918879768227908
"Verlot CDP, Washington",114,114,0,53,74760,0.0
"Creston town, Washington",150,132,18,53,15710,12.0
"Trout Lake CDP, Washington",343,202,141,53,72450,41.10787172011662
"Wishram CDP, Washington",201,164,37,53,79485,18.407960199004975
"Ilwaco city, Washington",563,402,161,53,33000,28.596802841918294
"Raymond city, Washington",1353,1105,248,53,57430,18.329637841832962
"Index town, Washington",115,81,34,53,33175,29.565217391304348
"Lake Goodwin CDP, Washington",1760,1463,297,53,37287,16.875
"Martha Lake CDP, Washington",7254,7009,245,53,43815,3.3774469258340227
"Monroe city, Washington",5712,5505,207,53,46685,3.623949579831933
"Mountlake Terrace city, Washington",8661,8307,354,53,47490,4.087287842050571
"Silvana CDP, Washington",13,13,0,53,64190,0.0
"Port Ludlow CDP, Washington",1715,1360,355,53,55645,20.699708454810494
"Dixie CDP, Washington",87,87,0,53,18055,0.0
"Acme CDP, Washington",49,49,0,53,00275,0.0
"Bellingham city, Washington",37831,35694,2137,53,05280,5.648806534323702
"Elk Plain CDP, Washington",5280,4900,380,53,21205,7.196969696969697
"Fort Lewis CDP, Washington",3389,3223,166,53,24915,4.898200059014458
"South Hill CDP, Washington",20598,19587,1011,53,65922,4.9082435187882325
"Gig Harbor city, Washington",4501,3990,511,53,26735,11.35303265940902
"Eschbach CDP, Washington",144,144,0,53,22150,0.0
"Ruston town, Washington",650,544,106,53,60510,16.307692307692307
"South Prairie town, Washington",118,104,14,53,66045,11.864406779661017
"Selah city, Washington",2951,2858,93,53,63280,3.151474076584209
"Sunnyside city, Washington",4676,4358,318,53,68750,6.800684345594525
"East Port Orchard CDP, Washington",2193,1964,229,53,19770,10.442316461468309
"Navy Yard City CDP, Washington",1288,1202,86,53,48225,6.6770186335403725
"Carnation city, Washington",707,672,35,53,10215,4.9504950495049505
"Issaquah city, Washington",16013,15333,680,53,33805,4.2465496783863115
"Coupeville town, Washington",1031,902,129,53,15185,12.51212415130941
"Port Townsend city, Washington",5261,4594,667,53,55855,12.678198061205096
"Central Park CDP, Washington",1285,1260,25,53,11195,1.9455252918287937
"Sammamish city, Washington",21893,21218,675,53,61115,3.0831772712739234
"Medical Lake city, Washington",1922,1840,82,53,44690,4.266389177939646
"Moclips CDP, Washington",167,0,167,53,46405,100.0
"Satsop CDP, Washington",282,272,10,53,61350,3.546099290780142
"Asotin city, Washington",550,481,69,53,03075,12.545454545454545
"Clarkston Heights-Vineland CDP, Washington",2722,2578,144,53,12680,5.290227773695812
"West Clarkston-Highland CDP, Washington",2659,2533,126,53,77297,4.73862354268522
"Entiat city, Washington",604,470,134,53,22010,22.185430463576157
"Wenatchee city, Washington",13628,12562,1066,53,77105,7.822130906956266
"Waterville town, Washington",674,601,73,53,76510,10.83086053412463
"Nespelem town, Washington",95,88,7,53,48540,7.368421052631578
"Omak city, Washington",2293,2049,244,53,51340,10.641081552551244
"Tonasket city, Washington",532,499,33,53,71890,6.203007518796992
"Auburn city, Washington",30070,28389,1681,53,03180,5.590289324908547
"Des Moines city, Washington",12378,11778,600,53,17635,4.847309743092584
"Marysville city, Washington",25325,24483,842,53,43955,3.324777887462981
"Junction City CDP, Washington",0,0,0,53,34470,
"Felida CDP, Washington",2939,2939,0,53,23550,0.0
"Klickitat CDP, Washington",177,141,36,53,36115,20.33898305084746
"Bay Center CDP, Washington",197,122,75,53,04615,38.07106598984771
"Lebam CDP, Washington",111,77,34,53,38880,30.630630630630627
"Amboy CDP, Washington",601,530,71,53,01850,11.813643926788686
"Sequim city, Washington",3786,3586,200,53,63385,5.282620179609086
"Lyman town, Washington",201,190,11,53,40770,5.472636815920398
"Roslyn city, Washington",542,302,240,53,60055,44.28044280442804
"Arlington Heights CDP, Washington",961,916,45,53,02620,4.682622268470343
"Walla Walla city, Washington",13381,12144,1237,53,75775,9.244451087362679
"Greenwater CDP, Washington",94,27,67,53,28695,71.27659574468085
"Grandview city, Washington",3528,3356,172,53,27925,4.875283446712018
"Silverdale CDP, Washington",8932,8442,490,53,64365,5.4858934169279
"Palouse city, Washington",514,467,47,53,52950,9.14396887159533
"Warden city, Washington",895,820,75,53,76160,8.379888268156424
"Port Angeles East CDP, Washington",1616,1420,196,53,55400,12.128712871287128
"La Conner town, Washington",448,415,33,53,36780,7.366071428571429
"Parkwood CDP, Washington",3171,2733,438,53,53440,13.812677388836327
"Midland CDP, Washington",3591,3367,224,53,45495,6.237816764132553
"Battle Ground city, Washington",6940,6632,308,53,04475,4.438040345821326
"Finley CDP, Washington",1999,1982,17,53,23865,0.8504252126063032
"Marrowstone CDP, Washington",675,444,231,53,43762,34.22222222222222
"Everson city, Washington",878,863,15,53,22745,1.7084282460136675
"White Salmon city, Washington",1340,1058,282,53,78330,21.044776119402986
"Ocean City CDP, Washington",228,142,86,53,50500,37.719298245614034
"Krupp town, Washington",32,26,6,53,36395,18.75
"White Swan CDP, Washington",205,184,21,53,78365,10.24390243902439
"Salmon Creek CDP, Washington",8118,7998,120,53,61000,1.4781966001478197
"Albion town, Washington",351,290,61,53,01010,17.37891737891738
"Winlock city, Washington",623,556,67,53,79275,10.754414125200643
"Three Lakes CDP, Washington",1238,1186,52,53,71330,4.20032310177706
"Hunts Point town, Washington",185,155,30,53,32755,16.216216216216218
"Freeland CDP, Washington",1163,936,227,53,25510,19.518486672398968
"Mill Creek city, Washington",8558,8168,390,53,45865,4.557139518579107
"Montesano city, Washington",1562,1430,132,53,46895,8.450704225352112
"Washtucna town, Washington",138,104,34,53,76440,24.637681159420293
"Nespelem Community CDP, Washington",101,83,18,53,48550,17.82178217821782
"Copalis Beach CDP, Washington",403,262,141,53,14660,34.98759305210918
"SeaTac city, Washington",10306,9671,635,53,62288,6.161459344071415
"Five Corners CDP, Washington",6540,6272,268,53,24188,4.097859327217125
"Lewisville CDP, Washington",536,536,0,53,39212,0.0
"Rochester CDP, Washington",1157,1121,36,53,59110,3.1114952463267067
"Garfield town, Washington",354,252,102,53,26140,28.8135593220339
"Pullman city, Washington",13074,11437,1637,53,56625,12.521034113507726
"Uniontown town, Washington",157,137,20,53,73360,12.738853503184714
"Burlington city, Washington",3833,3628,205,53,08920,5.348291155752674
"Cascade Valley CDP, Washington",945,802,143,53,10455,15.132275132275133
"Ashford CDP, Washington",82,82,0,53,03005,0.0
"Lakeview CDP, Washington",513,443,70,53,37926,13.64522417153996
"Ronald CDP, Washington",146,76,70,53,59635,47.94520547945205
"Bonney Lake city, Washington",7237,6958,279,53,07170,3.855188614066602
"Lakewood city, Washington",26891,24520,2371,53,38038,8.81707634524562
"Steilacoom town, Washington",2778,2562,216,53,67770,7.775377969762419
"Erlands Point-Kitsap Lake CDP, Washington",1403,1354,49,53,22118,3.492516037063435
"Indianola CDP, Washington",1634,1403,231,53,33280,14.137086903304773
"Tracyton CDP, Washington",2347,2216,131,53,72205,5.581593523647209
"Sumner city, Washington",4318,4104,214,53,68435,4.955998147290412
"Morton city, Washington",549,428,121,53,47175,22.040072859744992
"Vader city, Washington",333,270,63,53,73780,18.91891891891892
"Brier city, Washington",2514,2434,80,53,07940,3.182179793158314
"Richland city, Washington",23302,22016,1286,53,58235,5.518839584585014
"Davenport city, Washington",812,729,83,53,16795,10.22167487684729
"Kahlotus city, Washington",123,73,50,53,34575,40.65040650406504
"Edmonds city, Washington",18493,17694,799,53,20750,4.3205537230303355
"Malden town, Washington",133,106,27,53,42275,20.30075187969925
"Mount Vista CDP, Washington",3627,3512,115,53,47630,3.170664460987042
"Endicott town, Washington",157,124,33,53,21730,21.019108280254777
"Farmington town, Washington",50,46,4,53,23340,8.0
"Nisqually Indian Community CDP, Washington",235,220,15,53,49193,6.382978723404255
"Hockinson CDP, Washington",1716,1658,58,53,31530,3.37995337995338
"Forks city, Washington",1557,1509,48,53,24810,3.0828516377649327
"Brush Prairie CDP, Washington",1012,986,26,53,08465,2.5691699604743086
"La Center city, Washington",1099,1036,63,53,36710,5.7324840764331215
"Meadow Glade CDP, Washington",929,891,38,53,44620,4.090419806243272
"Orchards CDP, Washington",7940,7639,301,53,51795,3.7909319899244336
"Ridgefield city, Washington",2588,2497,91,53,58410,3.5162287480680057
"Venersborg CDP, Washington",1564,1447,117,53,74585,7.4808184143222505
"Woodland city, Washington",2243,1990,253,53,79625,11.27953633526527
"Grand Mound CDP, Washington",1139,1041,98,53,27890,8.604038630377524
"Yelm city, Washington",2979,2801,178,53,80220,5.975159449479691
"Rosalia town, Washington",280,229,51,53,59775,18.21428571428571
"Lake McMurray CDP, Washington",66,66,0,53,37526,0.0
"Big Lake CDP, Washington",834,695,139,53,06050,16.666666666666664
"Concrete town, Washington",380,327,53,53,14380,13.94736842105263
"Edison CDP, Washington",73,61,12,53,20680,16.43835616438356
"Rockport CDP, Washington",41,41,0,53,59250,0.0
"Coulee City town, Washington",325,244,81,53,15080,24.923076923076923
"Minnehaha CDP, Washington",4246,4031,215,53,46125,5.063589260480452
"Vancouver city, Washington",74970,71595,3375,53,74060,4.501800720288116
"Anacortes city, Washington",8024,7332,692,53,01990,8.624127617148554
"Hamilton town, Washington",152,136,16,53,29255,10.526315789473683
"Manchester CDP, Washington",2236,1885,351,53,42450,15.69767441860465
"Ephrata city, Washington",2950,2620,330,53,22080,11.186440677966102
"Artondale CDP, Washington",4949,4687,262,53,02910,5.293998787633866
"Carbonado town, Washington",257,252,5,53,09970,1.9455252918287937
"Ahtanum CDP, Washington",1346,1255,91,53,00800,6.760772659732541
"Fox Island CDP, Washington",1576,1408,168,53,25370,10.65989847715736
"Ravensdale CDP, Washington",720,704,16,53,57395,2.2222222222222223
"Shoreline city, Washington",22918,22160,758,53,63960,3.3074439305349506
"Snoqualmie city, Washington",4466,4311,155,53,65205,3.4706672637707117
"Kenmore city, Washington",9066,8699,367,53,35170,4.048091771453784
"Kent city, Washington",45254,42815,2439,53,35415,5.389578821761612
"Lakeland South CDP, Washington",4739,4689,50,53,37430,1.0550749103186325
"Renton city, Washington",41117,39030,2087,53,57745,5.075759418245494
"Skykomish town, Washington",166,63,103,53,64855,62.048192771084345
"Covington city, Washington",7411,7143,268,53,15290,3.6162461206314935
"Duvall city, Washington",2602,2584,18,53,19035,0.6917755572636434
"Fall City CDP, Washington",848,807,41,53,23200,4.834905660377359
"Federal Way city, Washington",36403,34923,1480,53,23515,4.065598989094306
"Maple Heights-Lake Desire CDP, Washington",1378,1378,0,53,43062,0.0
"Maple Valley city, Washington",8908,8606,302,53,43150,3.3902110462505615
"Mercer Island city, Washington",10959,10123,836,53,45005,7.628433251209052
"Starbuck town, Washington",88,72,16,53,67490,18.181818181818183
"Camas city, Washington",8330,7972,358,53,09480,4.297719087635054
"Washougal city, Washington",5986,5666,320,53,76405,5.345806882726362
"Yacolt town, Washington",527,484,43,53,79975,8.159392789373813
"Lamont town, Washington",32,28,4,53,38215,12.5
"St. John town, Washington",339,286,53,53,60860,15.634218289085547
"Lake Cavanaugh CDP, Washington",463,104,359,53,37105,77.5377969762419
"Port Orchard city, Washington",5477,4880,597,53,55785,10.90012780719372
"Edgewood city, Washington",4041,3813,228,53,20645,5.642167780252413
"Parkland CDP, Washington",14499,13326,1173,53,53335,8.09021311814608
"Harrah town, Washington",199,192,7,53,29710,3.5175879396984926
"Summitview CDP, Washington",437,407,30,53,68417,6.864988558352403
"Toppenish city, Washington",2558,2441,117,53,71960,4.573885848319
"Goldendale city, Washington",1702,1566,136,53,27435,7.9905992949471205
"Bellevue city, Washington",61605,57054,4551,53,05210,7.3873873873873865
"North Omak CDP, Washington",280,271,9,53,50007,3.214285714285714
"Twisp town, Washington",572,515,57,53,73080,9.965034965034965
"Algona city, Washington",1015,944,71,53,01290,6.995073891625616
"Burien city, Washington",19986,18886,1100,53,08850,5.503852696887821
"Bridgeport city, Washington",788,706,82,53,07870,10.406091370558377
"Union Hill-Novelty Hill CDP, Washington",8448,8058,390,53,73307,4.6164772727272725
"Woodinville city, Washington",5294,4971,323,53,79590,6.101246694370986
"Elmer City town, Washington",189,171,18,53,21485,9.523809523809524
"Riverside town, Washington",141,136,5,53,58795,3.546099290780142
"Winthrop town, Washington",369,207,162,53,79380,43.90243902439025
"Lake Morton-Berrydale CDP, Washington",4061,3944,117,53,37567,2.88106377739473
"Colville city, Washington",2234,1986,248,53,14170,11.101163831692032
"Northport town, Washington",183,147,36,53,50045,19.672131147540984
"Baring CDP, Washington",254,106,148,53,04300,58.26771653543307
"Mirrormont CDP, Washington",1431,1342,89,53,46215,6.219426974143955
"Newcastle city, Washington",4543,4396,147,53,48645,3.2357473035439135
"Pacific city, Washington",2499,2383,116,53,52495,4.641856742697079
"Redmond city, Washington",27117,25358,1759,53,57535,6.48670575653649
"Riverbend CDP, Washington",870,870,0,53,58742,0.0
"North Bonneville city, Washington",530,492,38,53,49555,7.169811320754717
"Kettle Falls city, Washington",781,701,80,53,35485,10.243277848911651
"Ames Lake CDP, Washington",629,619,10,53,01920,1.5898251192368837
"Beaux Arts Village town, Washington",139,133,6,53,04895,4.316546762589928
"Black Diamond city, Washington",1802,1709,93,53,06330,5.160932297447281
"Kirkland city, Washington",38407,36143,2264,53,35940,5.894758767932929
"Medina city, Washington",1292,1191,101,53,44725,7.817337461300309
"Vashon CDP, Washington",5661,4501,1160,53,74305,20.491079314608726
"White Center CDP, Washington",6005,5653,352,53,78225,5.861781848459617
"Lakeland North CDP, Washington",4630,4375,255,53,37420,5.50755939524838
"Normandy Park city, Washington",2959,2869,90,53,49415,3.041568097330179
"Tukwila city, Washington",7385,7012,373,53,72625,5.050778605280975
"Inchelium CDP, Washington",156,137,19,53,33105,12.179487179487179
"Lake Ketchum CDP, Washington",347,347,0,53,37415,0.0
"Lochsloy CDP, Washington",1059,1001,58,53,39860,5.476864966949953
"Centerville CDP, Washington",44,41,3,53,11090,6.8181818181818175
"Waller CDP, Washington",3259,3168,91,53,75905,2.7922675667382633
"Prosser city, Washington",2801,2583,218,53,56450,7.782934666190647
"Port Angeles city, Washington",9281,8480,801,53,55365,8.630535502639802
"Lyle CDP, Washington",315,213,102,53,40735,32.38095238095238
"Roosevelt CDP, Washington",87,60,27,53,59705,31.03448275862069
"Centralia city, Washington",7761,7199,562,53,11160,7.2413348795258345
"Toledo city, Washington",299,245,54,53,71785,18.06020066889632
"Cathcart CDP, Washington",1000,938,62,53,10600,6.2
"Lake Roesiger CDP, Washington",499,223,276,53,37672,55.31062124248497
"Warm Beach CDP, Washington",1052,1021,31,53,76195,2.9467680608365017
"Kelso city, Washington",4661,4502,159,53,35065,3.411285131945934
"Longview Heights CDP, Washington",1559,1455,104,53,40270,6.670942912123155
"Woods Creek CDP, Washington",2085,1987,98,53,79825,4.700239808153477
"Woodway city, Washington",459,423,36,53,79835,7.8431372549019605
"College Place city, Washington",3798,3466,332,53,13855,8.741442864665613
"Waitsburg city, Washington",569,512,57,53,75565,10.017574692442881
"Ferndale city, Washington",5174,5070,104,53,23620,2.0100502512562812
"Lynden city, Washington",5551,5342,209,53,40805,3.7650873716447486
"Castle Rock city, Washington",1180,1143,37,53,10565,3.1355932203389827
"Grayland CDP, Washington",868,334,534,53,28345,61.52073732718893
"Humptulips CDP, Washington",92,92,0,53,32650,0.0
"East Wenatchee city, Washington",5256,5054,202,53,20155,3.8432267884322675
"Brewster city, Washington",907,832,75,53,07835,8.26901874310915
"Peaceful Valley CDP, Washington",1563,1532,31,53,53800,1.983365323096609
"Custer CDP, Washington",50,50,0,53,16375,0.0
"Maple Falls CDP, Washington",184,98,86,53,43010,46.73913043478261
"Nooksack city, Washington",543,515,28,53,49275,5.156537753222836
"Deer Park city, Washington",1618,1486,132,53,17320,8.15822002472188
"Aberdeen city, Washington",7325,6183,1142,53,00100,15.590443686006825
"Pomeroy city, Washington",788,600,188,53,55120,23.85786802030457
"Cashmere city, Washington",1245,1074,171,53,10495,13.734939759036143
"Okanogan city, Washington",1091,988,103,53,50920,9.440879926672777
"Shelton city, Washington",3678,3365,313,53,63735,8.510059815116913
"Mansfield town, Washington",190,172,18,53,42800,9.473684210526317
"Coulee Dam town, Washington",630,544,86,53,15115,13.65079365079365
"Springdale town, Washington",147,137,10,53,67210,6.802721088435375
"Bryn Mawr-Skyway CDP, Washington",6958,6567,391,53,08552,5.619430870939925
"Tenino city, Washington",721,681,40,53,70630,5.547850208044383
"Sedro-Woolley city, Washington",4197,4021,176,53,63210,4.193471527281392
"Banks Lake South CDP, Washington",101,77,24,53,04125,23.762376237623762
"Desert Aire CDP, Washington",1080,805,275,53,17617,25.462962962962965
"Grand Coulee city, Washington",589,429,160,53,27855,27.164685908319186
"Moses Lake city, Washington",9296,8245,1051,53,47245,11.305938037865747
"Moses Lake North CDP, Washington",1339,1266,73,53,47280,5.4518297236743845
"Easton CDP, Washington",439,198,241,53,19700,54.89749430523918
"Snoqualmie Pass CDP, Washington",540,118,422,53,65275,78.14814814814814
"Vantage CDP, Washington",10,10,0,53,74200,0.0
"DuPont city, Washington",3880,3619,261,53,18965,6.72680412371134
"Fife city, Washington",3931,3688,243,53,23795,6.181633172220809
"Frederickson CDP, Washington",7496,7132,364,53,25475,4.855923159018143
"Dayton city, Washington",1344,1200,144,53,16970,10.714285714285714
"Cle Elum city, Washington",1383,1245,138,53,12945,9.97830802603037
"Stuarts Draft CDP, Virginia",4239,3940,299,51,76272,7.053550365652277
"Fort Chiswell CDP, Virginia",330,305,25,51,29040,7.575757575757576
"Blue Ridge CDP, Virginia",1285,1246,39,51,08200,3.035019455252918
"Grundy town, Virginia",419,363,56,51,33648,13.365155131264917
"New Castle town, Virginia",121,92,29,51,55592,23.96694214876033
"Blacksburg town, Virginia",15253,13436,1817,51,07784,11.912410673310168
"Chatham town, Virginia",640,503,137,51,15000,21.40625
"Culpeper town, Virginia",6534,6112,422,51,20752,6.458524640342822
"Annandale CDP, Virginia",14536,13837,699,51,01912,4.808750687947166
"Centreville CDP, Virginia",25392,24524,868,51,14440,3.4183994959042217
"Great Falls CDP, Virginia",5251,4933,318,51,32496,6.055989335364693
"Wytheville town, Virginia",4268,3659,609,51,88000,14.268978444236177
"Alexandria city, Virginia",76105,69979,6126,51,01000,8.049405426713093
"Woodstock town, Virginia",2466,2158,308,51,87712,12.489862124898622
"Stanley town, Virginia",791,701,90,51,75024,11.378002528445007
"Patrick Springs CDP, Virginia",941,800,141,51,60984,14.984059511158343
"Stuart town, Virginia",652,573,79,51,76256,12.116564417177914
"Lawrenceville town, Virginia",559,439,120,51,44520,21.46690518783542
"Rustburg CDP, Virginia",620,587,33,51,69536,5.32258064516129
"Chatmoss CDP, Virginia",677,677,0,51,15048,0.0
"Stanleytown CDP, Virginia",720,561,159,51,75040,22.083333333333332
"Blackstone town, Virginia",1510,1158,352,51,07832,23.311258278145697
"Crewe town, Virginia",1153,1026,127,51,20160,11.014744145706851
"Crozet CDP, Virginia",2949,2762,187,51,20560,6.341132587317736
"Hopewell city, Virginia",10275,9193,1082,51,38424,10.530413625304135
"Hamilton town, Virginia",219,216,3,51,34240,1.36986301369863
"Hampton city, Virginia",60124,53700,6424,51,35000,10.68458519060608
"Louisa town, Virginia",747,700,47,51,47144,6.291834002677376
"Branchville town, Virginia",56,41,15,51,09208,26.785714285714285
"Raven CDP, Virginia",1069,795,274,51,65744,25.63143124415341
"Craigsville town, Virginia",425,358,67,51,19904,15.764705882352942
"Crimora CDP, Virginia",835,835,0,51,20240,0.0
"Westlake Corner CDP, Virginia",759,492,267,51,84632,35.177865612648226
"Pamplin City town, Virginia",62,35,27,51,60488,43.54838709677419
"Gate City town, Virginia",1053,897,156,51,30496,14.814814814814813
"Weber City town, Virginia",741,618,123,51,83808,16.599190283400812
"Clifton town, Virginia",118,104,14,51,17376,11.864406779661017
"Pennington Gap town, Virginia",1020,854,166,51,61560,16.274509803921568
"Bon Air CDP, Virginia",7136,6794,342,51,08472,4.792600896860987
"South Boston town, Virginia",3728,2915,813,51,73712,21.80793991416309
"Fort Hunt CDP, Virginia",5926,5867,59,51,29136,0.9956125548430644
"Salem city, Virginia",10852,9881,971,51,70000,8.947659417618873
"Vienna town, Virginia",5562,5470,92,51,81072,1.6540812657317512
"Wolf Trap CDP, Virginia",5559,5462,97,51,87240,1.7449181507465372
"Colonial Beach town, Virginia",2163,1571,592,51,18400,27.36939435968562
"Danville city, Virginia",22151,18479,3672,51,21344,16.577129700690712
"Woodbridge CDP, Virginia",1794,1737,57,51,87312,3.177257525083612
"Forest CDP, Virginia",4406,4157,249,51,28688,5.651384475714934
"Verona CDP, Virginia",1548,1465,83,51,80864,5.361757105943153
"Laymantown CDP, Virginia",770,770,0,51,44620,0.0
"Saltville town, Virginia",1117,964,153,51,70096,13.69740376007162
"Vinton town, Virginia",3781,3498,283,51,81280,7.484792382967469
"Winchester city, Virginia",11896,10554,1342,51,86720,11.281102891728311
"Clifton Forge town, Virginia",1839,1535,304,51,17440,16.53072321914084
"Woodlawn CDP (Fairfax County), Virginia",7643,7055,588,51,87410,7.693314143660866
"Columbia CDP, Virginia",29,25,4,51,18624,13.793103448275861
"Tysons CDP, Virginia",11621,10677,944,51,79950,8.123225195766286
"Mount Hermon CDP, Virginia",1765,1696,69,51,53944,3.9093484419263453
"Mount Sidney CDP, Virginia",162,162,0,51,54120,0.0
"Nathalie CDP, Virginia",68,26,42,51,55000,61.76470588235294
"Neabsco CDP, Virginia",6264,5725,539,51,55272,8.604725415070243
"Nellysford CDP, Virginia",809,704,105,51,55400,12.978986402966624
"Nelsonia CDP, Virginia",290,247,43,51,55448,14.827586206896552
"New Baltimore CDP, Virginia",3247,3104,143,51,55528,4.404065291037881
"New Church CDP, Virginia",115,69,46,51,55608,40.0
"New Hope CDP, Virginia",342,342,0,51,55720,0.0
"Newington Forest CDP, Virginia",4316,4146,170,51,55758,3.9388322520852643
"New Kent CDP, Virginia",161,120,41,51,55800,25.465838509316768
"New River CDP, Virginia",135,135,0,51,56048,0.0
"Nottoway Court House CDP, Virginia",116,79,37,51,57870,31.896551724137932
"Oak Grove CDP, Virginia",718,718,0,51,58104,0.0
"Oak Hall CDP, Virginia",108,108,0,51,58184,0.0
"Opal CDP, Virginia",255,255,0,51,59416,0.0
"Palmyra CDP, Virginia",44,44,0,51,60392,0.0
"Parrott CDP, Virginia",238,238,0,51,60840,0.0
"Passapatanzy CDP, Virginia",496,496,0,51,60888,0.0
"Pastoria CDP, Virginia",376,321,55,51,60920,14.627659574468085
"Piney Mountain CDP, Virginia",545,512,33,51,62738,6.055045871559633
"Plum Creek CDP, Virginia",751,710,41,51,63190,5.459387483355526
"Potomac Mills CDP, Virginia",1963,1864,99,51,64152,5.043301069791136
"Prices Fork CDP, Virginia",468,452,16,51,64512,3.418803418803419
"Prince George CDP, Virginia",753,640,113,51,64560,15.0066401062417
"Pungoteague CDP, Virginia",187,124,63,51,64976,33.68983957219251
"Quantico Base CDP, Virginia",1035,1007,28,51,65128,2.7053140096618358
"Quinby CDP, Virginia",163,103,60,51,65280,36.809815950920246
"Ravensworth CDP, Virginia",807,793,14,51,65776,1.734820322180917
"Riner CDP, Virginia",416,373,43,51,67256,10.336538461538462
"Rivanna CDP, Virginia",806,741,65,51,67331,8.064516129032258
"Riverdale CDP, Virginia",384,301,83,51,67352,21.614583333333336
"Riverview CDP, Virginia",326,291,35,51,67704,10.736196319018406
"Rockwood CDP, Virginia",3321,3252,69,51,68470,2.077687443541102
"Ruckersville CDP, Virginia",530,530,0,51,69360,0.0
"Saluda CDP, Virginia",196,168,28,51,70112,14.285714285714285
"Savageville CDP, Virginia",50,50,0,51,70528,0.0
"Sandston CDP, Virginia",3224,3010,214,51,70256,6.637717121588089
"Sanford CDP, Virginia",104,55,49,51,70352,47.11538461538461
"Savage Town CDP, Virginia",45,21,24,51,70520,53.333333333333336
"Schuyler CDP, Virginia",159,54,105,51,70704,66.0377358490566
"Scotland CDP, Virginia",85,51,34,51,70715,40.0
"Sedley CDP, Virginia",213,190,23,51,71040,10.7981220657277
"Seven Mile Ford CDP, Virginia",294,265,29,51,71264,9.863945578231291
"Shawneeland CDP, Virginia",824,661,163,51,71625,19.781553398058254
"Shenandoah Farms CDP, Virginia",1513,1264,249,51,71810,16.457369464639786
"Shenandoah Retreat CDP, Virginia",361,301,60,51,71825,16.62049861495845
"Shenandoah Shores CDP, Virginia",377,355,22,51,71826,5.835543766578249
"Shipman CDP, Virginia",302,196,106,51,72080,35.099337748344375
"Skyland Estates CDP, Virginia",437,391,46,51,72935,10.526315789473683
"Snowville CDP, Virginia",35,27,8,51,73376,22.857142857142858
"Southern Gateway CDP, Virginia",1378,1378,0,51,73760,0.0
"South Riding CDP, Virginia",9796,9647,149,51,74100,1.5210289914250714
"South Run CDP, Virginia",2228,2141,87,51,74120,3.9048473967684023
"Southside Chesconessex CDP, Virginia",126,58,68,51,74160,53.96825396825397
"Sperryville CDP, Virginia",182,110,72,51,74384,39.56043956043956
"Springville CDP, Virginia",579,483,96,51,74848,16.580310880829018
"Stafford Courthouse CDP, Virginia",934,892,42,51,74916,4.496788008565311
"Sterling CDP, Virginia",9708,9402,306,51,75376,3.15203955500618
"Stone Ridge CDP, Virginia",4035,4005,30,51,75702,0.7434944237918215
"Sugarland Run CDP, Virginia",3742,3687,55,51,76464,1.469802244788883
"Sussex CDP, Virginia",87,87,0,51,76912,0.0
"Tasley CDP, Virginia",172,115,57,51,77648,33.13953488372093
"Temperanceville CDP, Virginia",162,123,39,51,77856,24.074074074074073
"Templeton CDP, Virginia",126,101,25,51,77925,19.841269841269842
"Thynedale CDP, Virginia",61,61,0,51,78532,0.0
"Twin Lakes CDP, Virginia",505,505,0,51,79768,0.0
"Union Level CDP, Virginia",107,107,0,51,80016,0.0
"University Center CDP, Virginia",1745,1660,85,51,80120,4.871060171919771
"University of Virginia CDP, Virginia",1458,1218,240,51,80165,16.46090534979424
"Wakefield CDP, Virginia",3774,3745,29,51,82371,0.7684154742978272
"Warfield CDP, Virginia",100,64,36,51,83056,36.0
"Warm Springs CDP, Virginia",47,14,33,51,83088,70.2127659574468
"Wattsville CDP, Virginia",639,444,195,51,83568,30.51643192488263
"Whitesville CDP, Virginia",59,48,11,51,85608,18.64406779661017
"Wintergreen CDP, Virginia",2175,288,1887,51,87008,86.75862068965517
"Woodburn CDP, Virginia",3180,3080,100,51,87333,3.1446540880503147
"Woodlake CDP, Virginia",2596,2488,108,51,87380,4.160246533127889
"Woodlawn CDP (Carroll County), Virginia",937,858,79,51,87408,8.431163287086447
"Yogaville CDP, Virginia",176,110,66,51,88145,37.5
"Allisonia CDP, Virginia",145,51,94,51,01256,64.82758620689654
"Amelia Court House CDP, Virginia",381,338,43,51,01640,11.286089238845145
"Apple Mountain Lake CDP, Virginia",536,520,16,51,02064,2.9850746268656714
"Arcola CDP, Virginia",459,404,55,51,02248,11.982570806100219
"Arrington CDP, Virginia",391,264,127,51,03208,32.48081841432225
"Ashburn CDP, Virginia",18188,17710,478,51,03320,2.628106443809105
"Atlantic CDP, Virginia",583,452,131,51,03528,22.46998284734134
"Augusta Springs CDP, Virginia",159,120,39,51,03608,24.528301886792452
"Baskerville CDP, Virginia",37,25,12,51,04856,32.432432432432435
"Basye CDP, Virginia",1649,440,1209,51,04920,73.31716191631291
"Bayside CDP, Virginia",160,117,43,51,05200,26.875
"Bealeton CDP, Virginia",1506,1425,81,51,05336,5.378486055776892
"Belview CDP, Virginia",498,376,122,51,06512,24.497991967871485
"Belmont CDP, Virginia",1832,1823,9,51,06275,0.49126637554585156
"Belmont Estates CDP, Virginia",620,608,12,51,06336,1.935483870967742
"Belspring CDP, Virginia",61,61,0,51,06424,0.0
"Benns Church CDP, Virginia",291,228,63,51,06712,21.649484536082475
"Bethel Manor CDP, Virginia",1182,1139,43,51,07160,3.6379018612521152
"Big Island CDP, Virginia",142,123,19,51,07400,13.380281690140844
"Blairs CDP, Virginia",411,353,58,51,07944,14.111922141119221
"Bland CDP, Virginia",263,253,10,51,07976,3.802281368821293
"Blue Ridge Shores CDP, Virginia",610,340,270,51,08264,44.26229508196721
"Bobtown CDP, Virginia",93,93,0,51,08320,0.0
"Boston CDP, Virginia",250,207,43,51,08675,17.2
"Boswell's Corner CDP, Virginia",397,393,4,51,08708,1.0075566750629723
"Bracey CDP, Virginia",2071,549,1522,51,09064,73.49106711733462
"Brambleton CDP, Virginia",6317,6246,71,51,09188,1.1239512426784866
"Brandermill CDP, Virginia",6090,6026,64,51,09248,1.0509031198686372
"Brightwood CDP, Virginia",503,503,0,51,09752,0.0
"Broadlands CDP, Virginia",4214,4144,70,51,09952,1.6611295681063125
"Buckhall CDP, Virginia",5328,5107,221,51,10776,4.147897897897898
"Buckingham Courthouse CDP, Virginia",99,33,66,51,10856,66.66666666666666
"Bull Run Mountain Estates CDP, Virginia",449,443,6,51,11245,1.3363028953229399
"Burke Centre CDP, Virginia",6306,6229,77,51,11470,1.2210593085949888
"Callaghan CDP, Virginia",153,124,29,51,12136,18.954248366013072
"Calverton CDP, Virginia",78,59,19,51,12264,24.358974358974358
"Camptown CDP, Virginia",406,383,23,51,12590,5.665024630541872
"Captains Cove CDP, Virginia",1040,496,544,51,12915,52.307692307692314
"Carrollton CDP, Virginia",2312,2171,141,51,13160,6.098615916955017
"Carrsville CDP, Virginia",143,97,46,51,13192,32.16783216783217
"Cascades CDP, Virginia",4544,4311,233,51,13403,5.127640845070423
"Catlett CDP, Virginia",187,131,56,51,13624,29.946524064171122
"Cats Bridge CDP, Virginia",165,86,79,51,13635,47.878787878787875
"Central Garage CDP, Virginia",528,513,15,51,14312,2.840909090909091
"Charles City CDP, Virginia",54,31,23,51,14904,42.592592592592595
"Chase Crossing CDP, Virginia",169,129,40,51,14995,23.668639053254438
"Cherry Hill CDP, Virginia",6508,6030,478,51,15176,7.344806392132759
"Chester Gap CDP, Virginia",444,377,67,51,16240,15.090090090090092
"Churchville CDP, Virginia",88,88,0,51,16736,0.0
"Clover CDP, Virginia",182,127,55,51,17632,30.21978021978022
"Cluster Springs CDP, Virginia",393,363,30,51,17776,7.633587786259542
"Concord CDP, Virginia",568,440,128,51,18880,22.535211267605636
"Countryside CDP, Virginia",3549,3395,154,51,19560,4.339250493096647
"County Center CDP, Virginia",996,996,0,51,19571,0.0
"Crosspointe CDP, Virginia",1794,1794,0,51,20436,0.0
"Cumberland CDP, Virginia",177,106,71,51,20768,40.11299435028249
"Quantico town, Virginia",342,287,55,51,65120,16.08187134502924
"Yorkshire CDP, Virginia",2874,2802,72,51,88176,2.5052192066805845
"Irvington town, Virginia",321,174,147,51,40088,45.794392523364486
"Portsmouth city, Virginia",40895,36471,4424,51,64000,10.817948404450421
"Bensley CDP, Virginia",2440,2274,166,51,06728,6.80327868852459
"Scottsburg town, Virginia",128,108,20,51,70752,15.625
"Belle Haven CDP, Virginia",3173,2980,193,51,05928,6.082571698707848
"Burke CDP, Virginia",13776,13473,303,51,11464,2.1994773519163764
"Dunn Loring CDP, Virginia",2990,2881,109,51,23984,3.6454849498327757
"Hybla Valley CDP, Virginia",6181,5634,547,51,39304,8.849700695680312
"Rural Retreat town, Virginia",772,683,89,51,69456,11.528497409326425
"Bridgewater town, Virginia",2262,2175,87,51,09656,3.8461538461538463
"Sugar Grove CDP, Virginia",448,305,143,51,76448,31.919642857142854
"Pulaski town, Virginia",4600,3828,772,51,64880,16.782608695652172
"Elkton town, Virginia",1443,1287,156,51,25408,10.81081081081081
"Coeburn town, Virginia",882,666,216,51,17952,24.489795918367346
"Pembroke town, Virginia",524,458,66,51,61336,12.595419847328243
"Port Royal town, Virginia",101,82,19,51,63928,18.81188118811881
"Goshen town, Virginia",225,157,68,51,31968,30.22222222222222
"Stanardsville town, Virginia",195,153,42,51,75008,21.53846153846154
"Hollins CDP, Virginia",6350,5909,441,51,37880,6.94488188976378
"Manassas Park city, Virginia",4884,4706,178,51,48968,3.644553644553645
"Tappahannock town, Virginia",1171,845,326,51,77568,27.83945345858241
"Weyers Cave CDP, Virginia",1012,897,115,51,85184,11.363636363636363
"Cedar Bluff town, Virginia",550,482,68,51,13784,12.363636363636363
"East Highland Park CDP, Virginia",6491,6152,339,51,24496,5.2226159297488834
"Lebanon town, Virginia",1669,1416,253,51,44696,15.158777711204314
"Mantua CDP, Virginia",2772,2540,232,51,49144,8.369408369408369
"Cape Charles town, Virginia",989,579,410,51,12808,41.45601617795754
"Brodnax town, Virginia",115,99,16,51,10072,13.91304347826087
"Sudley CDP, Virginia",5515,5252,263,51,76416,4.768812330009066
"Ettrick CDP, Virginia",1541,1326,215,51,26128,13.951979234263465
"Fort Belvoir CDP, Virginia",2081,1959,122,51,29008,5.862566074002883
"Pearisburg town, Virginia",1197,1014,183,51,61208,15.288220551378446
"Aquia Harbour CDP, Virginia",2546,2439,107,51,02112,4.20267085624509
"Clintwood town, Virginia",663,549,114,51,17552,17.194570135746606
"Bailey's Crossroads CDP, Virginia",9669,9098,571,51,04088,5.905471093184404
"Monterey town, Virginia",142,90,52,51,52680,36.61971830985916
"Duffield town, Virginia",35,35,0,51,23680,0.0
"Bull Run CDP, Virginia",6032,5489,543,51,11230,9.001989389920425
"Greenville CDP, Virginia",456,424,32,51,32944,7.017543859649122
"Roanoke city, Virginia",47056,42037,5019,51,68000,10.666014960897655
"Chilhowie town, Virginia",833,697,136,51,16480,16.3265306122449
"Yorktown CDP, Virginia",145,145,0,51,88240,0.0
"Clinchco town, Virginia",205,136,69,51,17504,33.65853658536586
"Haysi town, Virginia",152,122,30,51,36008,19.736842105263158
"Brookneal town, Virginia",518,381,137,51,10296,26.44787644787645
"Horse Pasture CDP, Virginia",1042,886,156,51,38552,14.971209213051823
"Sandy Level CDP, Virginia",349,275,74,51,70296,21.20343839541547
"Parksley town, Virginia",384,298,86,51,60680,22.395833333333336
"Front Royal town, Virginia",6239,5624,615,51,29968,9.857348934124058
"Chesapeake city, Virginia",89882,84230,5652,51,16000,6.288244587347856
"Wyndham CDP, Virginia",3509,3384,125,51,87960,3.562268452550584
"Matoaca CDP, Virginia",1017,940,77,51,50136,7.571288102261553
"Virgilina town, Virginia",66,49,17,51,81312,25.757575757575758
"Herndon town, Virginia",7960,7706,254,51,36648,3.1909547738693465
"Lorton CDP, Virginia",6919,6517,402,51,47064,5.81008816302934
"Newington CDP, Virginia",4401,4214,187,51,55752,4.249034310384003
"Pimmit Hills CDP, Virginia",2225,2130,95,51,62264,4.269662921348314
"West Springfield CDP, Virginia",8522,8358,164,51,84976,1.9244308847688334
"Windsor town, Virginia",1074,1022,52,51,86784,4.8417132216014895
"Mineral town, Virginia",193,188,5,51,52120,2.5906735751295336
"Cheriton town, Virginia",276,236,40,51,15112,14.492753623188406
"Exmore town, Virginia",860,718,142,51,26416,16.511627906976745
"Ewing CDP, Virginia",148,97,51,51,26384,34.45945945945946
"Chase City town, Virginia",1184,891,293,51,14984,24.74662162162162
"South Hill town, Virginia",2084,1739,345,51,73904,16.554702495201536
"Eastville town, Virginia",108,82,26,51,24752,24.074074074074073
"Ferrum CDP, Virginia",515,436,79,51,27712,15.339805825242719
"Union Hall CDP, Virginia",1103,499,604,51,80000,54.75974614687217
"La Crosse town, Virginia",315,207,108,51,43176,34.285714285714285
"Highland Springs CDP, Virginia",6725,6166,559,51,37032,8.312267657992566
"Hillsville town, Virginia",1612,1256,356,51,37336,22.084367245657567
"Dryden CDP, Virginia",491,406,85,51,23584,17.311608961303463
"Castlewood CDP, Virginia",1021,841,180,51,13512,17.62977473065622
"Lake Monticello CDP, Virginia",4406,4137,269,51,43424,6.10531093962778
"Shenandoah town, Virginia",1163,1028,135,51,71776,11.607910576096304
"Dublin town, Virginia",993,874,119,51,23648,11.983887210473315
"McKenney town, Virginia",232,186,46,51,48344,19.82758620689655
"Collinsville CDP, Virginia",3894,3177,717,51,18352,18.412942989214176
"Williamsburg city, Virginia",5194,4670,524,51,86160,10.088563727377743
"Selma CDP, Virginia",195,171,24,51,71072,12.307692307692308
"Dumbarton CDP, Virginia",3850,3604,246,51,23744,6.3896103896103895
"Laurel CDP, Virginia",7297,6726,571,51,44280,7.825133616554749
"Waverly town, Virginia",978,809,169,51,83600,17.280163599182004
"Rose Hill CDP (Fairfax County), Virginia",7374,7033,341,51,68880,4.62435584486032
"Kilmarnock town, Virginia",930,772,158,51,42424,16.989247311827956
"Franconia CDP, Virginia",7645,7399,246,51,29552,3.2177894048397646
"Groveton CDP, Virginia",5947,5703,244,51,33584,4.102909029762905
"Waynesboro city, Virginia",10013,9144,869,51,83680,8.678717667032858
"Montross town, Virginia",268,232,36,51,52952,13.432835820895523
"Christiansburg town, Virginia",10272,9416,856,51,16608,8.333333333333332
"Merrimac CDP, Virginia",1202,1039,163,51,51208,13.560732113144757
"Capron town, Virginia",78,59,19,51,12904,24.358974358974358
"Dooms CDP, Virginia",613,511,102,51,22976,16.6394779771615
"Sherando CDP, Virginia",311,268,43,51,71904,13.826366559485532
"Rocky Mount town, Virginia",2310,2123,187,51,68496,8.095238095238095
"Claremont town, Virginia",220,146,74,51,16880,33.63636363636363
"Warsaw town, Virginia",756,670,86,51,83168,11.375661375661375
"Dillwyn town, Virginia",192,167,25,51,22560,13.020833333333334
"Spotsylvania Courthouse CDP, Virginia",1674,1545,129,51,74470,7.706093189964158
"Wise town, Virginia",1566,1329,237,51,87072,15.134099616858238
"Low Moor CDP, Virginia",150,126,24,51,47352,16.0
"Gloucester Courthouse CDP, Virginia",1010,950,60,51,31608,5.9405940594059405
"Fries town, Virginia",279,198,81,51,29920,29.03225806451613
"Fredericksburg city, Virginia",11589,10582,1007,51,29744,8.689274311847441
"Glasgow town, Virginia",595,513,82,51,31136,13.781512605042018
"Massanutten CDP, Virginia",2548,960,1588,51,50030,62.32339089481946
"Suffolk city, Virginia",36213,33198,3015,51,76432,8.325739375362438
"Emporia city, Virginia",2401,2119,282,51,25808,11.745106205747605
"Remington town, Virginia",293,291,2,51,66512,0.6825938566552902
"Villa Heights CDP, Virginia",299,252,47,51,81152,15.719063545150503
"Dendron town, Virginia",193,140,53,51,22160,27.461139896373055
"Big Stone Gap town, Virginia",1933,1713,220,51,07480,11.381272633212623
"Charlottesville city, Virginia",20499,18613,1886,51,14968,9.200448802380604
"Fort Lee CDP, Virginia",1430,1352,78,51,29152,5.454545454545454
"Merrifield CDP, Virginia",8413,7623,790,51,51192,9.390229406870318
"Iron Gate town, Virginia",150,116,34,51,40024,22.666666666666664
"Idylwood CDP, Virginia",6936,6676,260,51,39448,3.748558246828143
"Oakton CDP, Virginia",13977,13440,537,51,58472,3.8420261858767977
"Springfield CDP, Virginia",10493,10139,354,51,74592,3.373677689888497
"Rushmere CDP, Virginia",506,426,80,51,69472,15.810276679841898
"Madison town, Virginia",123,81,42,51,48488,34.146341463414636
"Shawsville CDP, Virginia",761,599,162,51,71632,21.28777923784494
"Boykins town, Virginia",334,302,32,51,09032,9.580838323353294
"Lyndhurst CDP, Virginia",717,657,60,51,47720,8.368200836820083
"Accomac town, Virginia",212,174,38,51,00180,17.92452830188679
"Chamberlayne CDP, Virginia",2469,2357,112,51,14544,4.5362494937221545
"Keller town, Virginia",81,66,15,51,41656,18.51851851851852
"Melfa town, Virginia",189,176,13,51,50984,6.878306878306878
"Penhook CDP, Virginia",969,413,556,51,61464,57.378740970072236
"Tuckahoe CDP, Virginia",19695,18328,1367,51,79560,6.940847930946941
"Dahlgren CDP, Virginia",1167,1120,47,51,21008,4.027420736932305
"Nassawadox town, Virginia",237,195,42,51,54984,17.72151898734177
"Cleveland town, Virginia",109,57,52,51,17296,47.706422018348626
"Honaker town, Virginia",744,566,178,51,38280,23.9247311827957
"Martinsville city, Virginia",7090,5630,1460,51,49784,20.59238363892807
"Strasburg town, Virginia",2838,2664,174,51,76000,6.13107822410148
"Fairlawn CDP, Virginia",1336,1140,196,51,26736,14.67065868263473
"Gordonsville town, Virginia",758,703,55,51,31936,7.255936675461741
"Wakefield town, Virginia",545,482,63,51,82384,11.559633027522937
"Damascus town, Virginia",444,318,126,51,21184,28.37837837837838
"Glade Spring town, Virginia",675,571,104,51,31056,15.407407407407408
"Gretna town, Virginia",694,622,72,51,33232,10.37463976945245
"Pocahontas town, Virginia",215,163,52,51,63288,24.186046511627907
"Madison Heights CDP, Virginia",4920,4552,368,51,48520,7.479674796747967
"Jolivue CDP, Virginia",556,485,71,51,41144,12.769784172661872
"Reston CDP, Virginia",26703,25232,1471,51,66672,5.508744335842414
"West Point town, Virginia",1404,1324,80,51,84960,5.698005698005698
"Richlands town, Virginia",3027,2412,615,51,66928,20.317145688800792
"Tazewell town, Virginia",1910,1666,244,51,77792,12.774869109947645
"Berryville town, Virginia",1666,1518,148,51,06968,8.883553421368548
"Bloxom town, Virginia",197,175,22,51,08120,11.16751269035533
"Chincoteague town, Virginia",4491,1523,2968,51,16512,66.08773101759073
"Painter town, Virginia",119,98,21,51,60296,17.647058823529413
"Petersburg city, Virginia",16377,13274,3103,51,61832,18.947304146058496
"Linton Hall CDP, Virginia",11800,11507,293,51,45957,2.483050847457627
"Loch Lomond CDP, Virginia",1180,1163,17,51,46328,1.4406779661016949
"Mount Jackson town, Virginia",954,873,81,51,53992,8.49056603773585
"Richmond city, Virginia",100119,89846,10273,51,67000,10.260789660304239
"Washington town, Virginia",53,48,5,51,83248,9.433962264150944
"Hurt town, Virginia",747,651,96,51,39224,12.851405622489958
"Bluefield town, Virginia",2314,2139,175,51,08152,7.56266205704408
"Hallwood town, Virginia",137,100,37,51,34176,27.00729927007299
"Victoria town, Virginia",958,767,191,51,81024,19.937369519832984
"Urbanna town, Virginia",414,233,181,51,80272,43.71980676328502
"Gloucester Point CDP, Virginia",4428,3965,463,51,31616,10.456187895212285
"Grottoes town, Virginia",1224,1166,58,51,33488,4.738562091503268
"Mount Crawford town, Virginia",205,172,33,51,53864,16.097560975609756
"Saxis town, Virginia",181,96,85,51,70576,46.96132596685083
"Troutville town, Virginia",237,225,12,51,79472,5.063291139240507
"Kenbridge town, Virginia",641,440,201,51,41832,31.357254290171603
"Newsoms town, Virginia",141,123,18,51,56096,12.76595744680851
"Fishersville CDP, Virginia",3415,3131,284,51,27968,8.316251830161054
"Tangier town, Virginia",286,215,71,51,77520,24.825174825174827
"Wachapreague town, Virginia",279,120,159,51,82320,56.98924731182796
"Max Meadows CDP, Virginia",162,116,46,51,50312,28.39506172839506
"Vansant CDP, Virginia",265,208,57,51,80608,21.50943396226415
"Montrose CDP, Virginia",3682,3187,495,51,52904,13.443780554046715
"Short Pump CDP, Virginia",10978,10250,728,51,72272,6.631444707597012
"Stony Creek town, Virginia",92,68,24,51,75840,26.08695652173913
"Covington city, Virginia",3006,2409,597,51,19728,19.860279441117765
"Keysville town, Virginia",440,358,82,51,42264,18.636363636363637
"Narrows town, Virginia",1032,887,145,51,54904,14.050387596899224
"Laurel Park CDP, Virginia",399,254,145,51,44476,36.340852130325814
"Marion town, Virginia",2834,2480,354,51,49464,12.491178546224418
"Cave Spring CDP, Virginia",12140,11377,763,51,13720,6.285008237232289
"Timberlake CDP, Virginia",5785,5383,402,51,78688,6.949006050129645
"Pound town, Virginia",472,393,79,51,64272,16.73728813559322
"Leesburg town, Virginia",18105,17456,649,51,44984,3.5846451256558964
"Round Hill town, Virginia",268,257,11,51,69168,4.104477611940299
"Norton city, Virginia",2040,1819,221,51,57688,10.833333333333334
"Bowling Green town, Virginia",529,492,37,51,08888,6.994328922495274
"St. Paul town, Virginia",506,438,68,51,69936,13.438735177865613
"Altavista town, Virginia",1592,1458,134,51,01528,8.417085427135678
"Appomattox town, Virginia",918,793,125,51,02072,13.616557734204793
"Warrenton town, Virginia",4118,3764,354,51,83136,8.596406022340943
"Broadway town, Virginia",1704,1651,53,51,10040,3.1103286384976525
"Keokee CDP, Virginia",195,158,37,51,42104,18.974358974358974
"Rose Hill CDP (Lee County), Virginia",319,294,25,51,68885,7.836990595611286
"Clarksville town, Virginia",897,548,349,51,16992,38.90746934225195
"Gainesville CDP, Virginia",5066,4833,233,51,30176,4.599289380181603
"Nokesville CDP, Virginia",551,483,68,51,56464,12.341197822141561
"St. Charles town, Virginia",44,36,8,51,69792,18.181818181818183
"Clinchport town, Virginia",42,24,18,51,17536,42.857142857142854
"Cana CDP, Virginia",831,708,123,51,12600,14.801444043321299
"Dale City CDP, Virginia",21753,20878,875,51,21088,4.022433687307498
"Dumfries town, Virginia",1719,1518,201,51,23760,11.69284467713787
"Lake Ridge CDP, Virginia",15672,15093,579,51,43432,3.6944869831546705
"Montclair CDP, Virginia",7134,6998,136,51,52658,1.9063638912251193
"Colonial Heights city, Virginia",7752,7054,698,51,18448,9.004127966976263
"Triangle CDP, Virginia",3308,3097,211,51,79360,6.378476420798066
"Norfolk city, Virginia",97257,88155,9102,51,57000,9.35870939880934
"Bellwood CDP, Virginia",2663,2314,349,51,06216,13.105520090123921
"Chester CDP, Virginia",8484,8109,375,51,16096,4.42008486562942
"Halifax town, Virginia",629,558,71,51,34064,11.287758346581876
"Chantilly CDP, Virginia",7391,7283,108,51,14744,1.4612366391557299
"Lincolnia CDP, Virginia",8761,8246,515,51,45784,5.878324392192672
"McLean CDP, Virginia",17585,16447,1138,51,48376,6.471424509525163
"Mount Vernon CDP, Virginia",4727,4471,256,51,54144,5.415697059445737
"Seven Corners CDP, Virginia",3700,3485,215,51,71216,5.810810810810811
"Ivor town, Virginia",214,193,21,51,40232,9.813084112149532
"Claypool Hill CDP, Virginia",730,638,92,51,17120,12.602739726027398
"Amherst town, Virginia",1184,1049,135,51,01672,11.402027027027026
"Boyce town, Virginia",285,257,28,51,08984,9.824561403508772
"Belle Haven town, Virginia",316,258,58,51,05912,18.354430379746837
"Jonesville town, Virginia",703,602,101,51,41272,14.366998577524893
"Occoquan town, Virginia",595,550,45,51,58696,7.563025210084033
"Luray town, Virginia",2224,1894,330,51,47528,14.838129496402876
"Buena Vista city, Virginia",2878,2539,339,51,11032,11.779013203613621
"Boones Mill town, Virginia",122,80,42,51,08584,34.42622950819672
"Ashland town, Virginia",2923,2727,196,51,03368,6.705439616832022
"Mechanicsville CDP, Virginia",15425,14634,791,51,50856,5.128038897893031
"Falmouth CDP, Virginia",1703,1656,47,51,27264,2.7598355842630653
"White Stone town, Virginia",207,176,31,51,85600,14.975845410628018
"Franklin city, Virginia",3852,3526,326,51,29600,8.463136033229492
"Huntington CDP, Virginia",7122,6544,578,51,39064,8.115697837686044
"Lake Barcroft CDP, Virginia",3818,3597,221,51,43352,5.788370874803562
"North Springfield CDP, Virginia",2255,2154,101,51,57560,4.478935698447894
"Fairview Beach CDP, Virginia",353,214,139,51,27040,39.376770538243626
"Farmville town, Virginia",3100,2316,784,51,27440,25.290322580645164
"Cathlamet town, Washington",328,275,53,53,10635,16.158536585365855
"Nickelsville town, Virginia",207,154,53,51,56304,25.60386473429952
"Galax city, Virginia",3367,2742,625,51,30208,18.562518562518562
"Lacey city, Washington",19819,18711,1108,53,36745,5.590594883697462
"Carlsborg CDP, Washington",375,337,38,53,10075,10.133333333333333
"River Road CDP, Washington",307,307,0,53,58777,0.0
"Bingen city, Washington",284,226,58,53,06085,20.422535211267608
"Dallesport CDP, Washington",601,536,65,53,16550,10.8153078202995
"Maryhill CDP, Washington",24,24,0,53,43885,0.0
"Chinook CDP, Washington",314,142,172,53,12315,54.77707006369427
"Quincy city, Washington",2046,1899,147,53,57115,7.184750733137831
"Wilson Creek town, Washington",160,115,45,53,79135,28.125
"Cusick town, Washington",95,46,49,53,16340,51.578947368421055
"Metaline town, Washington",89,68,21,53,45285,23.595505617977526
"Metaline Falls town, Washington",208,115,93,53,45320,44.71153846153847
"Eatonville town, Washington",1211,1177,34,53,20260,2.8075970272502064
"McChord AFB CDP, Washington",875,793,82,53,41155,9.37142857142857
"Gleed CDP, Washington",1063,1063,0,53,26945,0.0
"Roy city, Washington",311,268,43,53,60160,13.826366559485532
"Spanaway CDP, Washington",11532,10780,752,53,66255,6.520985084980922
"Summit CDP, Washington",3277,3050,227,53,68365,6.927067439731462
"Tacoma city, Washington",89664,82540,7124,53,70000,7.945217701641684
"Geneva CDP, Washington",931,931,0,53,26420,0.0
"Sumas city, Washington",610,580,30,53,68330,4.918032786885246
"Cheney city, Washington",4843,4318,525,53,11825,10.840388189138963
"Ocean Park CDP, Washington",1886,755,1131,53,50535,59.96818663838812
"Darrington town, Washington",619,540,79,53,16690,12.762520193861066
"Benton City city, Washington",1246,1194,52,53,05560,4.173354735152488
"Kennewick city, Washington",30384,28364,2020,53,35275,6.648235913638757
"Burbank CDP, Washington",1220,1191,29,53,08780,2.3770491803278686
"Garrett CDP, Washington",592,528,64,53,26245,10.81081081081081
"Kendall CDP, Washington",46,0,46,53,35135,100.0
"Republic city, Washington",670,561,109,53,57850,16.268656716417908
"Clinton CDP, Washington",514,407,107,53,13155,20.817120622568094
"Almira town, Washington",130,101,29,53,01500,22.30769230769231
"Walla Walla East CDP, Washington",717,717,0,53,75810,0.0
"Birch Bay CDP, Washington",5831,4090,1741,53,06190,29.85765734865375
"Fairfield town, Washington",238,215,23,53,22990,9.663865546218489
"Pasco city, Washington",22064,21283,781,53,53545,3.539702683103698
"South Bend city, Washington",801,612,189,53,65625,23.595505617977526
"Gold Bar city, Washington",844,789,55,53,27365,6.516587677725119
"Lake Bosworth CDP, Washington",419,385,34,53,37077,8.1145584725537
"Maltby CDP, Washington",4299,4207,92,53,42415,2.140032565712956
"Tokeland CDP, Washington",182,133,49,53,71680,26.923076923076923
"Granite Falls city, Washington",1478,1448,30,53,27995,2.029769959404601
"Lake Stevens city, Washington",11305,10976,329,53,37900,2.910216718266254
"Lynnwood city, Washington",15113,14224,889,53,40840,5.88235294117647
"Machias CDP, Washington",439,324,115,53,41470,26.195899772209568
"North Marysville CDP, Washington",66,66,0,53,49992,0.0
"Snohomish city, Washington",4076,3903,173,53,65170,4.244357212953876
"Startup CDP, Washington",308,308,0,53,67595,0.0
"Kalama city, Washington",1144,1064,80,53,34645,6.993006993006993
"Longview city, Washington",16808,15757,1051,53,40245,6.252974773917182
"McCleary city, Washington",859,770,89,53,41225,10.360884749708964
"Westport city, Washington",1669,938,731,53,77630,43.79868184541642
"Bainbridge Island city, Washington",10585,9857,728,53,03736,6.877657061880019
"Van CDP, West Virginia",110,110,0,54,82852,0.0
"Terrace Heights CDP, Washington",3398,3208,190,53,70805,5.591524426133019
"Zillah city, Washington",1209,1077,132,53,80500,10.918114143920596
"Valley Head CDP, West Virginia",185,141,44,54,82756,23.783783783783786
"Verdunville CDP, West Virginia",307,251,56,54,83332,18.241042345276874
"Vivian CDP, West Virginia",52,16,36,54,83764,69.23076923076923
"Waverly CDP, West Virginia",204,177,27,54,84916,13.23529411764706
"Whitmer CDP, West Virginia",24,12,12,54,86932,50.0
"Wolf Summit CDP, West Virginia",120,97,23,54,88276,19.166666666666668
"Summersville city, West Virginia",1728,1663,65,54,77980,3.761574074074074
"Arbovale CDP, West Virginia",142,93,49,54,02260,34.50704225352113
"Parcoal CDP, West Virginia",49,49,0,54,62044,0.0
"St. George CDP, West Virginia",85,63,22,54,71284,25.882352941176475
"Wallace CDP, West Virginia",126,126,0,54,84172,0.0
"Edgar village, Wisconsin",621,601,20,55,22550,3.22061191626409
"Howards Grove village, Wisconsin",1252,1243,9,55,36025,0.7188498402555911
"Racine city, Wisconsin",33666,30378,3288,55,66000,9.766530030297629
"Alma city, Wisconsin",501,378,123,55,01225,24.550898203592812
"Centuria village, Wisconsin",430,383,47,55,13850,10.930232558139535
"Roberts village, Wisconsin",742,708,34,55,68475,4.5822102425876015
"Mount Calvary village, Wisconsin",212,212,0,55,54650,0.0
"Greendale village, Wisconsin",6237,5960,277,55,31125,4.441237774571108
"Oconomowoc city, Wisconsin",7059,6743,316,55,59250,4.476554752797847
"Amery city, Wisconsin",1356,1179,177,55,01725,13.053097345132745
"New Post CDP, Wisconsin",362,153,209,55,57050,57.73480662983425
"Hustler village, Wisconsin",116,109,7,55,36675,6.0344827586206895
"Rockland village, Wisconsin",257,234,23,55,68900,8.949416342412452
"Luxemburg village, Wisconsin",1001,954,47,55,46400,4.695304695304695
"Evansville city, Wisconsin",2296,2156,140,55,24550,6.097560975609756
"Kewaunee city, Wisconsin",1627,1382,245,55,39350,15.05838967424708
"Grand View CDP, Wisconsin",55,49,6,55,30150,10.909090909090908
"Greenbush CDP, Wisconsin",64,54,10,55,31075,15.625
"Greenleaf CDP, Wisconsin",281,281,0,55,31375,0.0
"Green Valley CDP, Wisconsin",59,48,11,55,31475,18.64406779661017
"Hager City CDP, Wisconsin",118,115,3,55,31975,2.5423728813559325
"Hanover CDP, Wisconsin",73,56,17,55,32550,23.28767123287671
"Hatfield CDP, Wisconsin",154,93,61,55,33150,39.61038961038961
"Herbster CDP, Wisconsin",159,44,115,55,33975,72.32704402515722
"Hingham CDP, Wisconsin",315,310,5,55,35000,1.5873015873015872
"Holcombe CDP, Wisconsin",104,96,8,55,35225,7.6923076923076925
"Houlton CDP, Wisconsin",104,90,14,55,35900,13.461538461538462
"Humbird CDP, Wisconsin",118,99,19,55,36400,16.101694915254235
"Iron Belt CDP, Wisconsin",131,94,37,55,37125,28.24427480916031
"Iron River CDP, Wisconsin",468,343,125,55,37175,26.70940170940171
"Jim Falls CDP, Wisconsin",154,140,14,55,38225,9.090909090909092
"Juda CDP, Wisconsin",109,109,0,55,38600,0.0
"Jump River CDP, Wisconsin",28,16,12,55,38625,42.857142857142854
"Kieler CDP, Wisconsin",228,228,0,55,39550,0.0
"King CDP, Wisconsin",565,519,46,55,39700,8.141592920353983
"Knowlton CDP, Wisconsin",61,61,0,55,40125,0.0
"Krakow CDP, Wisconsin",187,178,9,55,40450,4.81283422459893
"Lake Arrowhead CDP, Wisconsin",889,469,420,55,41160,47.24409448818898
"Lake Camelot CDP, Wisconsin",1398,293,1105,55,41210,79.0414878397711
"Lake Ivanhoe CDP, Wisconsin",191,165,26,55,41560,13.612565445026178
"Lake Lorraine CDP, Wisconsin",176,109,67,55,41645,38.06818181818182
"Lake Sherwood CDP, Wisconsin",583,198,385,55,41772,66.0377358490566
"Lauderdale Lakes CDP, Wisconsin",1161,483,678,55,42805,58.39793281653747
"Lake Tomahawk CDP, Wisconsin",246,116,130,55,41875,52.84552845528455
"Lakewood CDP, Wisconsin",293,161,132,55,42050,45.051194539249146
"Laona CDP, Wisconsin",251,177,74,55,42475,29.482071713147413
"Lebanon CDP, Wisconsin",77,77,0,55,43025,0.0
"Leopolis CDP, Wisconsin",44,44,0,55,43575,0.0
"Lewis CDP, Wisconsin",97,90,7,55,43725,7.216494845360824
"Little Sturgeon CDP, Wisconsin",416,108,308,55,45225,74.03846153846155
"Long Lake CDP, Wisconsin",75,32,43,55,45600,57.333333333333336
"Marengo CDP, Wisconsin",48,30,18,55,49175,37.5
"Mercer CDP, Wisconsin",581,293,288,55,51175,49.5697074010327
"Millston CDP, Wisconsin",102,57,45,55,52025,44.11764705882353
"Minocqua CDP, Wisconsin",486,164,322,55,53200,66.2551440329218
"Mole Lake CDP, Wisconsin",297,213,84,55,53500,28.28282828282828
"Mountain CDP, Wisconsin",308,141,167,55,54625,54.22077922077923
"Navarino CDP, Wisconsin",67,67,0,55,55650,0.0
"Newald CDP, Wisconsin",151,73,78,55,56250,51.65562913907284
"New Odanah CDP, Wisconsin",181,166,15,55,57008,8.287292817679557
"Northport CDP, Wisconsin",228,228,0,55,58375,0.0
"Ogema CDP, Wisconsin",116,73,43,55,59500,37.06896551724138
"Packwaukee CDP, Wisconsin",115,107,8,55,60950,6.956521739130435
"Pella CDP, Wisconsin",121,85,36,55,61675,29.75206611570248
"Pembine CDP, Wisconsin",56,33,23,55,61750,41.07142857142857
"Pence CDP, Wisconsin",106,64,42,55,61800,39.62264150943396
"Pine River CDP, Wisconsin",81,63,18,55,62975,22.22222222222222
"Polonia CDP, Wisconsin",219,210,9,55,63925,4.10958904109589
"Port Wing CDP, Wisconsin",141,111,30,55,64500,21.27659574468085
"Post Lake CDP, Wisconsin",647,144,503,55,64550,77.74343122102009
"Poy Sippi CDP, Wisconsin",184,145,39,55,64950,21.195652173913043
"Pulcifer CDP, Wisconsin",54,54,0,55,65725,0.0
"St. Peter CDP, Wisconsin",580,520,60,55,71050,10.344827586206897
"Sandy Hook CDP, Wisconsin",132,126,6,55,71585,4.545454545454546
"Saxon CDP, Wisconsin",29,29,0,55,71850,0.0
"Sayner CDP, Wisconsin",262,95,167,55,71950,63.74045801526718
"Sextonville CDP, Wisconsin",222,177,45,55,72650,20.27027027027027
"Sobieski CDP, Wisconsin",133,133,0,55,74500,0.0
"Springfield CDP, Wisconsin",62,39,23,55,75975,37.096774193548384
"Stone Lake CDP, Wisconsin",177,81,96,55,77625,54.23728813559322
"Summit Lake CDP, Wisconsin",125,52,73,55,78425,58.4
"Taycheedah CDP, Wisconsin",296,296,0,55,79100,0.0
"Thornton CDP, Wisconsin",31,31,0,55,79600,0.0
"Three Lakes CDP, Wisconsin",487,289,198,55,79675,40.6570841889117
"Tichigan CDP, Wisconsin",2047,1873,174,55,79740,8.500244259892526
"Tilleda CDP, Wisconsin",63,29,34,55,79900,53.96825396825397
"Townsend CDP, Wisconsin",140,41,99,55,80300,70.71428571428572
"Trego CDP, Wisconsin",169,94,75,55,80425,44.37869822485207
"Tunnel City CDP, Wisconsin",56,42,14,55,81025,25.0
"Turtle Lake CDP, Wisconsin",193,137,56,55,81090,29.015544041450774
"Tustin CDP, Wisconsin",144,74,70,55,81150,48.61111111111111
"Van Dyne CDP, Wisconsin",106,106,0,55,82450,0.0
"Wabeno CDP, Wisconsin",257,180,77,55,83000,29.961089494163424
"Waubeka CDP, Wisconsin",315,315,0,55,84150,0.0
"Dorchester village, Wisconsin",406,385,21,55,20450,5.172413793103448
"Spencer village, Wisconsin",848,789,59,55,75400,6.9575471698113205
"Suring village, Wisconsin",270,209,61,55,78725,22.59259259259259
"Baraboo city, Wisconsin",5599,5402,197,55,04625,3.5184854438292548
"Bowler village, Wisconsin",156,128,28,55,09025,17.94871794871795
"Scandinavia village, Wisconsin",189,182,7,55,71975,3.7037037037037033
"Middle Village CDP, Wisconsin",79,69,10,55,51617,12.658227848101266
"Sherwood village, Wisconsin",1119,1102,17,55,73525,1.519213583556747
"Niagara city, Wisconsin",752,686,66,55,57325,8.77659574468085
"Merrill city, Wisconsin",4734,4283,451,55,51250,9.526827207435574
"Kiel city, Wisconsin",1644,1609,35,55,39525,2.1289537712895377
"Mishicot village, Wisconsin",664,613,51,55,53325,7.680722891566265
"Maiden Rock village, Wisconsin",80,40,40,55,48175,50.0
"Spring Valley village, Wisconsin",618,600,18,55,76300,2.912621359223301
"Cameron village, Wisconsin",866,810,56,55,12250,6.466512702078522
"Rosendale village, Wisconsin",424,399,25,55,69525,5.89622641509434
"Hortonville village, Wisconsin",1086,1045,41,55,35850,3.7753222836095763
"St. Francis city, Wisconsin",5177,4739,438,55,70650,8.460498358122464
"Lodi city, Wisconsin",1386,1328,58,55,45350,4.184704184704184
"Downing village, Wisconsin",91,82,9,55,20675,9.89010989010989
"Rochester village, Wisconsin",1464,1427,37,55,68550,2.527322404371585
"Sister Bay village, Wisconsin",1397,413,984,55,74225,70.43664996420902
"Oliver village, Wisconsin",175,166,9,55,59800,5.142857142857142
"Superior city, Wisconsin",12489,11733,756,55,78650,6.053326927696373
"Elroy city, Wisconsin",674,623,51,55,23800,7.566765578635016
"Potter Lake CDP, Wisconsin",550,464,86,55,64700,15.636363636363637
"Williams Bay village, Wisconsin",2133,1126,1007,55,87200,47.21050164088139
"Bonduel village, Wisconsin",614,570,44,55,08725,7.166123778501629
"Elderon village, Wisconsin",116,116,0,55,23075,0.0
"Hammond village, Wisconsin",809,782,27,55,32325,3.3374536464771323
"River Falls city, Wisconsin",5645,5414,231,55,68275,4.0921169176262175
"Cochrane village, Wisconsin",185,183,2,55,16025,1.0810810810810811
"Neopit CDP, Wisconsin",256,246,10,55,56050,3.90625
"Okauchee Lake CDP, Wisconsin",2090,1715,375,55,59650,17.942583732057415
"Pewaukee city, Wisconsin",5923,5616,307,55,62240,5.183184197197367
"Lake Wisconsin CDP, Wisconsin",2662,1999,663,55,42012,24.906085649887302
"Wausau city, Wisconsin",18803,17340,1463,55,84475,7.780673296814338
"Lena village, Wisconsin",266,230,36,55,43325,13.533834586466165
"Oconto city, Wisconsin",2221,1936,285,55,59350,12.832057631697433
"Loganville village, Wisconsin",116,110,6,55,45400,5.172413793103448
"Sauk City village, Wisconsin",1669,1543,126,55,71650,7.549430796884361
"Powers Lake CDP, Wisconsin",751,372,379,55,64825,50.466045272969374
"Black River Falls city, Wisconsin",1704,1524,180,55,07900,10.56338028169014
"Wind Lake CDP, Wisconsin",2227,2049,178,55,87675,7.992815446789403
"Egg Harbor village, Wisconsin",715,126,589,55,22850,82.37762237762237
"Necedah village, Wisconsin",463,377,86,55,55700,18.57451403887689
"New Lisbon city, Wisconsin",788,690,98,55,56900,12.436548223350254
"Spring Green village, Wisconsin",766,706,60,55,76025,7.83289817232376
"Browntown village, Wisconsin",116,109,7,55,10475,6.0344827586206895
"Lowell village, Wisconsin",130,120,10,55,45950,7.6923076923076925
"Mount Sterling village, Wisconsin",90,75,15,55,54900,16.666666666666664
"Juneau city, Wisconsin",937,879,58,55,38675,6.189967982924227
"Neosho village, Wisconsin",266,248,18,55,56075,6.7669172932330826
"Randolph village, Wisconsin",778,719,59,55,66150,7.583547557840617
"Helenville CDP, Wisconsin",92,92,0,55,33825,0.0
"Lomira village, Wisconsin",1173,1107,66,55,45475,5.626598465473146
"Johnson Creek village, Wisconsin",1180,1109,71,55,38350,6.016949152542373
"Watertown city, Wisconsin",9859,9463,396,55,83975,4.016634547114312
"Oshkosh city, Wisconsin",28533,26435,2098,55,60500,7.352889636561175
"Mason village, Wisconsin",50,38,12,55,49900,24.0
"Kennan village, Wisconsin",67,60,7,55,39175,10.44776119402985
"Thorp city, Wisconsin",775,689,86,55,79625,11.096774193548386
"Curtiss village, Wisconsin",100,86,14,55,18125,14.000000000000002
"Greenwood city, Wisconsin",498,458,40,55,31575,8.032128514056225
"Owen city, Wisconsin",481,402,79,55,60825,16.424116424116423
"Prairie du Chien city, Wisconsin",2650,2383,267,55,65050,10.075471698113207
"Chenequa village, Wisconsin",324,234,90,55,14225,27.77777777777778
"Menomonee Falls village, Wisconsin",15723,15052,671,55,51000,4.267633403294536
"Boaz village, Wisconsin",66,64,2,55,08600,3.0303030303030303
"Yuba village, Wisconsin",45,30,15,55,89625,33.33333333333333
"Conrath village, Wisconsin",36,36,0,55,16775,0.0
"Glen Flora village, Wisconsin",64,47,17,55,29475,26.5625
"Francis Creek village, Wisconsin",276,236,40,55,27125,14.492753623188406
"Reedsville village, Wisconsin",501,483,18,55,66875,3.592814371257485
"Bay City village, Wisconsin",205,197,8,55,05325,3.902439024390244
"Barneveld village, Wisconsin",454,433,21,55,04775,4.6255506607929515
"Highland village, Wisconsin",428,399,29,55,34450,6.775700934579438
"Elkhart Lake village, Wisconsin",715,480,235,55,23275,32.86713286713287
"Sheboygan Falls city, Wisconsin",3636,3562,74,55,73025,2.035203520352035
"Waldo village, Wisconsin",268,258,10,55,83100,3.731343283582089
"Plainfield village, Wisconsin",358,310,48,55,63150,13.40782122905028
"Kenosha city, Wisconsin",40805,37646,3159,55,39225,7.741698321284156
"Cottage Grove village, Wisconsin",2340,2237,103,55,17175,4.401709401709402
"Dane village, Wisconsin",440,426,14,55,18700,3.1818181818181817
"Oregon village, Wisconsin",3954,3888,66,55,60200,1.669195751138088
"Hebron CDP, Wisconsin",118,103,15,55,33675,12.711864406779661
"Barron city, Wisconsin",1490,1204,286,55,04875,19.19463087248322
"Chetek city, Wisconsin",1035,916,119,55,14325,11.497584541062803
"Colfax village, Wisconsin",499,423,76,55,16275,15.230460921843688
"Fall River village, Wisconsin",751,698,53,55,25150,7.057256990679095
"Pardeeville village, Wisconsin",986,913,73,55,61100,7.403651115618662
"Rio village, Wisconsin",448,448,0,55,68100,0.0
"Black Earth village, Wisconsin",649,619,30,55,07800,4.622496147919876
"Maple Bluff village, Wisconsin",632,597,35,55,48750,5.537974683544303
"Middleton city, Wisconsin",9116,8677,439,55,51575,4.815708644142168
"Verona city, Wisconsin",5212,5082,130,55,82600,2.49424405218726
"Waterloo city, Wisconsin",1574,1506,68,55,83925,4.320203303684879
"La Crosse city, Wisconsin",22756,21314,1442,55,40775,6.336790297064511
"West Salem village, Wisconsin",2071,1974,97,55,86275,4.683727667793336
"Eagle River city, Wisconsin",964,763,201,55,21625,20.850622406639005
"Pittsville city, Wisconsin",410,383,27,55,63100,6.585365853658537
"Stetsonville village, Wisconsin",261,256,5,55,77100,1.9157088122605364
"Kekoskee village, Wisconsin",83,80,3,55,38900,3.614457831325301
"Bear Creek village, Wisconsin",162,145,17,55,05575,10.493827160493826
"Black Creek village, Wisconsin",523,520,3,55,07725,0.5736137667304015
"Fairwater village, Wisconsin",157,156,1,55,25075,0.6369426751592357
"Oakfield village, Wisconsin",458,435,23,55,58900,5.021834061135371
"Franklin city, Wisconsin",13946,13684,262,55,27300,1.87867488885702
"Marshfield city, Wisconsin",9403,8759,644,55,49675,6.8488780176539406
"Rudolph village, Wisconsin",226,208,18,55,70000,7.964601769911504
"Tennyson village, Wisconsin",151,135,16,55,79250,10.596026490066226
"Theresa village, Wisconsin",547,519,28,55,79375,5.118829981718465
"Loyal city, Wisconsin",607,563,44,55,46075,7.248764415156507
"Phillips city, Wisconsin",908,694,214,55,62450,23.568281938325992
"Ferryville village, Wisconsin",159,80,79,55,25725,49.685534591194966
"Albany village, Wisconsin",563,533,30,55,00750,5.328596802841918
"Brodhead city, Wisconsin",1554,1446,108,55,09925,6.94980694980695
"Brown Deer village, Wisconsin",5478,5285,193,55,10375,3.5231836436655715
"Monticello village, Wisconsin",552,521,31,55,54000,5.615942028985507
"Seymour city, Wisconsin",1614,1480,134,55,72725,8.302354399008674
"Shiocton village, Wisconsin",386,370,16,55,73625,4.145077720207254
"Cudahy city, Wisconsin",8366,7656,710,55,17975,8.486732010518766
"River Hills village, Wisconsin",643,569,74,55,68325,11.508553654743391
"Keshena CDP, Wisconsin",433,407,26,55,39250,6.0046189376443415
"Legend Lake CDP, Wisconsin",1458,565,893,55,43207,61.24828532235939
"Ettrick village, Wisconsin",284,257,27,55,24400,9.507042253521126
"Galesville city, Wisconsin",777,762,15,55,28200,1.9305019305019304
"Brice Prairie CDP, Wisconsin",867,795,72,55,09465,8.304498269896193
"Onalaska city, Wisconsin",8087,7822,265,55,59925,3.276864102881168
"Almond village, Wisconsin",212,191,21,55,01400,9.90566037735849
"Ashland city, Wisconsin",3834,3449,385,55,03225,10.041731872717788
"Boyceville village, Wisconsin",482,447,35,55,09050,7.261410788381744
"Doylestown village, Wisconsin",115,110,5,55,20775,4.3478260869565215
"Elk Mound village, Wisconsin",414,383,31,55,23325,7.487922705314009
"Knapp village, Wisconsin",233,211,22,55,39975,9.44206008583691
"Deerfield village, Wisconsin",979,979,0,55,19250,0.0
"McFarland village, Wisconsin",3475,3424,51,55,46850,1.4676258992805755
"Stoughton city, Wisconsin",5352,5125,227,55,77675,4.241405082212257
"Lake Koshkonong CDP, Wisconsin",763,515,248,55,41583,32.50327653997378
"Lake Ripley CDP, Wisconsin",1154,804,350,55,41765,30.329289428076255
"Amherst village, Wisconsin",534,453,81,55,01750,15.168539325842698
"Cuba City city, Wisconsin",869,855,14,55,17950,1.611047180667434
"Glenbeulah village, Wisconsin",200,179,21,55,29350,10.5
"Wautoma city, Wisconsin",996,900,96,55,84625,9.63855421686747
"Browns Lake CDP, Wisconsin",950,806,144,55,10425,15.157894736842106
"Gratiot village, Wisconsin",112,109,3,55,30575,2.6785714285714284
"Elmwood Park village, Wisconsin",220,211,9,55,23725,4.090909090909091
"New Richmond city, Wisconsin",3809,3571,238,55,57100,6.24835914938304
"Somerset village, Wisconsin",1094,1028,66,55,74675,6.032906764168191
"Mosinee city, Wisconsin",1867,1798,69,55,54500,3.6957686127477234
"Rib Mountain CDP, Wisconsin",2261,2157,104,55,67320,4.599734630694384
"Norwalk village, Wisconsin",257,232,25,55,58575,9.72762645914397
"Wyeville village, Wisconsin",60,56,4,55,89275,6.666666666666667
"Brokaw village, Wisconsin",146,145,1,55,09975,0.684931506849315
"Reedsburg city, Wisconsin",3746,3662,84,55,66800,2.2423918846769886
"Blair city, Wisconsin",635,555,80,55,08075,12.598425196850393
"Pigeon Falls village, Wisconsin",188,188,0,55,62675,0.0
"Glendale city, Wisconsin",6289,5803,486,55,29400,7.727778661154397
"Marinette city, Wisconsin",5641,5081,560,55,49300,9.92731785144478
"Clintonville city, Wisconsin",2008,1993,15,55,15725,0.7470119521912351
"Marion city, Wisconsin",576,494,82,55,49400,14.23611111111111
"Crivitz village, Wisconsin",504,460,44,55,17725,8.73015873015873
"Stockholm village, Wisconsin",102,42,60,55,77475,58.82352941176471
"Manawa city, Wisconsin",617,586,31,55,48350,5.024311183144246
"Almena village, Wisconsin",334,301,33,55,01325,9.880239520958083
"Rice Lake city, Wisconsin",4283,3922,361,55,67350,8.428671491944899
"Belleville village, Wisconsin",1085,1010,75,55,06300,6.912442396313365
"Brooklyn village, Wisconsin",498,481,17,55,10075,3.413654618473896
"Spooner city, Wisconsin",1524,1253,271,55,75625,17.78215223097113
"Marshall village, Wisconsin",1344,1344,0,55,49575,0.0
"Monona city, Wisconsin",4066,3886,180,55,53675,4.426955238563699
"Sullivan village, Wisconsin",301,289,12,55,78175,3.9867109634551494
"Mount Horeb village, Wisconsin",2926,2763,163,55,54725,5.570745044429255
"Holmen village, Wisconsin",3708,3540,168,55,35450,4.53074433656958
"Cambridge village, Wisconsin",640,593,47,55,12225,7.34375
"Lake Mills city, Wisconsin",2681,2409,272,55,41675,10.145468108914583
"French Island CDP, Wisconsin",2140,2039,101,55,27875,4.719626168224298
"Park Ridge village, Wisconsin",247,245,2,55,61325,0.8097165991902834
"Omro city, Wisconsin",1480,1443,37,55,59875,2.5
"Lake Wazeecha CDP, Wisconsin",1001,1001,0,55,41975,0.0
"Dodgeville city, Wisconsin",2097,2024,73,55,20350,3.481163567000477
"Livingston village, Wisconsin",279,237,42,55,45325,15.053763440860216
"Ridgeway village, Wisconsin",291,278,13,55,67875,4.4673539518900345
"Sheboygan city, Wisconsin",22080,20269,1811,55,72975,8.201992753623188
"Osseo city, Wisconsin",813,758,55,55,60575,6.765067650676507
"Hartland village, Wisconsin",3705,3546,159,55,33100,4.291497975708502
"Mukwonago village, Wisconsin",3172,3068,104,55,55050,3.278688524590164
"Nashotah village, Wisconsin",494,468,26,55,55550,5.263157894736842
"Pewaukee village, Wisconsin",4020,3915,105,55,62250,2.6119402985074625
"Belgium village, Wisconsin",867,854,13,55,06150,1.4994232987312572
"Port Washington city, Wisconsin",5149,4937,212,55,64450,4.117304330938047
"Lone Rock village, Wisconsin",444,405,39,55,45575,8.783783783783784
"Richland Center city, Wisconsin",2463,2259,204,55,67625,8.28258221680877
"Tony village, Wisconsin",61,61,0,55,80225,0.0
"Friendship village, Wisconsin",278,213,65,55,27950,23.381294964028775
"East Troy village, Wisconsin",1913,1871,42,55,22100,2.195504443282802
"Neshkoro village, Wisconsin",241,195,46,55,56125,19.08713692946058
"Fontana-on-Geneva Lake village, Wisconsin",2407,699,1708,55,26350,70.95970087245533
"Markesan city, Wisconsin",598,501,97,55,49450,16.220735785953178
"Taylor village, Wisconsin",223,210,13,55,79150,5.829596412556054
"Abbotsford city, Wisconsin",887,852,35,55,00100,3.9458850056369785
"Rothschild village, Wisconsin",2295,2209,86,55,69725,3.747276688453159
"Wisconsin Dells city, Wisconsin",1606,1248,358,55,88150,22.291407222914074
"Eland village, Wisconsin",89,76,13,55,22975,14.606741573033707
"Pulaski village, Wisconsin",1484,1391,93,55,65675,6.2668463611859835
"Eleva village, Wisconsin",342,333,9,55,23175,2.631578947368421
"Big Bend village, Wisconsin",532,513,19,55,07200,3.571428571428571
"Delafield city, Wisconsin",3303,3193,110,55,19400,3.330305782621859
"Coloma village, Wisconsin",218,191,27,55,16375,12.385321100917432
"Ashwaubenon village, Wisconsin",7908,7636,272,55,03425,3.43955488113303
"De Pere city, Wisconsin",9777,9460,317,55,19775,3.242303365040401
"South Wayne village, Wisconsin",192,180,12,55,75275,6.25
"Lublin village, Wisconsin",81,65,16,55,46150,19.753086419753085
"Medford city, Wisconsin",2111,1957,154,55,50425,7.29512079583136
"Rib Lake village, Wisconsin",463,393,70,55,67275,15.118790496760258
"Fox Lake city, Wisconsin",803,692,111,55,27000,13.823163138231632
"Horicon city, Wisconsin",1438,1375,63,55,35750,4.3810848400556335
"Hustisford village, Wisconsin",457,404,53,55,36625,11.597374179431071
"Campbellsport village, Wisconsin",826,785,41,55,12325,4.963680387409201
"St. Cloud village, Wisconsin",245,237,8,55,70500,3.2653061224489797
"Beloit city, Wisconsin",15479,14140,1339,55,06500,8.65042961431617
"Vesper village, Wisconsin",311,289,22,55,82650,7.07395498392283
"Jackson village, Wisconsin",3042,2884,158,55,37675,5.193951347797501
"Newburg village, Wisconsin",534,504,30,55,56450,5.617977528089887
"Weyauwega city, Wisconsin",853,717,136,55,86400,15.943728018757328
"Shorewood village, Wisconsin",6275,5967,308,55,73725,4.908366533864542
"Whitefish Bay village, Wisconsin",5443,5244,199,55,86700,3.65607201910711
"Ogdensburg village, Wisconsin",100,88,12,55,59475,12.0
"Mount Hope village, Wisconsin",80,71,9,55,54675,11.25
"Hillsboro city, Wisconsin",680,608,72,55,34825,10.588235294117647
"Patch Grove village, Wisconsin",82,67,15,55,61425,18.29268292682927
"Woodman village, Wisconsin",50,36,14,55,88825,28.000000000000004
"Bayfield city, Wisconsin",502,276,226,55,05350,45.0199203187251
"Slinger village, Wisconsin",2199,2128,71,55,74400,3.2287403365165988
"Janesville city, Wisconsin",27494,26405,1089,55,37825,3.960864188550229
"Genoa village, Wisconsin",116,102,14,55,28625,12.068965517241379
"Boyd village, Wisconsin",244,238,6,55,09075,2.459016393442623
"Brillion city, Wisconsin",1218,1168,50,55,09725,4.105090311986864
"Stratford village, Wisconsin",723,688,35,55,77750,4.840940525587829
"Gillett city, Wisconsin",609,518,91,55,29050,14.942528735632186
"Manitowoc city, Wisconsin",16053,14704,1349,55,48500,8.40341369214477
"Woodville village, Wisconsin",575,541,34,55,89025,5.913043478260869
"Merrillan village, Wisconsin",351,279,72,55,51300,20.51282051282051
"North Prairie village, Wisconsin",868,847,21,55,58400,2.4193548387096775
"Milltown village, Wisconsin",532,503,29,55,52075,5.451127819548872
"New Holstein city, Wisconsin",1579,1410,169,55,56800,10.70297656744775
"Weston village, Wisconsin",6325,6078,247,55,86025,3.9051383399209487
"Butler village, Wisconsin",937,902,35,55,11475,3.7353255069370332
"Cumberland city, Wisconsin",1310,1100,210,55,18025,16.030534351145036
"Lake Wissota CDP, Wisconsin",1385,1297,88,55,42025,6.353790613718411
"Darlington city, Wisconsin",1078,997,81,55,18875,7.5139146567718
"Lake Nebagamon village, Wisconsin",736,425,311,55,41725,42.255434782608695
"Hixton village, Wisconsin",217,212,5,55,35075,2.3041474654377883
"Prairie du Sac village, Wisconsin",1920,1880,40,55,65100,2.083333333333333
"Pepin village, Wisconsin",540,384,156,55,61925,28.888888888888886
"Eau Claire city, Wisconsin",28931,27495,1436,55,22300,4.963533925546991
"Hilbert village, Wisconsin",449,422,27,55,34575,6.013363028953229
"Potter village, Wisconsin",103,103,0,55,64675,0.0
"Iola village, Wisconsin",643,574,69,55,37025,10.730948678071538
"New London city, Wisconsin",3272,3054,218,55,56925,6.662591687041565
"Grantsburg village, Wisconsin",711,623,88,55,30450,12.376933895921239
"Cassville village, Wisconsin",534,414,120,55,13050,22.47191011235955
"Neillsville city, Wisconsin",1230,1093,137,55,55800,11.138211382113822
"Bell Center village, Wisconsin",71,51,20,55,06225,28.169014084507044
"Orfordville village, Wisconsin",609,538,71,55,60250,11.658456486042693
"De Soto village, Wisconsin",199,138,61,55,19850,30.65326633165829
"Readstown village, Wisconsin",206,194,12,55,66450,5.825242718446602
"Stoddard village, Wisconsin",414,395,19,55,77550,4.5893719806763285
"Viola village, Wisconsin",329,301,28,55,82900,8.51063829787234
"Bloomer city, Wisconsin",1637,1589,48,55,08225,2.9321930360415394
"Park Falls city, Wisconsin",1368,1253,115,55,61200,8.406432748538013
"Bloomington village, Wisconsin",362,319,43,55,08375,11.878453038674033
"Fennimore city, Wisconsin",1143,988,155,55,25600,13.560804899387577
"Washburn city, Wisconsin",1037,946,91,55,83525,8.775313404050145
"Wauzeka village, Wisconsin",309,279,30,55,84725,9.70873786407767
"Amherst Junction village, Wisconsin",166,147,19,55,01800,11.44578313253012
"Rosholt village, Wisconsin",233,206,27,55,69575,11.587982832618025
"Wisconsin Rapids city, Wisconsin",8716,8131,585,55,88200,6.7117944011014234
"Avoca village, Wisconsin",404,305,99,55,04025,24.504950495049506
"Cobb village, Wisconsin",249,227,22,55,15975,8.835341365461847
"Mineral Point city, Wisconsin",1270,1177,93,55,53100,7.322834645669292
"Montfort village, Wisconsin",299,278,21,55,53950,7.023411371237458
"Adell village, Wisconsin",232,225,7,55,00450,3.0172413793103448
"Cedar Grove village, Wisconsin",870,840,30,55,13475,3.4482758620689653
"Lohrville village, Wisconsin",187,159,28,55,45425,14.973262032085561
"Belmont village, Wisconsin",432,421,11,55,06425,2.5462962962962963
"Rhinelander city, Wisconsin",4098,3198,900,55,67200,21.96193265007321
"Bohners Lake CDP, Wisconsin",1344,999,345,55,08625,25.669642857142854
"Wrightstown village, Wisconsin",1214,1206,8,55,89150,0.6589785831960462
"Benton village, Wisconsin",452,425,27,55,06825,5.9734513274336285
"Blanchardville village, Wisconsin",431,375,56,55,08125,12.993039443155451
"Shullsburg city, Wisconsin",575,537,38,55,73825,6.608695652173912
"Paddock Lake village, Wisconsin",1358,1180,178,55,60975,13.107511045655377
"Milton city, Wisconsin",2373,2257,116,55,52200,4.888327012220818
"Chaseburg village, Wisconsin",146,144,2,55,14150,1.36986301369863
"Westby city, Wisconsin",1028,981,47,55,85475,4.571984435797665
"Chippewa Falls city, Wisconsin",6449,6110,339,55,14575,5.256628934718561
"Cornell city, Wisconsin",764,673,91,55,17100,11.910994764397905
"Hawkins village, Wisconsin",210,189,21,55,33275,10.0
"Buffalo City city, Wisconsin",582,435,147,55,11062,25.257731958762886
"Madison city, Wisconsin",113665,108573,5092,55,48000,4.479831082567193
"Arlington village, Wisconsin",307,298,9,55,02800,2.9315960912052117
"Cross Plains village, Wisconsin",1656,1636,20,55,17775,1.2077294685990339
"Rome CDP, Wisconsin",307,280,27,55,69300,8.794788273615636
"Milladore village, Wisconsin",139,131,8,55,51875,5.755395683453238
"Combined Locks village, Wisconsin",1382,1332,50,55,16500,3.61794500723589
"Hewitt village, Wisconsin",359,353,6,55,34250,1.6713091922005572
"Coon Valley village, Wisconsin",368,345,23,55,16900,6.25
"Waupaca city, Wisconsin",2995,2763,232,55,84375,7.746243739565943
"Greenfield city, Wisconsin",17929,16794,1135,55,31175,6.330525963522785
"Bagley village, Wisconsin",407,166,241,55,04250,59.21375921375921
"Eastman village, Wisconsin",182,164,18,55,21900,9.89010989010989
"Monroe city, Wisconsin",5068,4883,185,55,53750,3.6503551696921863
"Independence city, Wisconsin",699,626,73,55,36800,10.44349070100143
"Fredonia village, Wisconsin",971,911,60,55,27550,6.179196704428424
"Weyerhaeuser village, Wisconsin",175,121,54,55,86450,30.857142857142854
"Hollandale village, Wisconsin",117,106,11,55,35400,9.401709401709402
"Platteville city, Wisconsin",4408,4070,338,55,63250,7.6678765880217785
"Ontario village, Wisconsin",227,206,21,55,60075,9.251101321585903
"Fort Atkinson city, Wisconsin",5321,4954,367,55,26675,6.897199774478481
"Jefferson city, Wisconsin",3441,3114,327,55,37900,9.503051438535309
"Neenah city, Wisconsin",11451,10966,485,55,55750,4.235437953017204
"West Baraboo village, Wisconsin",716,690,26,55,85325,3.6312849162011176
"Aniwa village, Wisconsin",109,96,13,55,02075,11.926605504587156
"Tigerton village, Wisconsin",335,296,39,55,79825,11.641791044776118
"Oak Creek city, Wisconsin",14816,14466,350,55,58800,2.3623110151187907
"Ingram village, Wisconsin",44,36,8,55,36925,18.181818181818183
"Couderay village, Wisconsin",49,36,13,55,17225,26.53061224489796
"Exeland village, Wisconsin",109,92,17,55,24700,15.59633027522936
"Adams city, Wisconsin",1005,961,44,55,00275,4.378109452736319
"Lyndon Station village, Wisconsin",259,198,61,55,46600,23.552123552123554
"Mauston city, Wisconsin",1935,1700,235,55,50025,12.144702842377262
"Wonewoc village, Wisconsin",427,345,82,55,88500,19.20374707259953
"Green Lake city, Wisconsin",676,433,243,55,31300,35.946745562130175
"Sparta city, Wisconsin",4469,4234,235,55,75325,5.258447079883643
"Tomah city, Wisconsin",4338,3819,519,55,80075,11.964038727524205
"Wilton village, Wisconsin",212,191,21,55,87525,9.90566037735849
"Shawano city, Wisconsin",4382,4058,324,55,72925,7.3938840712003655
"Saukville village, Wisconsin",1912,1828,84,55,71700,4.393305439330543
"Eagle village, Wisconsin",733,718,15,55,21425,2.046384720327422
"Lac La Belle village, Wisconsin",140,107,33,55,40750,23.57142857142857
"Frederic village, Wisconsin",564,473,91,55,27500,16.134751773049647
"Muskego city, Wisconsin",9566,9145,421,55,55275,4.401003554254652
"Thiensville village, Wisconsin",1593,1559,34,55,79475,2.1343377275580666
"Clayton village, Wisconsin",203,185,18,55,15100,8.866995073891626
"Osceola village, Wisconsin",1285,1126,159,55,60450,12.373540856031129
"Bruce village, Wisconsin",410,368,42,55,10500,10.24390243902439
"Chief Lake CDP, Wisconsin",503,237,266,55,14440,52.88270377733598
"Chilton city, Wisconsin",1780,1687,93,55,14475,5.224719101123595
"Wausaukee village, Wisconsin",297,272,25,55,84525,8.417508417508419
"Fremont village, Wisconsin",384,306,78,55,27800,20.3125
"Clear Lake village, Wisconsin",478,451,27,55,15250,5.648535564853557
"St. Croix Falls city, Wisconsin",1083,953,130,55,70550,12.003693444136658
"Webster village, Wisconsin",386,350,36,55,85025,9.32642487046632
"Big Falls village, Wisconsin",55,30,25,55,07250,45.45454545454545
"Embarrass village, Wisconsin",208,208,0,55,23850,0.0
"Siren village, Wisconsin",528,437,91,55,74175,17.234848484848484
"Blue River village, Wisconsin",247,217,30,55,08525,12.145748987854251
"Boscobel city, Wisconsin",1299,1188,111,55,08850,8.545034642032332
"Dickeyville village, Wisconsin",511,482,29,55,20175,5.6751467710371815
"Potosi village, Wisconsin",338,314,24,55,64625,7.100591715976331
"Soldiers Grove village, Wisconsin",258,221,37,55,74550,14.34108527131783
"Steuben village, Wisconsin",53,34,19,55,77175,35.84905660377358
"Prentice village, Wisconsin",362,336,26,55,65325,7.18232044198895
"Beaver Dam city, Wisconsin",7502,6798,704,55,05900,9.3841642228739
"Brownsville village, Wisconsin",243,238,5,55,10450,2.05761316872428
"Haugen village, Wisconsin",152,140,12,55,33225,7.894736842105263
"Stanley city, Wisconsin",962,847,115,55,76625,11.954261954261955
"Fall Creek village, Wisconsin",582,557,25,55,25125,4.29553264604811
"Dallas village, Wisconsin",163,142,21,55,18575,12.883435582822086
"Minong village, Wisconsin",280,221,59,55,53250,21.071428571428573
"Poynette village, Wisconsin",1118,1053,65,55,64900,5.813953488372093
"Ridgeland village, Wisconsin",152,113,39,55,67800,25.657894736842106
"Wheeler village, Wisconsin",162,151,11,55,86575,6.790123456790123
"DeForest village, Wisconsin",3836,3660,176,55,19350,4.588112617309697
"Lac du Flambeau CDP, Wisconsin",1232,805,427,55,40675,34.659090909090914
"Long Beach city, Washington",1849,750,1099,53,40070,59.437533802055164
"Chehalis city, Washington",3158,2901,257,53,11475,8.138062064597847
"Napavine city, Washington",683,649,34,53,47980,4.978038067349927
"Alderwood Manor CDP, Washington",3325,3276,49,53,01185,1.4736842105263157
"Esperance CDP, Washington",1536,1536,0,53,22255,0.0
"May Creek CDP, Washington",399,361,38,53,44260,9.523809523809524
"Mukilteo city, Washington",8870,8287,583,53,47735,6.5727170236753105
"Stanwood city, Washington",2766,2535,231,53,67455,8.351409978308027
"West Richland city, Washington",4774,4642,132,53,77665,2.7649769585253456
"Reardan town, Washington",265,235,30,53,57465,11.320754716981133
"West Pasco CDP, Washington",458,428,30,53,77612,6.550218340611353
"Rock Island city, Washington",393,385,8,53,59180,2.035623409669211
"Markham CDP, Washington",36,36,0,53,43640,0.0
"Clarkston city, Washington",3362,2999,363,53,12630,10.797144556811421
"Chelan city, Washington",2631,1610,1021,53,11615,38.80653743823641
"Friday Harbor town, Washington",1401,1165,236,53,25615,16.84511063526053
"Conconully town, Washington",218,135,83,53,14310,38.07339449541284
"Bothell city, Washington",17996,17223,773,53,07380,4.295398977550566
"Cottage Lake CDP, Washington",8260,8100,160,53,14940,1.937046004842615
"Lake Forest Park city, Washington",5358,5306,52,53,37270,0.9705113848450915
"North Bend city, Washington",2617,2485,132,53,49485,5.043943446694689
"Carson CDP, Washington",1090,972,118,53,10320,10.825688073394495
"North Yelm CDP, Washington",1198,1180,18,53,50210,1.5025041736227045
"Colfax city, Washington",1271,1141,130,53,13785,10.22816679779701
"Liberty Lake city, Washington",4170,3842,328,53,39335,7.865707434052757
"Electric City city, Washington",485,412,73,53,21030,15.051546391752577
"LaCrosse town, Washington",261,205,56,53,36850,21.455938697318008
"Prescott city, Washington",157,135,22,53,56240,14.012738853503185
"Rainier city, Washington",841,777,64,53,57220,7.609988109393578
"Spangle city, Washington",99,91,8,53,66290,8.080808080808081
"Spokane Valley city, Washington",42323,40129,2194,53,67167,5.1839425371547385
"Granger city, Washington",916,861,55,53,27960,6.004366812227074
"Addy CDP, Washington",83,44,39,53,00380,46.98795180722892
"Alder CDP, Washington",75,55,20,53,01045,26.666666666666668
"Alderton CDP, Washington",1237,1201,36,53,01150,2.9102667744543247
"Allyn CDP, Washington",1274,938,336,53,01430,26.373626373626376
"Altoona CDP, Washington",47,34,13,53,01745,27.659574468085108
"Amanda Park CDP, Washington",68,41,27,53,01780,39.705882352941174
"Anderson Island CDP, Washington",1177,624,553,53,02060,46.98385726423109
"Bangor Base CDP, Washington",1333,1250,83,53,04100,6.22655663915979
"Barney's Junction CDP, Washington",69,69,0,53,04347,0.0
"Barstow CDP, Washington",61,51,10,53,04370,16.39344262295082
"Belfair CDP, Washington",1811,1586,225,53,05140,12.424075096631695
"Bethel CDP, Washington",1509,1395,114,53,05735,7.5546719681908545
"Bothell East CDP, Washington",4025,3764,261,53,07390,6.484472049689441
"Bothell West CDP, Washington",7572,7250,322,53,07395,4.2525092445853145
"Boulevard Park CDP, Washington",1755,1708,47,53,07397,2.678062678062678
"Boyds CDP, Washington",17,17,0,53,07485,0.0
"Bryant CDP, Washington",668,668,0,53,08500,0.0
"Buena CDP, Washington",359,290,69,53,08640,19.220055710306408
"Bunk Foss CDP, Washington",1358,1294,64,53,08770,4.712812960235641
"Burley CDP, Washington",779,720,59,53,08885,7.573812580231065
"Canterwood CDP, Washington",1331,1288,43,53,09810,3.2306536438767846
"Canyon Creek CDP, Washington",1579,1240,339,53,09820,21.469284357188094
"Cavalero CDP, Washington",1774,1645,129,53,10645,7.271702367531003
"Chain Lake CDP, Washington",1571,1526,45,53,11325,2.8644175684277533
"Chelan Falls CDP, Washington",15,15,0,53,11685,0.0
"Chico CDP, Washington",1115,1062,53,53,12175,4.753363228699552
"Clallam Bay CDP, Washington",320,231,89,53,12525,27.8125
"Clayton CDP, Washington",160,131,29,53,12735,18.125
"Clear Lake CDP (Pierce County), Washington",467,372,95,53,12820,20.342612419700217
"Clear Lake CDP (Skagit County), Washington",411,385,26,53,12840,6.326034063260341
"Clearview CDP, Washington",1411,1335,76,53,12875,5.386250885896527
"Cliffdell CDP, Washington",171,56,115,53,13015,67.2514619883041
"Clover Creek CDP, Washington",2685,2411,274,53,13215,10.204841713221601
"Cowiche CDP, Washington",177,177,0,53,15325,0.0
"Crocker CDP, Washington",412,412,0,53,15780,0.0
"Curlew CDP, Washington",48,40,8,53,16165,16.666666666666664
"Curlew Lake CDP, Washington",397,179,218,53,16170,54.91183879093199
"Danville CDP, Washington",27,18,9,53,16585,33.33333333333333
"Dash Point CDP, Washington",444,392,52,53,16760,11.711711711711711
"Deep River CDP, Washington",99,93,6,53,17215,6.0606060606060606
"Disautel CDP, Washington",16,16,0,53,17880,0.0
"Donald CDP, Washington",43,0,43,53,18265,100.0
"Duluth CDP, Washington",633,599,34,53,18775,5.371248025276461
"Eastmont CDP, Washington",7687,7403,284,53,19630,3.6945492389748926
"Enetai CDP, Washington",892,836,56,53,21800,6.278026905829597
"Fife Heights CDP, Washington",724,696,28,53,23830,3.867403314917127
"Fairwood CDP (King County), Washington",7566,7217,349,53,23160,4.6127412106793555
"Fairwood CDP (Spokane County), Washington",3400,3331,69,53,23165,2.0294117647058822
"Fern Prairie CDP, Washington",760,723,37,53,23690,4.868421052631579
"Fobes Hill CDP, Washington",1092,1028,64,53,24425,5.86080586080586
"Four Lakes CDP, Washington",281,281,0,53,25300,0.0
"Gorst CDP, Washington",164,149,15,53,27680,9.146341463414634
"Grapeview CDP, Washington",784,371,413,53,28135,52.67857142857143
"Switzer CDP, West Virginia",306,250,56,54,78796,18.30065359477124
"Alum Creek CDP, West Virginia",879,681,198,54,01396,22.525597269624573
"West Hamlin town, West Virginia",328,280,48,54,85804,14.634146341463413
"Hendricks town, West Virginia",147,106,41,54,36460,27.89115646258503
"Anawalt town, West Virginia",109,49,60,54,01780,55.04587155963303
"Whitesville town, West Virginia",318,218,100,54,86836,31.446540880503143
"Chester city, West Virginia",1468,1271,197,54,15076,13.419618528610355
"Bluefield city, West Virginia",5184,4194,990,54,08524,19.09722222222222
"Harman town, West Virginia",72,46,26,54,35092,36.11111111111111
"Elkview CDP, West Virginia",749,697,52,54,24748,6.942590120160213
"Monongah town, West Virginia",544,477,67,54,55276,12.316176470588236
"Hamlin town, West Virginia",656,565,91,54,34516,13.871951219512196
"Wiley Ford CDP, West Virginia",510,440,70,54,87316,13.725490196078432
"Stanaford CDP, West Virginia",626,516,110,54,76444,17.57188498402556
"Vienna city, West Virginia",4847,4510,337,54,83500,6.9527542809985565
"Mount Gay-Shamrock CDP, West Virginia",774,571,203,54,56342,26.22739018087855
"Clendenin town, West Virginia",522,451,71,54,16012,13.601532567049809
"Fairview town, West Virginia",171,138,33,54,26524,19.298245614035086
"Addison (Webster Springs) town, West Virginia",559,441,118,54,00364,21.10912343470483
"Sophia town, West Virginia",623,518,105,54,75172,16.853932584269664
"Benwood city, West Virginia",745,594,151,54,06340,20.268456375838927
"Bridgeport city, West Virginia",3721,3405,316,54,10180,8.492340768610589
"Ellenboro town, West Virginia",177,140,37,54,24844,20.903954802259886
"Milton town, West Virginia",1371,1206,165,54,54484,12.035010940919037
"New Martinsville city, West Virginia",2523,2002,521,54,58684,20.650019817677368
"Winfield town, West Virginia",1070,1008,62,54,87988,5.794392523364486
"Moundsville city, West Virginia",4369,3583,786,54,56020,17.99038681620508
"Hambleton town, West Virginia",120,104,16,54,34492,13.333333333333334
"Kermit town, West Virginia",158,135,23,54,43300,14.556962025316455
"Man town, West Virginia",438,400,38,54,50932,8.67579908675799
"Keyser city, West Virginia",2380,2072,308,54,43492,12.941176470588237
"St. Marys city, West Virginia",989,859,130,54,71356,13.144590495449949
"Bradley CDP, West Virginia",766,743,23,54,09676,3.0026109660574414
"Cairo town, West Virginia",141,102,39,54,12124,27.659574468085108
"Pullman town, West Virginia",79,59,20,54,65956,25.31645569620253
"Glenville town, West Virginia",766,605,161,54,32044,21.01827676240209
"War city, West Virginia",477,347,130,54,84484,27.253668763102723
"Ravenswood city, West Virginia",1627,1483,144,54,67108,8.850645359557467
"Richwood city, West Virginia",1189,864,325,54,68116,27.333894028595456
"Terra Alta town, West Virginia",773,661,112,54,79708,14.489003880983182
"Pinch CDP, West Virginia",1256,1133,123,54,63772,9.79299363057325
"St. Albans city, West Virginia",5078,4402,676,54,71212,13.312327688066167
"Paden City city, West Virginia",1310,1165,145,54,61636,11.068702290076336
"Blennerhassett CDP, West Virginia",1373,1229,144,54,08308,10.487982520029133
"Boaz CDP, West Virginia",653,626,27,54,08836,4.134762633996937
"Lubeck CDP, West Virginia",600,554,46,54,49156,7.666666666666666
"Fayetteville town, West Virginia",1361,1256,105,54,27028,7.7149155033063925
"Mallory CDP, West Virginia",442,370,72,54,50860,16.289592760180994
"Mount Hope city, West Virginia",637,555,82,54,56404,12.872841444270017
"Pax town, West Virginia",86,61,25,54,62356,29.069767441860467
"Harts CDP, West Virginia",297,207,90,54,35596,30.303030303030305
"Gilbert Creek CDP, West Virginia",579,468,111,54,30777,19.170984455958546
"Crab Orchard CDP, West Virginia",1106,913,193,54,18508,17.4502712477396
"Lester town, West Virginia",210,170,40,54,46468,19.047619047619047
"Harrisville town, West Virginia",1130,901,229,54,35428,20.265486725663717
"Petersburg city, West Virginia",1451,1105,346,54,62956,23.845623707787734
"Teays Valley CDP, West Virginia",5765,5166,599,54,79545,10.39028620988725
"Brandonville town, West Virginia",84,74,10,54,09844,11.904761904761903
"Quinwood town, West Virginia",107,57,50,54,66412,46.728971962616825
"Middlebourne town, West Virginia",405,278,127,54,53572,31.35802469135803
"Hinton city, West Virginia",1504,1228,276,54,37636,18.351063829787233
"Camden-on-Gauley town, West Virginia",93,85,8,54,12436,8.60215053763441
"Smithfield town, West Virginia",101,66,35,54,74788,34.65346534653465
"Ansted town, West Virginia",710,557,153,54,01996,21.549295774647888
"West Milford town, West Virginia",275,241,34,54,85924,12.363636363636363
"Matewan town, West Virginia",355,284,71,54,52324,20.0
"Beckley city, West Virginia",8383,7297,1086,54,05332,12.9547894548491
"Rupert town, West Virginia",471,387,84,54,70828,17.8343949044586
"Jane Lew town, West Virginia",195,159,36,54,40828,18.461538461538463
"Weston city, West Virginia",2179,1714,465,54,85972,21.340064249655804
"McMechen city, West Virginia",946,782,164,54,50260,17.33615221987315
"Craigsville CDP, West Virginia",1027,916,111,54,18604,10.808179162609543
"Albright town, West Virginia",108,108,0,54,00748,0.0
"Northfork town, West Virginia",238,113,125,54,59428,52.52100840336135
"Mason town, West Virginia",549,439,110,54,52180,20.036429872495447
"Huntington city, West Virginia",24354,19755,4599,54,39460,18.883961566888395
"Oak Hill city, West Virginia",4140,3517,623,54,60028,15.048309178743963
"Thurmond town, West Virginia",6,3,3,54,80284,50.0
"Lost Creek town, West Virginia",228,186,42,54,48748,18.421052631578945
"Chattaroy CDP, West Virginia",248,236,12,54,14692,4.838709677419355
"Red Jacket CDP, West Virginia",266,214,52,54,67396,19.548872180451127
"Belmont city, West Virginia",443,424,19,54,06004,4.288939051918736
"MacArthur CDP, West Virginia",742,656,86,54,49564,11.590296495956872
"Morgantown city, West Virginia",12508,10522,1986,54,55756,15.87783818356252
"Newell CDP, West Virginia",649,605,44,54,58420,6.779661016949152
"Montrose town, West Virginia",85,72,13,54,55540,15.294117647058824
"Brookhaven CDP, West Virginia",2218,2003,215,54,10420,9.69341749323715
"Granville town, West Virginia",1295,1005,290,54,32932,22.393822393822393
"Spencer city, West Virginia",1198,941,257,54,75820,21.452420701168613
"Matoaka town, West Virginia",130,60,70,54,52420,53.84615384615385
"Oakvale town, West Virginia",52,44,8,54,60196,15.384615384615385
"Barrackville town, West Virginia",583,547,36,54,04612,6.174957118353345
"Pleasant Valley city, West Virginia",1568,1333,235,54,64228,14.987244897959185
"Follansbee city, West Virginia",1442,1286,156,54,28204,10.818307905686545
"Burnsville town, West Virginia",293,217,76,54,11716,25.938566552901023
"Bancroft town, West Virginia",220,187,33,54,04204,15.0
"Franklin town, West Virginia",401,284,117,54,29044,29.177057356608476
"Nutter Fort town, West Virginia",797,695,102,54,59836,12.797992471769135
"Shinnston city, West Virginia",1092,976,116,54,73636,10.622710622710622
"Tunnelton town, West Virginia",115,99,16,54,81268,13.91304347826087
"Bayard town, West Virginia",133,93,40,54,04924,30.075187969924812
"Keystone city, West Virginia",176,55,121,54,43516,68.75
"Cross Lanes CDP, West Virginia",4612,4016,596,54,19108,12.922810060711187
"Point Pleasant city, West Virginia",2145,1788,357,54,64708,16.643356643356643
"Rivesville town, West Virginia",469,421,48,54,68908,10.23454157782516
"Worthington town, West Virginia",88,86,2,54,88708,2.272727272727273
"Montgomery city, West Virginia",819,641,178,54,55468,21.733821733821735
"Tornado CDP, West Virginia",526,473,53,54,80764,10.076045627376425
"Blacksville town, West Virginia",65,42,23,54,08092,35.38461538461539
"Star City town, West Virginia",999,941,58,54,76516,5.805805805805806
"Buckhannon city, West Virginia",2386,2002,384,54,11188,16.093880972338642
"Ceredo city, West Virginia",639,500,139,54,14308,21.752738654147105
"Wayne town, West Virginia",815,665,150,54,84940,18.404907975460123
"Philippi city, West Virginia",1572,1389,183,54,63292,11.641221374045802
"Cheat Lake CDP, West Virginia",3515,3351,164,54,14775,4.665718349928876
"Grant Town town, West Virginia",266,247,19,54,32908,7.142857142857142
"Davis town, West Virginia",438,301,137,54,20428,31.27853881278539
"Athens town, West Virginia",333,252,81,54,03292,24.324324324324326
"Windsor Heights village, West Virginia",171,146,25,54,87892,14.619883040935672
"Grantsville town, West Virginia",278,188,90,54,32884,32.37410071942446
"Capon Bridge town, West Virginia",212,172,40,54,13108,18.867924528301888
"Elkins city, West Virginia",3486,2888,598,54,24580,17.154331612162938
"Reedy town, West Virginia",84,47,37,54,67660,44.047619047619044
"Danville town, West Virginia",324,265,59,54,20212,18.209876543209877
"Dunbar city, West Virginia",4410,3703,707,54,22564,16.03174603174603
"Smithers city, West Virginia",474,399,75,54,74740,15.822784810126583
"Fort Gay town, West Virginia",489,360,129,54,28516,26.380368098159508
"Mullens city, West Virginia",841,627,214,54,57148,25.44589774078478
"Shepherdstown town, West Virginia",391,329,62,54,73468,15.856777493606138
"Flatwoods town, West Virginia",90,82,8,54,27868,8.88888888888889
"Sutton town, West Virginia",652,512,140,54,78580,21.472392638036812
"New Cumberland city, West Virginia",601,549,52,54,58372,8.652246256239602
"Hillsboro town, West Virginia",132,85,47,54,37372,35.60606060606061
"Union town, West Virginia",305,253,52,54,81940,17.04918032786885
"Bethlehem village, West Virginia",1135,1063,72,54,06940,6.343612334801763
"Triadelphia town, West Virginia",440,324,116,54,80932,26.36363636363636
"Valley Grove village, West Virginia",195,167,28,54,82732,14.358974358974358
"Leon town, West Virginia",110,77,33,54,46300,30.0
"Parsons city, West Virginia",767,659,108,54,62284,14.08083441981747
"Thomas city, West Virginia",359,248,111,54,80020,30.919220055710305
"Wardensville town, West Virginia",137,113,24,54,84580,17.51824817518248
"Cedar Grove town, West Virginia",318,231,87,54,13924,27.358490566037734
"Sistersville city, West Virginia",650,500,150,54,74380,23.076923076923077
"Parkersburg city, West Virginia",15067,13152,1915,54,62140,12.709895798765514
"Meadow Bridge town, West Virginia",189,147,42,54,52780,22.22222222222222
"Clarksburg city, West Virginia",7432,6257,1175,54,15628,15.810010764262646
"Despard CDP, West Virginia",429,394,35,54,21316,8.158508158508159
"Enterprise CDP, West Virginia",475,417,58,54,25516,12.210526315789473
"Stonewood city, West Virginia",868,844,24,54,77188,2.7649769585253456
"Chapmanville town, West Virginia",711,552,159,54,14524,22.362869198312236
"Logan city, West Virginia",977,775,202,54,48148,20.67553735926305
"Mitchell Heights town, West Virginia",196,174,22,54,54892,11.224489795918368
"Fort Ashby CDP, West Virginia",774,717,57,54,28444,7.3643410852713185
"Delbarton town, West Virginia",297,207,90,54,20980,30.303030303030305
"Coal City CDP, West Virginia",825,805,20,54,16516,2.4242424242424243
"Daniels CDP, West Virginia",977,848,129,54,20164,13.203684749232345
"Shady Spring CDP, West Virginia",1521,1347,174,54,73108,11.439842209072978
"Friendly town, West Virginia",73,34,39,54,29404,53.42465753424658
"Eleanor town, West Virginia",675,608,67,54,24292,9.925925925925926
"Barboursville village, West Virginia",1772,1701,71,54,04276,4.006772009029345
"West Liberty town, West Virginia",317,238,79,54,85876,24.9211356466877
"Flemington town, West Virginia",174,151,23,54,27940,13.218390804597702
"Carpendale town, West Virginia",421,341,80,54,13525,19.002375296912113
"Elk Garden town, West Virginia",103,86,17,54,24484,16.50485436893204
"Lumberport town, West Virginia",363,322,41,54,49252,11.294765840220386
"Holden CDP, West Virginia",374,264,110,54,37948,29.411764705882355
"Williamson city, West Virginia",1732,1331,401,54,87508,23.15242494226328
"West Logan town, West Virginia",260,203,57,54,85900,21.923076923076923
"Piedmont town, West Virginia",452,331,121,54,63604,26.769911504424783
"Gilbert town, West Virginia",268,205,63,54,30772,23.507462686567166
"Beaver CDP, West Virginia",679,583,96,54,05260,14.138438880706921
"Mabscott town, West Virginia",717,639,78,54,49492,10.87866108786611
"Prosperity CDP, West Virginia",891,742,149,54,65836,16.722783389450054
"Grafton city, West Virginia",2442,2140,302,54,32716,12.366912366912366
"Cowen town, West Virginia",346,295,51,54,18412,14.739884393063585
"Mineralwells CDP, West Virginia",723,674,49,54,54580,6.77731673582296
"North Hills town, West Virginia",355,345,10,54,59458,2.8169014084507045
"Williamstown city, West Virginia",1393,1305,88,54,87556,6.317300789662599
"Culloden CDP, West Virginia",1552,1400,152,54,19516,9.793814432989691
"Hurricane city, West Virginia",2668,2348,320,54,39532,11.994002998500749
"Nitro city, West Virginia",3158,2712,446,54,59068,14.122862571247625
"Iaeger town, West Virginia",154,105,49,54,39652,31.818181818181817
"Kimball town, West Virginia",133,47,86,54,43780,64.66165413533834
"Hartford City town, West Virginia",398,311,87,54,35500,21.85929648241206
"Kingwood city, West Virginia",1356,1152,204,54,44044,15.04424778761062
"Gary city, West Virginia",472,293,179,54,30196,37.92372881355932
"Welch city, West Virginia",1312,942,370,54,85228,28.20121951219512
"New Haven town, West Virginia",754,639,115,54,58564,15.251989389920425
"Clay town, West Virginia",336,227,109,54,15676,32.44047619047619
"Kenova city, West Virginia",1531,1264,267,54,43180,17.439581972566952
"Madison city, West Virginia",1444,1161,283,54,50524,19.598337950138504
"Sylvester town, West Virginia",95,88,7,54,78964,7.368421052631578
"East Bank town, West Virginia",352,301,51,54,23092,14.488636363636365
"Glasgow town, West Virginia",331,290,41,54,31324,12.386706948640484
"Westover city, West Virginia",2008,1894,114,54,85996,5.677290836653386
"Bath (Berkeley Springs) town, West Virginia",410,307,103,54,04876,25.121951219512194
"Fairmont city, West Virginia",8933,7577,1356,54,26452,15.179670883241911
"Farmington town, West Virginia",174,143,31,54,26932,17.81609195402299
"Bramwell town, West Virginia",198,123,75,54,09796,37.878787878787875
"Junior town, West Virginia",196,157,39,54,42244,19.897959183673468
"Inwood CDP, West Virginia",1266,1227,39,54,40204,3.080568720379147
"Hooverson Heights CDP, West Virginia",1050,1005,45,54,38476,4.285714285714286
"Wellsburg city, West Virginia",1434,1323,111,54,85324,7.740585774058577
"West Union town, West Virginia",437,286,151,54,86116,34.55377574370709
"Rowlesburg town, West Virginia",293,197,96,54,70588,32.76450511945392
"Bethany town, West Virginia",187,142,45,54,06844,24.06417112299465
"Pineville town, West Virginia",348,256,92,54,63940,26.436781609195403
"Hedgesville town, West Virginia",117,102,15,54,36220,12.82051282051282
"Martinsburg city, West Virginia",8329,7166,1163,54,52060,13.963260895665746
"Chesapeake town, West Virginia",970,806,164,54,15028,16.90721649484536
"Bradshaw town, West Virginia",119,90,29,54,09700,24.369747899159663
"Davy town, West Virginia",141,107,34,54,20500,24.113475177304963
"Coal Fork CDP, West Virginia",689,556,133,54,16612,19.3033381712627
"Ridgeley town, West Virginia",413,311,102,54,68260,24.69733656174334
"Rhodell town, West Virginia",71,48,23,54,67996,32.3943661971831
"Charleston city, West Virginia",25534,21970,3564,54,14600,13.957860108091172
"Handley town, West Virginia",92,62,30,54,34756,32.608695652173914
"Pratt town, West Virginia",228,171,57,54,65356,25.0
"Cassville CDP, West Virginia",592,499,93,54,13756,15.70945945945946
"Paw Paw town, West Virginia",269,196,73,54,62332,27.137546468401485
"Mannington city, West Virginia",774,601,173,54,51100,22.35142118863049
"Montcalm CDP, West Virginia",244,158,86,54,55372,35.24590163934426
"Belington town, West Virginia",855,703,152,54,05788,17.77777777777778
"Henderson town, West Virginia",128,108,20,54,36436,15.625
"Pea Ridge CDP, West Virginia",3311,3085,226,54,62488,6.825732407127756
"Piney View CDP, West Virginia",567,535,32,54,63988,5.64373897707231
"Elizabeth town, West Virginia",431,361,70,54,24364,16.241299303944317
"Hundred town, West Virginia",216,144,72,54,39340,33.33333333333333
"Auburn town, West Virginia",49,41,8,54,03364,16.3265306122449
"Pennsboro city, West Virginia",553,411,142,54,62764,25.678119349005424
"Sand Fork town, West Virginia",78,65,13,54,71620,16.666666666666664
"Poca town, West Virginia",466,417,49,54,64516,10.515021459227468
"Pine Grove town, West Virginia",263,195,68,54,63892,25.85551330798479
"Washington CDP, West Virginia",452,345,107,54,84724,23.672566371681416
"Buffalo town, West Virginia",591,475,116,54,11284,19.627749576988155
"Peterstown town, West Virginia",284,241,43,54,63052,15.140845070422534
"Fairlea CDP, West Virginia",800,754,46,54,26428,5.75
"Falling Spring town, West Virginia",117,80,37,54,26692,31.62393162393162
"Ronceverte city, West Virginia",920,820,100,54,70156,10.869565217391305
"Glen Dale city, West Virginia",727,669,58,54,31492,7.977991746905088
"Lewisburg city, West Virginia",2166,2001,165,54,46636,7.617728531855955
"Alderson town, West Virginia",625,532,93,54,00772,14.879999999999999
"Newburg town, West Virginia",169,146,23,54,58300,13.609467455621301
"Reedsville town, West Virginia",232,204,28,54,67636,12.068965517241379
"Gauley Bridge town, West Virginia",371,278,93,54,30364,25.067385444743934
"Powellton CDP, West Virginia",363,260,103,54,65284,28.37465564738292
"Anmoore town, West Virginia",330,266,64,54,01900,19.393939393939394
"Salem city, West Virginia",743,556,187,54,71380,25.168236877523555
"Cameron city, West Virginia",528,241,287,54,12484,54.35606060606061
"Rainelle town, West Virginia",733,566,167,54,66652,22.78308321964529
"White Sulphur Springs city, West Virginia",1452,1176,276,54,86812,19.00826446280992
"Ripley city, West Virginia",1448,1411,37,54,68596,2.5552486187845305
"Clearview village, West Virginia",201,201,0,54,15916,0.0
"Wheeling city, West Virginia",14465,11723,2742,54,86452,18.956100933287246
"Belle town, West Virginia",638,552,86,54,05836,13.479623824451412
"Bruceton Mills town, West Virginia",28,28,0,54,10852,0.0
"Masontown town, West Virginia",337,288,49,54,52228,14.540059347181009
"Moorefield town, West Virginia",1510,1390,120,54,55588,7.9470198675496695
"Marmet city, West Virginia",710,595,115,54,51724,16.19718309859155
"Sissonville CDP, West Virginia",1998,1862,136,54,74356,6.806806806806807
"South Charleston city, West Virginia",6317,5662,655,54,75292,10.368845971188856
"Oceana town, West Virginia",657,564,93,54,60364,14.15525114155251
"Princeton city, West Virginia",3140,2597,543,54,65692,17.292993630573246
"Charles Town city, West Virginia",2425,2316,109,54,14610,4.494845360824742
"Harpers Ferry town, West Virginia",179,125,54,54,35284,30.16759776536313
"Durbin town, West Virginia",136,75,61,54,22852,44.85294117647059
"Marlinton town, West Virginia",613,432,181,54,51676,29.526916802610113
"Bolivar town, West Virginia",607,503,104,54,08932,17.1334431630972
"Weirton city, West Virginia",8970,8189,781,54,85156,8.706800445930881
"Romney city, West Virginia",1117,933,184,54,70084,16.472694717994628
"Huttonsville town, West Virginia",84,69,15,54,39628,17.857142857142858
"Mill Creek town, West Virginia",334,285,49,54,54100,14.67065868263473
"Beech Bottom village, West Virginia",307,239,68,54,05452,22.149837133550488
"Gassaway town, West Virginia",530,426,104,54,30220,19.622641509433965
"Beverly town, West Virginia",358,303,55,54,06988,15.363128491620111
"Womelsdorf (Coalton) town, West Virginia",129,123,6,54,88324,4.651162790697675
"White Hall town, West Virginia",383,357,26,54,86620,6.7885117493472595
"Ranson corporation, West Virginia",2069,1895,174,54,66988,8.409859835669407
"Accoville CDP, West Virginia",322,307,15,54,00196,4.658385093167702
"Amherstdale CDP, West Virginia",223,196,27,54,01660,12.10762331838565
"Apple Grove CDP, West Virginia",87,51,36,54,02188,41.37931034482759
"Aurora CDP, West Virginia",74,74,0,54,03460,0.0
"Bartley CDP, West Virginia",47,22,25,54,04732,53.191489361702125
"Bartow CDP, West Virginia",43,20,23,54,04780,53.48837209302325
"Beards Fork CDP, West Virginia",77,77,0,54,05068,0.0
"Belva CDP, West Virginia",51,43,8,54,06052,15.686274509803921
"Bergoo CDP, West Virginia",61,28,33,54,06436,54.09836065573771
"Berwind CDP, West Virginia",170,123,47,54,06748,27.647058823529413
"Big Chimney CDP, West Virginia",249,249,0,54,07204,0.0
"Big Creek CDP, West Virginia",49,35,14,54,07228,28.57142857142857
"Big Sandy CDP, West Virginia",104,80,24,54,07516,23.076923076923077
"Birch River CDP, West Virginia",35,35,0,54,07756,0.0
"Bluewell CDP, West Virginia",1382,938,444,54,08764,32.127351664254704
"Bolt CDP, West Virginia",354,341,13,54,08956,3.672316384180791
"Boomer CDP, West Virginia",343,264,79,54,09100,23.03206997084548
"Bowden CDP, West Virginia",0,0,0,54,09364,
"Brandywine CDP, West Virginia",150,99,51,54,09868,34.0
"Brenton CDP, West Virginia",157,130,27,54,09964,17.197452229299362
"Bruno CDP, West Virginia",284,284,0,54,10876,0.0
"Brush Fork CDP, West Virginia",692,597,95,54,10948,13.728323699421965
"Bud CDP, West Virginia",205,185,20,54,11212,9.75609756097561
"Burlington CDP, West Virginia",63,40,23,54,11620,36.507936507936506
"Carolina CDP, West Virginia",254,254,0,54,13468,0.0
"Cass CDP, West Virginia",91,33,58,54,13684,63.73626373626373
"Century CDP, West Virginia",49,29,20,54,14212,40.816326530612244
"Charlton Heights CDP, West Virginia",140,128,12,54,14630,8.571428571428571
"Chauncey CDP, West Virginia",186,168,18,54,14716,9.67741935483871
"Chelyan CDP, West Virginia",327,302,25,54,14812,7.64525993883792
"Comfort CDP, West Virginia",78,74,4,54,17380,5.128205128205128
"Corinne CDP, West Virginia",149,130,19,54,17836,12.751677852348994
"Covel CDP, West Virginia",75,13,62,54,18388,82.66666666666667
"Crum CDP, West Virginia",105,66,39,54,19300,37.142857142857146
"Crumpler CDP, West Virginia",99,78,21,54,19324,21.21212121212121
"Cucumber CDP, West Virginia",40,40,0,54,19492,0.0
"Dailey CDP, West Virginia",45,12,33,54,19948,73.33333333333333
"Deep Water CDP, West Virginia",105,93,12,54,20764,11.428571428571429
"Dixie CDP, West Virginia",114,107,7,54,21628,6.140350877192982
"East Dailey CDP, West Virginia",225,225,0,54,23140,0.0
"Eccles CDP, West Virginia",202,68,134,54,23644,66.33663366336634
"Falling Waters CDP, West Virginia",597,556,41,54,26716,6.867671691792294
"Falls View CDP, West Virginia",101,78,23,54,26812,22.772277227722775
"Fenwick CDP, West Virginia",74,52,22,54,27196,29.72972972972973
"Ghent CDP, West Virginia",345,197,148,54,30724,42.89855072463768
"Frank CDP, West Virginia",32,32,0,54,28948,0.0
"Gallipolis Ferry CDP, West Virginia",465,338,127,54,29716,27.311827956989248
"Galloway CDP, West Virginia",43,21,22,54,29740,51.162790697674424
"Glen Ferris CDP, West Virginia",150,88,62,54,31732,41.333333333333336
"Glen Fork CDP, West Virginia",119,119,0,54,31756,0.0
"Glen Jean CDP, West Virginia",49,40,9,54,31876,18.367346938775512
"Glen White CDP, West Virginia",110,110,0,54,32068,0.0
"Great Cacapon CDP, West Virginia",194,119,75,54,33100,38.659793814432994
"Green Bank CDP, West Virginia",90,77,13,54,33124,14.444444444444443
"Green Spring CDP, West Virginia",136,97,39,54,33436,28.676470588235293
"Greenview CDP, West Virginia",177,153,24,54,33580,13.559322033898304
"Gypsy CDP, West Virginia",107,83,24,54,34180,22.429906542056074
"Helen CDP, West Virginia",31,13,18,54,36292,58.06451612903226
"Helvetia CDP, West Virginia",63,31,32,54,36340,50.79365079365079
"Henlawson CDP, West Virginia",72,49,23,54,36484,31.944444444444443
"Hepzibah CDP, West Virginia",292,277,15,54,36628,5.136986301369863
"Hico CDP, West Virginia",173,110,63,54,37036,36.41618497109826
"Hilltop CDP, West Virginia",136,120,16,54,37444,11.76470588235294
"Hometown CDP, West Virginia",259,229,30,54,38260,11.583011583011583
"Huntersville CDP, West Virginia",52,52,0,54,39412,0.0
"Idamay CDP, West Virginia",370,255,115,54,39676,31.08108108108108
"Itmann CDP, West Virginia",102,102,0,54,40444,0.0
"Jacksonburg CDP, West Virginia",74,33,41,54,40636,55.4054054054054
"Jefferson CDP, West Virginia",221,201,20,54,41010,9.049773755656108
"Justice CDP, West Virginia",239,225,14,54,42292,5.857740585774058
"Kimberly CDP, West Virginia",76,62,14,54,43828,18.421052631578945
"Kincaid CDP, West Virginia",41,33,8,54,43852,19.51219512195122
"Kistler CDP, West Virginia",211,158,53,54,44188,25.118483412322274
"Kopperston CDP, West Virginia",278,232,46,54,44548,16.546762589928058
"Lashmeet CDP, West Virginia",203,203,0,54,45292,0.0
"Lavalette CDP, West Virginia",523,384,139,54,45580,26.577437858508606
"Lesage CDP, West Virginia",581,470,111,54,46420,19.104991394148023
"Littleton CDP, West Virginia",137,42,95,54,47788,69.34306569343066
"McConnell CDP, West Virginia",349,283,66,54,49732,18.911174785100286
"Matheny CDP, West Virginia",194,160,34,54,52372,17.525773195876287
"Maybeury CDP, West Virginia",116,42,74,54,52588,63.793103448275865
"Middleway CDP, West Virginia",192,192,0,54,53692,0.0
"Monaville CDP, West Virginia",113,85,28,54,55132,24.778761061946902
"Mount Carbon CDP, West Virginia",176,150,26,54,56212,14.772727272727273
"Neibert CDP, West Virginia",59,46,13,54,57916,22.033898305084744
"Nettie CDP, West Virginia",279,259,20,54,58180,7.168458781362006
"New Richmond CDP, West Virginia",253,177,76,54,58756,30.039525691699602
"Omar CDP, West Virginia",259,163,96,54,60628,37.06563706563706
"Page CDP, West Virginia",91,61,30,54,61660,32.967032967032964
"Pageton CDP, West Virginia",64,40,24,54,61684,37.5
"Pentress CDP, West Virginia",96,76,20,54,62788,20.833333333333336
"Pickens CDP, West Virginia",10,10,0,54,63484,0.0
"Prichard CDP, West Virginia",147,105,42,54,65596,28.57142857142857
"Prince CDP, West Virginia",29,20,9,54,65668,31.03448275862069
"Rachel CDP, West Virginia",111,111,0,54,66460,0.0
"Racine CDP, West Virginia",127,114,13,54,66484,10.236220472440944
"Rand CDP, West Virginia",825,673,152,54,66892,18.424242424242422
"Raysal CDP, West Virginia",267,206,61,54,67228,22.846441947565545
"Reader CDP, West Virginia",250,161,89,54,67252,35.6
"Robinette CDP, West Virginia",263,221,42,54,69100,15.96958174904943
"Sarah Ann CDP, West Virginia",96,43,53,54,72004,55.208333333333336
"Roderfield CDP, West Virginia",49,24,25,54,69844,51.02040816326531
"Rossmore CDP, West Virginia",114,114,0,54,70468,0.0
"Salt Rock CDP, West Virginia",224,154,70,54,71476,31.25
"Scarbro CDP, West Virginia",273,242,31,54,72292,11.355311355311356
"Shannondale CDP, West Virginia",1583,1333,250,54,73252,15.792798483891346
"Shenandoah Junction CDP, West Virginia",244,222,22,54,73444,9.01639344262295
"Shrewsbury CDP, West Virginia",275,275,0,54,73876,0.0
"Spelter CDP, West Virginia",176,176,0,54,75796,0.0
"Springfield CDP, West Virginia",212,189,23,54,76084,10.849056603773585
"Stollings CDP, West Virginia",214,214,0,54,76996,0.0
"Tioga CDP, West Virginia",54,30,24,54,80476,44.44444444444444
"Twilight CDP, West Virginia",67,28,39,54,81484,58.2089552238806
"Valley Bend CDP, West Virginia",217,194,23,54,82564,10.599078341013826
"Nelsonville village, Wisconsin",46,40,6,55,56000,13.043478260869565
"Appleton city, Wisconsin",30380,29125,1255,55,02375,4.13100724160632
"Winneconne village, Wisconsin",1312,1161,151,55,87900,11.509146341463415
"Butternut village, Wisconsin",221,191,30,55,11525,13.574660633484163
"Mellen city, Wisconsin",426,328,98,55,50700,23.004694835680752
"Kewaskum village, Wisconsin",1759,1648,111,55,39300,6.310403638430927
"Edgerton city, Wisconsin",2388,2231,157,55,22575,6.574539363484087
"Footville village, Wisconsin",342,329,13,55,26400,3.8011695906432745
"La Farge village, Wisconsin",371,351,20,55,40875,5.3908355795148255
"Fairchild village, Wisconsin",282,248,34,55,24825,12.056737588652481
"Altoona city, Wisconsin",3305,3070,235,55,01550,7.110438729198185
"Algoma city, Wisconsin",1528,1306,222,55,01000,14.528795811518325
"White Lake village, Wisconsin",215,154,61,55,86750,28.37209302325581
"Prairie Farm village, Wisconsin",223,210,13,55,65150,5.829596412556054
"Birchwood village, Wisconsin",291,180,111,55,07550,38.144329896907216
"Cambria village, Wisconsin",292,259,33,55,12200,11.301369863013697
"Friesland village, Wisconsin",133,116,17,55,28000,12.781954887218044
"Portage city, Wisconsin",4521,4261,260,55,64100,5.7509400575094
"Wyocena village, Wisconsin",302,293,9,55,89300,2.980132450331126
"Menomonie city, Wisconsin",6285,5757,528,55,51025,8.400954653937948
"Rockdale village, Wisconsin",115,97,18,55,68725,15.65217391304348
"Grafton village, Wisconsin",5263,5105,158,55,30000,3.002090062701881
"Lake Delton village, Wisconsin",2540,1440,1100,55,41300,43.30708661417323
"La Valle village, Wisconsin",177,156,21,55,42825,11.864406779661017
"Birnamwood village, Wisconsin",373,297,76,55,07600,20.37533512064343
"Luck village, Wisconsin",627,559,68,55,46200,10.845295055821373
"Turtle Lake village, Wisconsin",486,439,47,55,81075,9.670781893004115
"Sheldon village, Wisconsin",127,105,22,55,73175,17.322834645669293
"Cascade village, Wisconsin",297,270,27,55,12825,9.090909090909092
"Plymouth city, Wisconsin",4324,4089,235,55,63700,5.434782608695652
"Berlin city, Wisconsin",2636,2391,245,55,06925,9.294385432473444
"Redgranite village, Wisconsin",603,470,133,55,66625,22.056384742951906
"Wild Rose village, Wisconsin",336,305,31,55,87075,9.226190476190476
"Sturtevant village, Wisconsin",2032,1963,69,55,77925,3.395669291338583
"Wind Point village, Wisconsin",818,762,56,55,87700,6.845965770171149
"Kellnersville village, Wisconsin",193,173,20,55,39000,10.362694300518134
"Valders village, Wisconsin",430,389,41,55,82200,9.534883720930234
"Elm Grove village, Wisconsin",2423,2293,130,55,23575,5.3652496904663645
"Little Chute village, Wisconsin",5091,4804,287,55,44950,5.637399332154783
"Merton village, Wisconsin",1167,1150,17,55,51375,1.4567266495287061
"West Milwaukee village, Wisconsin",2281,2028,253,55,85875,11.091626479614204
"Cedarburg city, Wisconsin",5082,4823,259,55,13375,5.096418732782369
"West Allis city, Wisconsin",29200,27657,1543,55,85300,5.284246575342466
"Ephraim village, Wisconsin",681,152,529,55,24150,77.67988252569751
"Sturgeon Bay city, Wisconsin",5051,4415,636,55,77875,12.5915660265294
"Poplar village, Wisconsin",273,258,15,55,63975,5.4945054945054945
"Solon Springs village, Wisconsin",395,293,102,55,74575,25.82278481012658
"Shell Lake city, Wisconsin",960,571,389,55,73200,40.520833333333336
"Sun Prairie city, Wisconsin",13837,13242,595,55,78600,4.30006504300065
"Ixonia CDP, Wisconsin",712,685,27,55,37575,3.7921348314606744
"Palmyra village, Wisconsin",773,706,67,55,61025,8.667529107373868
"Tainter Lake CDP, Wisconsin",1343,1178,165,55,78980,12.285927029039465
"Blue Mounds village, Wisconsin",388,371,17,55,08475,4.381443298969072
"Fitchburg city, Wisconsin",12693,12127,566,55,25950,4.459150712991413
"Mazomanie village, Wisconsin",761,747,14,55,50225,1.8396846254927726
"Shorewood Hills village, Wisconsin",903,876,27,55,73750,2.990033222591362
"Waunakee village, Wisconsin",5061,4956,105,55,84350,2.0746887966804977
"Bangor village, Wisconsin",580,571,9,55,04550,1.5517241379310345
"Junction City village, Wisconsin",225,186,39,55,38650,17.333333333333336
"Stevens Point city, Wisconsin",11119,10337,782,55,77200,7.033006565338609
"Auburndale village, Wisconsin",328,302,26,55,03775,7.926829268292683
"Biron village, Wisconsin",465,414,51,55,07650,10.967741935483872
"Port Edwards village, Wisconsin",791,716,75,55,64175,9.481668773704172
"Ladysmith city, Wisconsin",1604,1506,98,55,40850,6.109725685785536
"Hurley city, Wisconsin",1073,831,242,55,36525,22.55358807082945
"Montreal city, Wisconsin",502,363,139,55,54075,27.689243027888445
"Milwaukee city, Wisconsin",257506,229556,27950,55,53000,10.854116020597578
"Sussex village, Wisconsin",4256,4104,152,55,78750,3.571428571428571
"Balsam Lake village, Wisconsin",650,340,310,55,04475,47.69230769230769
"Rewey village, Wisconsin",126,119,7,55,67100,5.555555555555555
"Oostburg village, Wisconsin",1186,1138,48,55,60100,4.0472175379426645
"Alma Center village, Wisconsin",224,194,30,55,01300,13.392857142857142
"Darien village, Wisconsin",652,600,52,55,18825,7.975460122699387
"Delavan Lake CDP, Wisconsin",2372,1136,1236,55,19500,52.1079258010118
"Elkhorn city, Wisconsin",4065,3946,119,55,23300,2.927429274292743
"Melrose village, Wisconsin",226,210,16,55,50750,7.079646017699115
"Oxford village, Wisconsin",314,240,74,55,60875,23.56687898089172
"Westfield village, Wisconsin",595,513,82,55,85575,13.781512605042018
"Melvina village, Wisconsin",33,19,14,55,50800,42.42424242424242
"Ironton village, Wisconsin",96,87,9,55,37225,9.375
"Lime Ridge village, Wisconsin",88,71,17,55,44225,19.318181818181817
"Plain village, Wisconsin",391,335,56,55,63125,14.322250639386189
"Waukau CDP, Wisconsin",129,129,0,55,84200,0.0
"Waumandee CDP, Wisconsin",47,47,0,55,84300,0.0
"Westboro CDP, Wisconsin",74,74,0,55,85425,0.0
"Dellwood CDP, Wisconsin",944,310,634,55,19600,67.16101694915254
"St. Joseph CDP, Wisconsin",178,178,0,55,70800,0.0
"Summit village, Wisconsin",2090,1815,275,55,78375,13.157894736842104
"Bloomfield village, Wisconsin",1992,1557,435,55,08265,21.837349397590362
"Whittlesey CDP, Wisconsin",53,46,7,55,87000,13.20754716981132
"Harrison village, Wisconsin",4168,4113,55,55,32790,1.3195777351247602
"Winchester CDP, Wisconsin",284,284,0,55,87625,0.0
"Woodford CDP, Wisconsin",35,23,12,55,88675,34.285714285714285
"Woodruff CDP, Wisconsin",560,386,174,55,88925,31.071428571428573
"Lily Lake CDP, Wisconsin",243,169,74,55,44033,30.45267489711934
"North Bay village, Wisconsin",90,89,1,55,57700,1.1111111111111112
"Lancaster city, Wisconsin",1778,1546,232,55,42250,13.048368953880765
"Withee village, Wisconsin",201,182,19,55,88275,9.45273631840796
"Clyman village, Wisconsin",151,139,12,55,15900,7.9470198675496695
"Reeseville village, Wisconsin",338,306,32,55,66900,9.467455621301776
"Arpin village, Wisconsin",158,140,18,55,03025,11.39240506329114
"Catawba village, Wisconsin",89,65,24,55,13175,26.96629213483146
"Nekoosa city, Wisconsin",1215,1040,175,55,55875,14.40329218106996
"Plover village, Wisconsin",5567,5285,282,55,63525,5.065564936231364
"Whiting village, Wisconsin",787,751,36,55,86975,4.5743329097839895
"Menasha city, Wisconsin",8201,7711,490,55,50825,5.974881112059505
"Odanah CDP, Wisconsin",0,0,0,55,59450,
"Germantown village, Wisconsin",8244,7967,277,55,28875,3.3600194080543426
"Hartford city, Wisconsin",6207,5888,319,55,33000,5.139358788464636
"Viroqua city, Wisconsin",2181,2100,81,55,82925,3.7138927097661623
"Seymour CDP, Wisconsin",659,624,35,55,72670,5.311077389984825
"Casco village, Wisconsin",243,212,31,55,12850,12.757201646090536
"West Bend city, Wisconsin",14241,13734,507,55,85350,3.5601432483673903
"Cadott village, Wisconsin",704,653,51,55,11750,7.2443181818181825
"Augusta city, Wisconsin",671,595,76,55,03825,11.326378539493295
"Stockbridge village, Wisconsin",362,314,48,55,77400,13.259668508287293
"Durand city, Wisconsin",876,812,64,55,21225,7.30593607305936
"Endeavor village, Wisconsin",229,209,20,55,24075,8.73362445414847
"Como CDP, Wisconsin",1601,1055,546,55,16575,34.10368519675203
"Delavan city, Wisconsin",3419,3186,233,55,19450,6.814858145656625
"Princeton city, Wisconsin",635,536,99,55,65600,15.590551181102363
"Bear River town, Wyoming",229,208,21,56,05625,9.170305676855897
"Encampment town, Wyoming",368,207,161,56,24750,43.75
"Star Valley Ranch town, Wyoming",1206,805,401,56,73180,33.250414593698174
"Veteran CDP, Wyoming",15,15,0,56,80285,0.0
"Ranchester town, Wyoming",369,344,25,56,63755,6.775067750677506
"Story CDP, Wyoming",604,326,278,56,73615,46.026490066225165
"Lingle town, Wyoming",249,218,31,56,46790,12.449799196787147
"Clearview Acres CDP, Wyoming",448,399,49,56,15400,10.9375
"Little America CDP, Wyoming",84,84,0,56,46935,0.0
"McKinnon CDP, Wyoming",0,0,0,56,49400,
"Opal town, Wyoming",75,49,26,56,57810,34.66666666666667
"Rock Springs city, Wyoming",10668,8523,2145,56,67235,20.106861642294714
"Afton town, Wyoming",980,754,226,56,00245,23.06122448979592
"Cokeville town, Wyoming",205,178,27,56,15905,13.170731707317074
"Yoder town, Wyoming",55,51,4,56,86665,7.2727272727272725
"Glendo town, Wyoming",180,114,66,56,32290,36.666666666666664
"Marbleton town, Wyoming",476,353,123,56,50415,25.840336134453786
"Arvada CDP, Wyoming",41,20,21,56,03725,51.21951219512195
"Sheridan city, Wyoming",8602,8036,566,56,69845,6.579865147640083
"Alcova CDP, Wyoming",53,0,53,56,01115,100.0
"Bar Nunn town, Wyoming",973,950,23,56,05245,2.36382322713258
"Farson CDP, Wyoming",148,44,104,56,26055,70.27027027027027
"Reliance CDP, Wyoming",346,273,73,56,65060,21.09826589595376
"Superior town, Wyoming",191,120,71,56,74775,37.17277486910995
"Homa Hills CDP, Wyoming",165,124,41,56,38307,24.848484848484848
"Powell city, Wyoming",2901,2537,364,56,62450,12.547397449155465
"Newcastle city, Wyoming",1667,1408,259,56,56215,15.536892621475703
"Upton town, Wyoming",565,480,85,56,79125,15.04424778761062
"Worland city, Wyoming",2432,2183,249,56,84925,10.238486842105262
"Mountain View CDP, Wyoming",55,55,0,56,55200,0.0
"Vista West CDP, Wyoming",395,395,0,56,80575,0.0
"Ralston CDP, Wyoming",162,162,0,56,63465,0.0
"Bairoil town, Wyoming",103,57,46,56,04885,44.66019417475729
"Green River city, Wyoming",4903,4334,569,56,33740,11.6051397103814
"North Rock Springs CDP, Wyoming",991,798,193,56,56700,19.475277497477293
"Table Rock CDP, Wyoming",0,0,0,56,75355,
"Wamsutter town, Wyoming",212,81,131,56,81300,61.79245283018868
"Hill View Heights CDP, Wyoming",39,39,0,56,37727,0.0
"Ten Sleep town, Wyoming",144,104,40,56,75790,27.77777777777778
"Westview Circle CDP, Wyoming",0,0,0,56,82967,
"Cody city, Wyoming",4676,4109,567,56,15760,12.125748502994012
"Frannie town, Wyoming",74,60,14,56,29825,18.91891891891892
"Eden CDP, Wyoming",141,85,56,56,23010,39.71631205673759
"Purple Sage CDP, Wyoming",327,256,71,56,62812,21.712538226299692
"Washam CDP, Wyoming",13,0,13,56,81703,100.0
"Point of Rocks CDP, Wyoming",86,69,17,56,62160,19.767441860465116
"Oakdale village, Wisconsin",126,113,13,55,58850,10.317460317460316
"Athens village, Wisconsin",526,484,42,55,03550,7.984790874524715
"Colby city, Wisconsin",826,751,75,55,16150,9.079903147699758
"Hatley village, Wisconsin",197,188,9,55,33175,4.568527918781726
"Allouez village, Wisconsin",5507,5313,194,55,01150,3.522789177410569
"Arena village, Wisconsin",370,350,20,55,02550,5.405405405405405
"Muscoda village, Wisconsin",675,609,66,55,55200,9.777777777777779
"Kohler village, Wisconsin",923,867,56,55,40275,6.067172264355363
"Green Bay city, Wisconsin",44713,42331,2382,55,31000,5.32730973095073
"Hazel Green village, Wisconsin",498,429,69,55,33500,13.855421686746988
"Pleasant Prairie village, Wisconsin",8232,7756,476,55,63300,5.782312925170068
"Maribel village, Wisconsin",158,152,6,55,49250,3.79746835443038
"St. Nazianz village, Wisconsin",353,334,19,55,71025,5.382436260623229
"Plum City village, Wisconsin",260,237,23,55,63600,8.846153846153847
"Prescott city, Wisconsin",1918,1737,181,55,65375,9.436913451511991
"Deer Park village, Wisconsin",140,125,15,55,19325,10.714285714285714
"Brandon village, Wisconsin",368,360,8,55,09300,2.1739130434782608
"Eden village, Wisconsin",345,319,26,55,22475,7.536231884057972
"Fond du Lac city, Wisconsin",19430,17821,1609,55,26275,8.281008749356666
"North Fond du Lac village, Wisconsin",2002,1914,88,55,58000,4.395604395604396
"Waupun city, Wisconsin",4349,4144,205,55,84425,4.71372729363072
"Trempealeau village, Wisconsin",903,817,86,55,80475,9.523809523809524
"Kimberly village, Wisconsin",2925,2820,105,55,39650,3.5897435897435894
"Bayside village, Wisconsin",1940,1839,101,55,05450,5.206185567010309
"Strum village, Wisconsin",474,455,19,55,77825,4.008438818565401
"Dousman village, Wisconsin",971,931,40,55,20550,4.11946446961895
"Lannon village, Wisconsin",543,498,45,55,42450,8.287292817679557
"New Berlin city, Wisconsin",17085,16685,400,55,56375,2.341235001463272
"Oconomowoc Lake village, Wisconsin",281,215,66,55,59300,23.487544483985765
"Wales village, Wisconsin",985,922,63,55,83175,6.395939086294416
"Waukesha city, Wisconsin",30689,29432,1257,55,84250,4.0959301378344035
"Mequon city, Wisconsin",9545,9074,471,55,51150,4.934520691461499
"Little Round Lake CDP, Wisconsin",501,465,36,55,45220,7.18562874251497
"Genoa City village, Wisconsin",1197,1105,92,55,28675,7.685881370091896
"Lake Geneva city, Wisconsin",4400,3461,939,55,41450,21.34090909090909
"Sharon village, Wisconsin",719,656,63,55,72875,8.762169680111267
"Reserve CDP, Wisconsin",295,187,108,55,67050,36.610169491525426
"Forestville village, Wisconsin",223,202,21,55,26625,9.417040358744394
"Superior village, Wisconsin",339,310,29,55,78660,8.55457227138643
"Camp Douglas village, Wisconsin",274,259,15,55,12350,5.474452554744526
"New Auburn village, Wisconsin",214,187,27,55,56350,12.616822429906541
"Howard village, Wisconsin",8136,7874,262,55,35950,3.220255653883972
"Nichols village, Wisconsin",132,119,13,55,57375,9.848484848484848
"Clinton village, Wisconsin",845,815,30,55,15625,3.5502958579881656
"Peshtigo city, Wisconsin",1668,1486,182,55,62175,10.911270983213429
"Burlington city, Wisconsin",4730,4491,239,55,11200,5.052854122621564
"Radisson village, Wisconsin",204,163,41,55,66050,20.098039215686274
"Winter village, Wisconsin",232,172,60,55,87975,25.862068965517242
"Union Center village, Wisconsin",112,100,12,55,81725,10.714285714285714
"Walworth village, Wisconsin",1183,1066,117,55,83250,9.89010989010989
"Wilson village, Wisconsin",85,82,3,55,87475,3.5294117647058822
"Cecil village, Wisconsin",353,278,75,55,13325,21.246458923512748
"Gresham village, Wisconsin",244,198,46,55,31675,18.852459016393443
"Mattoon village, Wisconsin",190,152,38,55,50000,20.0
"Wittenberg village, Wisconsin",474,448,26,55,88325,5.485232067510549
"Gilman village, Wisconsin",228,195,33,55,29175,14.473684210526317
"Granton village, Wisconsin",152,134,18,55,30425,11.842105263157894
"Gays Mills village, Wisconsin",255,227,28,55,28450,10.980392156862745
"Lynxville village, Wisconsin",132,81,51,55,46675,38.63636363636363
"Mayville city, Wisconsin",2180,2052,128,55,50200,5.871559633027523
"Granger town, Wyoming",79,29,50,56,32870,63.29113924050633
"Torrington city, Wyoming",2685,2504,181,56,77530,6.741154562383612
"Osage CDP, Wyoming",54,54,0,56,58680,0.0
"Arrowhead Springs CDP, Wyoming",56,56,0,56,03652,0.0
"Meadow Acres CDP, Wyoming",81,81,0,56,51285,0.0
"Fox Farm-College CDP, Wyoming",1626,1513,113,56,29300,6.949569495694957
"Deaver town, Wyoming",91,70,21,56,19530,23.076923076923077
"Evanston city, Wyoming",5226,4598,628,56,25620,12.016838882510525
"Ranchettes CDP, Wyoming",2462,2360,102,56,63800,4.1429731925264015
"Lonetree CDP, Wyoming",0,0,0,56,47370,
"Manville town, Wyoming",62,53,9,56,50270,14.516129032258066
"Van Tassell town, Wyoming",17,15,2,56,79705,11.76470588235294
"Alpine town, Wyoming",438,325,113,56,01695,25.799086757990867
"La Barge town, Wyoming",299,137,162,56,43455,54.18060200668896
"Hartville town, Wyoming",54,46,8,56,35625,14.814814814814813
"Cora CDP, Wyoming",72,25,47,56,17210,65.27777777777779
"Daniel CDP, Wyoming",115,87,28,56,18950,24.347826086956523
"Hawk Springs CDP, Wyoming",59,7,52,56,36060,88.13559322033898
"Pinedale town, Wyoming",902,619,283,56,61580,31.37472283813747
"Clearmont town, Wyoming",95,76,19,56,15325,20.0
"Fort Laramie town, Wyoming",140,107,33,56,28230,23.57142857142857
"Huntley CDP, Wyoming",0,0,0,56,39250,
"Bessemer Bend CDP, Wyoming",108,108,0,56,06407,0.0
"Casper city, Wyoming",26305,23986,2319,56,13150,8.815814483938416
"Edgerton town, Wyoming",118,90,28,56,23155,23.728813559322035
"Wilson CDP, Wyoming",1028,696,332,56,83765,32.295719844357976
"Big Horn CDP, Wyoming",276,230,46,56,06770,16.666666666666664
"Hoback CDP, Wyoming",572,485,87,56,37945,15.209790209790212
"Hyattville CDP, Wyoming",74,45,29,56,39395,39.189189189189186
"Cheyenne city, Wyoming",29182,26635,2547,56,13900,8.727983003221164
"South Park CDP, Wyoming",789,628,161,56,71947,20.405576679340935
"Basin town, Wyoming",613,541,72,56,05320,11.745513866231647
"Greybull town, Wyoming",866,731,135,56,33885,15.588914549653579
"Woods Landing-Jelm CDP, Wyoming",72,48,24,56,84852,33.33333333333333
"Kirby town, Wyoming",40,37,3,56,42730,7.5
"Pine Haven town, Wyoming",251,187,64,56,61610,25.49800796812749
"Lander city, Wyoming",3318,3015,303,56,44760,9.132007233273058
"Bedford CDP, Wyoming",87,46,41,56,06045,47.12643678160919
"Oakley CDP, Wyoming",0,0,0,56,57375,
"Smoot CDP, Wyoming",49,49,0,56,71440,0.0
"Guernsey town, Wyoming",558,488,70,56,34320,12.544802867383511
"Evansville town, Wyoming",1389,1216,173,56,25765,12.455003599712024
"Powder River CDP, Wyoming",0,0,0,56,62305,
"Y-O Ranch CDP, Wyoming",30,30,0,56,86737,0.0
"Big Piney town, Wyoming",296,181,115,56,07060,38.85135135135135
"Burns town, Wyoming",171,143,28,56,11265,16.374269005847953
"Gillette city, Wyoming",13643,11853,1790,56,31855,13.12028146302133
"Wright town, Wyoming",954,668,286,56,85015,29.979035639413
"Riverside town, Wyoming",46,26,20,56,66075,43.47826086956522
"Kaycee town, Wyoming",123,101,22,56,41353,17.88617886178862
"Albin town, Wyoming",63,52,11,56,00825,17.46031746031746
"Pine Bluffs town, Wyoming",621,492,129,56,61435,20.77294685990338
"Fort Bridger CDP, Wyoming",100,100,0,56,27940,0.0
"Robertson CDP, Wyoming",16,16,0,56,66655,0.0
"Hulett town, Wyoming",205,174,31,56,39105,15.121951219512194
"Sundance town, Wyoming",681,614,67,56,74195,9.838472834067549
"Hudson town, Wyoming",223,187,36,56,38960,16.143497757847534
"Johnstown CDP, Wyoming",103,93,10,56,40945,9.70873786407767
"Pavillion town, Wyoming",101,76,25,56,60130,24.752475247524753
"Lance Creek CDP, Wyoming",17,9,8,56,44615,47.05882352941176
"Rafter J Ranch CDP, Wyoming",753,753,0,56,63100,0.0
"Lovell town, Wyoming",1063,870,193,56,47950,18.156161806208843
"Manderson town, Wyoming",41,34,7,56,49980,17.073170731707318
"Kaukauna city, Wisconsin",7048,6632,416,55,38800,5.902383654937571
"Antigo city, Wisconsin",4091,3700,391,55,02250,9.557565387435835
"Coleman village, Wisconsin",362,335,27,55,16250,7.458563535911603
"Pound village, Wisconsin",187,178,9,55,64750,4.81283422459893
"New Glarus village, Wisconsin",895,811,84,55,56700,9.385474860335195
"Columbus city, Wisconsin",2392,2136,256,55,16450,10.702341137123746
"Iron Ridge village, Wisconsin",457,417,40,55,37150,8.752735229759299
"Ripon city, Wisconsin",3463,3271,192,55,68175,5.544325729136586
"Fox Point village, Wisconsin",2913,2808,105,55,27075,3.604531410916581
"Hales Corners village, Wisconsin",3417,3143,274,55,32075,8.018729880011707
"Crandon city, Wisconsin",1086,890,196,55,17425,18.047882136279927
"Tomahawk city, Wisconsin",1695,1442,253,55,80125,14.926253687315635
"North Hudson village, Wisconsin",1744,1648,96,55,58050,5.5045871559633035
"South Milwaukee city, Wisconsin",9196,8614,582,55,75125,6.328838625489343
"Wauwatosa city, Wisconsin",21364,20299,1065,55,84675,4.985021531548399
"Cleveland village, Wisconsin",629,606,23,55,15400,3.6565977742448332
"Baldwin village, Wisconsin",1786,1677,109,55,04400,6.103023516237402
"Fountain City city, Wisconsin",479,410,69,55,26850,14.40501043841336
"Linden village, Wisconsin",218,209,9,55,44625,4.128440366972478
"Argyle village, Wisconsin",400,378,22,55,02650,5.5
"Random Lake village, Wisconsin",753,719,34,55,66200,4.51527224435591
"Hancock village, Wisconsin",245,161,84,55,32450,34.285714285714285
"Denmark village, Wisconsin",934,858,76,55,19700,8.137044967880087
"Twin Lakes village, Wisconsin",3219,2301,918,55,81250,28.51817334575955
"Eagle Lake CDP, Wisconsin",647,487,160,55,21525,24.72952086553323
"Union Grove village, Wisconsin",1955,1872,83,55,81775,4.245524296675192
"Waterford village, Wisconsin",2251,2177,74,55,83825,3.287427809862283
"Two Rivers city, Wisconsin",5712,5263,449,55,81325,7.860644257703081
"Whitelaw village, Wisconsin",291,276,15,55,86775,5.154639175257731
"Glenwood City city, Wisconsin",543,518,25,55,29625,4.6040515653775325
"Unity village, Wisconsin",162,154,8,55,81850,4.938271604938271
"Oconto Falls city, Wisconsin",1296,1227,69,55,59400,5.324074074074074
"Cazenovia village, Wisconsin",176,165,11,55,13300,6.25
"Merrimac village, Wisconsin",277,227,50,55,51325,18.050541516245488
"Whitewater city, Wisconsin",5114,4616,498,55,86925,9.73797418850215
"Kingston village, Wisconsin",160,144,16,55,39750,10.0
"Marquette village, Wisconsin",155,83,72,55,49500,46.45161290322581
"Montello city, Wisconsin",873,634,239,55,53875,27.376861397479956
"Cashton village, Wisconsin",475,420,55,55,12950,11.578947368421053
"Kendall village, Wisconsin",231,218,13,55,39150,5.627705627705628
"Warrens village, Wisconsin",394,205,189,55,83450,47.96954314720812
"Fenwood village, Wisconsin",77,73,4,55,25650,5.194805194805195
"Marathon City village, Wisconsin",664,605,59,55,49100,8.885542168674698
"Schofield city, Wisconsin",1121,992,129,55,72150,11.507582515611062
"North Freedom village, Wisconsin",279,258,21,55,58025,7.526881720430108
"Dresser village, Wisconsin",433,421,12,55,20850,2.771362586605081
"Hayward city, Wisconsin",1395,1171,224,55,33450,16.057347670250895
"Nelson village, Wisconsin",178,169,9,55,55950,5.056179775280898
"Ellsworth village, Wisconsin",1338,1302,36,55,23525,2.690582959641256
"Elmwood village, Wisconsin",363,327,36,55,23700,9.917355371900827
"Star Prairie village, Wisconsin",327,290,37,55,76825,11.314984709480122
"Hudson city, Wisconsin",5925,5672,253,55,36250,4.270042194092827
"Mondovi city, Wisconsin",1226,1167,59,55,53600,4.8123980424143555
"Rock Springs village, Wisconsin",158,133,25,55,68975,15.822784810126583
"Zoar CDP, Wisconsin",32,32,0,55,89760,0.0
"Arcadia city, Wisconsin",1092,1035,57,55,02500,5.21978021978022
"Whitehall city, Wisconsin",770,675,95,55,86725,12.337662337662337
"Brookfield city, Wisconsin",15189,14704,485,55,10025,3.193100269932188
"Richfield village, Wisconsin",4603,4500,103,55,67475,2.2376710840756027
"Bellevue village, Wisconsin",6873,6580,293,55,06350,4.263058344245599
"Elk Mountain town, Wyoming",125,83,42,56,24025,33.6
"Rawlins city, Wyoming",3961,3449,512,56,63900,12.926028780610958
"Centennial CDP, Wyoming",304,151,153,56,13440,50.32894736842105
"East Thermopolis town, Wyoming",206,161,45,56,22720,21.844660194174757
"Lucerne CDP, Wyoming",223,223,0,56,48240,0.0
"Riverton city, Wyoming",4887,4290,597,56,66220,12.216083486801718
"Grover CDP, Wyoming",82,82,0,56,34030,0.0
"Taylor CDP, Wyoming",22,22,0,56,75572,0.0
"Alpine Northeast CDP, Wyoming",41,0,41,56,01888,100.0
"Diamondville town, Wyoming",396,337,59,56,20110,14.898989898989898
"Fairview CDP, Wyoming",93,51,42,56,25910,45.16129032258064
"Lakeview North CDP, Wyoming",59,59,0,56,44252,0.0
"Bondurant CDP, Wyoming",143,49,94,56,08365,65.73426573426573
"Parkman CDP, Wyoming",66,66,0,56,59985,0.0
"Douglas city, Wyoming",3197,2594,603,56,21125,18.86143259305599
"Esterbrook CDP, Wyoming",130,31,99,56,25185,76.15384615384615
"Medicine Bow town, Wyoming",238,188,50,56,51575,21.008403361344538
"Mountain View town, Wyoming",506,462,44,56,55345,8.695652173913043
"Laramie city, Wyoming",15176,13417,1759,56,45050,11.590669478123353
"Rock River town, Wyoming",93,63,30,56,67090,32.25806451612903
"Owl Creek CDP, Wyoming",0,0,0,56,59332,
"Ethete CDP, Wyoming",416,349,67,56,25330,16.105769230769234
"Midwest town, Wyoming",183,125,58,56,52445,31.693989071038253
"Rolling Hills town, Wyoming",150,142,8,56,67440,5.333333333333334
"Antelope Hills CDP, Wyoming",15,0,15,56,02877,100.0
"Mills town, Wyoming",1878,1664,214,56,53460,11.395101171458998
"Red Butte CDP, Wyoming",264,223,41,56,64400,15.530303030303031
"Chugcreek CDP, Wyoming",59,59,0,56,14097,0.0
"Wheatland town, Wyoming",1895,1662,233,56,83040,12.295514511873352
"Boulder CDP, Wyoming",40,40,0,56,09235,0.0
"Dayton town, Wyoming",347,315,32,56,19385,9.221902017291066
"La Grange town, Wyoming",130,105,25,56,43745,19.230769230769234
"Alta CDP, Wyoming",242,195,47,56,01985,19.421487603305785
"Jackson town, Wyoming",4874,4006,868,56,40120,17.80878128846943
"Teton Village CDP, Wyoming",879,82,797,56,75935,90.6712172923777
"Cowley town, Wyoming",263,263,0,56,17645,0.0
"Hanna town, Wyoming",492,291,201,56,35335,40.853658536585364
"Sinclair town, Wyoming",205,172,33,56,71150,16.097560975609756
"Warren AFB CDP, Wyoming",554,491,63,56,81640,11.371841155234657
"Lyman town, Wyoming",846,742,104,56,48675,12.293144208037825
"Thermopolis town, Wyoming",1533,1335,198,56,76515,12.915851272015654
"Boulder Flats CDP, Wyoming",130,112,18,56,09307,13.846153846153847
"Crowheart CDP, Wyoming",88,60,28,56,18225,31.818181818181817
"Dubois town, Wyoming",589,415,174,56,21415,29.541595925297116
"Alpine Northwest CDP, Wyoming",56,16,40,56,01936,71.42857142857143
"Kemmerer city, Wyoming",1370,1139,231,56,42005,16.86131386861314
"Turnerville CDP, Wyoming",135,47,88,56,78400,65.18518518518519
"Glenrock town, Wyoming",1119,942,177,56,32435,15.81769436997319
"Brookhurst CDP, Wyoming",160,125,35,56,10175,21.875
"Dixon town, Wyoming",68,41,27,56,20690,39.705882352941174
"Hartrandt CDP, Wyoming",312,267,45,56,35552,14.423076923076922
"Burlington town, Wyoming",71,69,2,56,11120,2.8169014084507045
"Byron town, Wyoming",231,194,37,56,11700,16.017316017316016
"Buffalo city, Wyoming",2413,2184,229,56,10685,9.49026108578533
"Albany CDP, Wyoming",113,12,101,56,00680,89.38053097345133
"Moorcroft town, Wyoming",478,307,171,56,54185,35.77405857740586
"Atlantic City CDP, Wyoming",110,0,110,56,04015,100.0
"Fort Washakie CDP, Wyoming",562,493,69,56,28665,12.277580071174377
"Jeffrey City CDP, Wyoming",14,14,0,56,40555,0.0
"Shoshoni town, Wyoming",319,246,73,56,70570,22.884012539184955
"Auburn CDP, Wyoming",165,165,0,56,04160,0.0
"Fontenelle CDP, Wyoming",18,18,0,56,27650,0.0
"Hobart village, Wisconsin",3880,3701,179,55,35150,4.613402061855671
"Kronenwetter village, Wisconsin",2958,2925,33,55,40550,1.1156186612576064
"Caledonia village, Wisconsin",10325,9911,414,55,11950,4.009685230024213
"Lake Hallie village, Wisconsin",2680,2601,79,55,41525,2.9477611940298507
"Mount Pleasant village, Wisconsin",11914,11153,761,55,54875,6.387443343965084
"Suamico village, Wisconsin",4869,4760,109,55,77975,2.2386527007599093
"Gilmanton CDP, Wisconsin",67,53,14,55,29200,20.8955223880597
"Springbrook CDP, Wisconsin",65,48,17,55,75775,26.153846153846157
"Wiota CDP, Wisconsin",46,46,0,55,88025,0.0
"Maine village, Wisconsin",923,904,19,55,48225,2.058504875406284
"Somers village, Wisconsin",3278,2988,290,55,74625,8.84685784014643
"Windsor village, Wisconsin",2640,2607,33,55,87725,1.25
"Fox Crossing village, Wisconsin",8858,8514,344,55,26982,3.8834951456310676
"Salem Lakes village, Wisconsin",6341,5481,860,55,71163,13.562529569468538
"Abrams CDP, Wisconsin",185,177,8,55,00150,4.324324324324325
"Allenton CDP, Wisconsin",421,382,39,55,01100,9.263657957244655
"Amberg CDP, Wisconsin",158,98,60,55,01650,37.9746835443038
"Angelica CDP, Wisconsin",53,44,9,55,01950,16.9811320754717
"Argonne CDP, Wisconsin",96,72,24,55,02600,25.0
"Arkansaw CDP, Wisconsin",100,100,0,55,02700,0.0
"Arkdale CDP, Wisconsin",152,59,93,55,02725,61.18421052631579
"Ashippun CDP, Wisconsin",396,390,6,55,03175,1.5151515151515151
"Babcock CDP, Wisconsin",62,38,24,55,04150,38.70967741935484
"Baileys Harbor CDP, Wisconsin",263,111,152,55,04300,57.79467680608364
"Bancroft CDP, Wisconsin",210,190,20,55,04525,9.523809523809524
"Barronett CDP, Wisconsin",52,52,0,55,04925,0.0
"Birch Hill CDP, Wisconsin",133,104,29,55,07532,21.804511278195488
"Bluffview CDP, Wisconsin",239,204,35,55,08560,14.644351464435147
"Boulder Junction CDP, Wisconsin",131,52,79,55,08925,60.30534351145038
"Bristol village, Wisconsin",2133,1974,159,55,09800,7.454289732770746
"Brule CDP, Wisconsin",113,92,21,55,10550,18.58407079646018
"Burnett CDP, Wisconsin",121,113,8,55,11250,6.6115702479338845
"Butte des Morts CDP, Wisconsin",360,344,16,55,11500,4.444444444444445
"Cable CDP, Wisconsin",143,106,37,55,11650,25.874125874125873
"Caroline CDP, Wisconsin",102,82,20,55,12675,19.607843137254903
"Cataract CDP, Wisconsin",65,65,0,55,13150,0.0
"Chain O' Lakes CDP, Wisconsin",1064,489,575,55,13880,54.04135338345865
"Chelsea CDP, Wisconsin",47,46,1,55,14175,2.127659574468085
"Chili CDP, Wisconsin",88,72,16,55,14450,18.181818181818183
"Clam Lake CDP, Wisconsin",64,17,47,55,14850,73.4375
"Collins CDP, Wisconsin",47,47,0,55,16350,0.0
"Cornucopia CDP, Wisconsin",152,65,87,55,17150,57.23684210526315
"Dale CDP, Wisconsin",244,230,14,55,18500,5.737704918032787
"Dalton CDP, Wisconsin",95,84,11,55,18625,11.578947368421053
"Danbury CDP, Wisconsin",97,80,17,55,18650,17.525773195876287
"Diamond Bluff CDP, Wisconsin",101,84,17,55,20125,16.831683168316832
"Diaperville CDP, Wisconsin",23,15,8,55,20167,34.78260869565217
"Dodge CDP, Wisconsin",81,69,12,55,20275,14.814814814814813
"Downsville CDP, Wisconsin",65,56,9,55,20725,13.846153846153847
"Drummond CDP, Wisconsin",116,73,43,55,20875,37.06896551724138
"Dunbar CDP, Wisconsin",74,40,34,55,20975,45.94594594594595
"Dyckesville CDP, Wisconsin",302,239,63,55,21375,20.86092715231788
"Edmund CDP, Wisconsin",93,74,19,55,22700,20.43010752688172
"Elcho CDP, Wisconsin",193,142,51,55,23025,26.42487046632124
"Ellison Bay CDP, Wisconsin",243,67,176,55,23475,72.42798353909465
"Emerald CDP, Wisconsin",52,52,0,55,23900,0.0
"Eureka CDP, Wisconsin",218,209,9,55,24475,4.128440366972478
"Florence CDP, Wisconsin",370,267,103,55,26175,27.837837837837835
"Forest Junction CDP, Wisconsin",297,294,3,55,26575,1.0101010101010102
"Garland CDP, Wyoming",150,107,43,56,30985,28.666666666666668
"Franks Field CDP, Wisconsin",83,73,10,55,27412,12.048192771084338
"Gibbsville CDP, Wisconsin",196,183,13,55,28925,6.63265306122449
"Thayne town, Wyoming",190,173,17,56,76370,8.947368421052632
"Slater CDP, Wyoming",25,25,0,56,71295,0.0
"James Town CDP, Wyoming",311,285,26,56,40265,8.360128617363344
"Meeteetse town, Wyoming",176,149,27,56,51720,15.340909090909092
"Baggs town, Wyoming",217,163,54,56,04740,24.88479262672811
"Saratoga town, Wyoming",980,668,312,56,68685,31.83673469387755
"Lusk town, Wyoming",790,591,199,56,48530,25.18987341772152
"Lost Springs town, Wyoming",1,1,0,56,47805,0.0
"South Greeley CDP, Wyoming",1934,1708,226,56,71800,11.685625646328852
"Arapahoe CDP, Wyoming",525,430,95,56,03000,18.095238095238095
"Moose Wilson Road CDP, Wyoming",1434,649,785,56,54402,54.74198047419805
"Carter CDP, Wyoming",0,0,0,56,13005,
"Casper Mountain CDP, Wyoming",376,267,109,56,13222,28.98936170212766
"Chugwater town, Wyoming",151,140,11,56,14165,7.28476821192053
"Sleepy Hollow CDP, Wyoming",401,401,0,56,71350,0.0
"Etna CDP, Wyoming",22,22,0,56,25475,0.0
"Arlington CDP, Wyoming",40,6,34,56,03245,85.0
"Beulah CDP, Wyoming",0,0,0,56,06480,
"Carpenter CDP, Wyoming",143,143,0,56,12860,0.0
"Freedom CDP, Wyoming",128,76,52,56,30115,40.625
"Hillsdale CDP, Wyoming",0,0,0,56,37510,
"Kelly CDP, Wyoming",0,0,0,56,41860,
"Mammoth CDP, Wyoming",51,0,51,56,49775,100.0
"Nordic CDP, Wyoming",218,178,40,56,56520,18.34862385321101
"Orin CDP, Wyoming",20,20,0,56,58100,0.0
"Osmond CDP, Wyoming",118,118,0,56,58970,0.0
"Ryan Park CDP, Wyoming",163,0,163,56,67670,100.0
"Shell CDP, Wyoming",74,74,0,56,69700,0.0
"Urie CDP, Wyoming",159,159,0,56,79270,0.0
"Whiting CDP, Wyoming",53,53,0,56,83100,0.0
"Fox Park CDP, Wyoming",46,0,46,56,29400,100.0
"Comunas comunidad, Puerto Rico",733,535,198,72,19837,27.012278308321964
"Yabucoa zona urbana, Puerto Rico",2777,2336,441,72,87863,15.88044652502701
"Palomas comunidad (Yauco Municipio), Puerto Rico",891,609,282,72,59053,31.64983164983165
"Stella comunidad, Puerto Rico",1320,626,694,72,80596,52.57575757575758
"Mariano Col�n comunidad, Puerto Rico",998,863,135,72,51055,13.527054108216433
"Rinc�n zona urbana, Puerto Rico",1001,430,571,72,69588,57.04295704295704
"Parcelas Pe�uelas comunidad, Puerto Rico",374,279,95,72,59440,25.40106951871658
"Juncal comunidad, Puerto Rico",429,339,90,72,39470,20.97902097902098
"Palmas comunidad, Puerto Rico",717,392,325,72,58516,45.32775453277546
"Jauca comunidad, Puerto Rico",723,616,107,72,38241,14.79944674965422
"Playita Cortada comunidad, Puerto Rico",605,345,260,72,63568,42.97520661157025
"Ceiba zona urbana, Puerto Rico",2560,2032,528,72,15924,20.625
"El Mang� comunidad, Puerto Rico",549,479,70,72,25556,12.750455373406194
"Juncos zona urbana, Puerto Rico",3663,2875,788,72,39574,21.51242151242151
"Can�vanas zona urbana, Puerto Rico",3052,2390,662,72,12828,21.690694626474443
"Naranjito zona urbana, Puerto Rico",664,518,146,72,56129,21.987951807228914
"Parcelas La Milagrosa comunidad, Puerto Rico",536,339,197,72,59420,36.75373134328358
"Los Llanos comunidad, Puerto Rico",872,818,54,72,47013,6.192660550458716
"Pajonal comunidad, Puerto Rico",285,237,48,72,57862,16.842105263157894
"Fuig comunidad, Puerto Rico",666,499,167,72,29727,25.075075075075077
"Coraz�n comunidad, Puerto Rico",1013,755,258,72,20353,25.468904244817374
"Guaynabo zona urbana, Puerto Rico",31481,24633,6848,72,32522,21.752803278167786
"Maunabo zona urbana, Puerto Rico",734,550,184,72,52345,25.068119891008173
"La Luisa comunidad, Puerto Rico",1108,902,206,72,41294,18.592057761732853
"Tierras Nuevas Poniente comunidad, Puerto Rico",1397,1198,199,72,82187,14.244810307802434
"Emajagua comunidad, Puerto Rico",1451,1093,358,72,26502,24.67263955892488
"Naguabo zona urbana, Puerto Rico",2033,1620,413,72,55828,20.31480570585342
"Pe�a Pobre comunidad, Puerto Rico",323,206,117,72,60945,36.22291021671827
"Glen Haven CDP, Wisconsin",40,22,18,55,29500,45.0
"Glidden CDP, Wisconsin",276,187,89,55,29675,32.2463768115942
"Goodman CDP, Wisconsin",204,123,81,55,29750,39.705882352941174
"Gordon CDP, Wisconsin",117,86,31,55,29900,26.495726495726498
"Gotham CDP, Wisconsin",113,104,9,55,29950,7.964601769911504
"Grand Marsh CDP, Wisconsin",58,58,0,55,30100,0.0
"Tallaboa comunidad, Puerto Rico",367,303,64,72,81413,17.43869209809264
"Ponce zona urbana, Puerto Rico",55066,43916,11150,72,63820,20.248429157737988
"El Negro comunidad, Puerto Rico",480,414,66,72,25685,13.750000000000002
"Mucarabones comunidad, Puerto Rico",444,312,132,72,55355,29.72972972972973
"Toa Alta zona urbana, Puerto Rico",1344,1081,263,72,82488,19.56845238095238
"Vieques zona urbana, Puerto Rico",1041,667,374,72,86014,35.92699327569645
"Carolina zona urbana, Puerto Rico",70461,57329,13132,72,14290,18.637260328408622
"Indios comunidad, Puerto Rico",602,451,151,72,36177,25.083056478405314
"Lajas zona urbana, Puerto Rico",2111,1501,610,72,40950,28.89625769777357
"Las Piedras zona urbana, Puerto Rico",2702,2187,515,72,44390,19.059955588452997
"Orocovis zona urbana, Puerto Rico",346,285,61,72,57290,17.63005780346821
"Palomas comunidad (Comer�o Municipio), Puerto Rico",621,469,152,72,58967,24.476650563607087
"Guayama zona urbana, Puerto Rico",9832,7944,1888,72,32221,19.202603742880388
"Olimpo comunidad, Puerto Rico",716,676,40,72,57075,5.58659217877095
"Carrizales comunidad, Puerto Rico",1087,1017,70,72,14634,6.439742410303588
"Manat� zona urbana, Puerto Rico",6483,5221,1262,72,50152,19.466296467684714
"Mayag�ez zona urbana, Puerto Rico",33462,24513,8949,72,52431,26.743769051461356
"R�o Blanco comunidad, Puerto Rico",719,604,115,72,70448,15.99443671766342
"Pe�uelas zona urbana, Puerto Rico",2214,1842,372,72,61074,16.802168021680217
"Quebradillas zona urbana, Puerto Rico",2298,1759,539,72,68040,23.455178416013926
"V�zquez comunidad, Puerto Rico",830,661,169,72,85111,20.36144578313253
"Toa Baja zona urbana, Puerto Rico",644,501,143,72,82617,22.204968944099377
"Morovis zona urbana, Puerto Rico",862,714,148,72,55097,17.16937354988399
"Hato Arriba comunidad, Puerto Rico",228,205,23,72,33597,10.087719298245613
"Maricao zona urbana, Puerto Rico",389,269,120,72,51270,30.848329048843187
"Patillas zona urbana, Puerto Rico",1770,1404,366,72,60472,20.677966101694913
"San Juan zona urbana, Puerto Rico",186060,139963,46097,72,76770,24.77534128775664
"H. Rivera Col�n comunidad, Puerto Rico",1050,912,138,72,35403,13.142857142857142
"El Ojo comunidad, Puerto Rico",591,508,83,72,25771,14.04399323181049
"Magas Arriba comunidad, Puerto Rico",387,302,85,72,48604,21.963824289405682
"La Parguera comunidad, Puerto Rico",637,234,403,72,41767,63.26530612244898
"Lares zona urbana, Puerto Rico",2291,1826,465,72,42498,20.296813618507205
"Las Mar�as zona urbana, Puerto Rico",324,243,81,72,43788,25.0
"Sabana Grande zona urbana, Puerto Rico",3838,2906,932,72,73544,24.283480979676916
"Coco comunidad, Puerto Rico",2119,1826,293,72,18891,13.827277017461068
"San Lorenzo zona urbana, Puerto Rico",3587,2972,615,72,77027,17.145246724282128
"Vega Baja zona urbana, Puerto Rico",10543,7968,2575,72,85326,24.423788295551553
"La Fermina comunidad, Puerto Rico",1227,924,303,72,40563,24.69437652811736
"Playita comunidad (Yabucoa Municipio), Puerto Rico",670,518,152,72,63525,22.686567164179106
"Santa Isabel zona urbana, Puerto Rico",2484,2040,444,72,78145,17.874396135265698
"Luquillo zona urbana, Puerto Rico",3682,2715,967,72,47787,26.26290059750136
"Pueblito del R�o comunidad, Puerto Rico",488,430,58,72,64500,11.885245901639344
"Duque comunidad, Puerto Rico",679,536,143,72,24395,21.06038291605302
"Juana D�az zona urbana, Puerto Rico",3254,2710,544,72,38972,16.717885679164105
"Arroyo zona urbana, Puerto Rico",2910,2145,765,72,03927,26.288659793814436
"Tiburones comunidad, Puerto Rico",669,563,106,72,82125,15.844544095665173
"Ciales zona urbana, Puerto Rico",980,768,212,72,17773,21.63265306122449
"Campo Rico comunidad, Puerto Rico",1179,956,223,72,11710,18.914334181509755
"Quebrada comunidad, Puerto Rico",506,380,126,72,66660,24.90118577075099
"Celada comunidad, Puerto Rico",1630,1415,215,72,16440,13.190184049079754
"Sabana Eneas comunidad, Puerto Rico",665,492,173,72,73372,26.015037593984964
"San Antonio comunidad (Aguadilla Municipio), Puerto Rico",1006,760,246,72,75608,24.45328031809145
"Florida zona urbana, Puerto Rico",1767,1584,183,72,28824,10.35653650254669
"Hatillo zona urbana, Puerto Rico",1889,1579,310,72,33296,16.41079936474325
"La Dolores comunidad, Puerto Rico",1289,915,374,72,40348,29.014740108611324
"La Alianza comunidad, Puerto Rico",769,588,181,72,39875,23.5370611183355
"Bayam�n comunidad, Puerto Rico",746,619,127,72,06679,17.024128686327078
"Jagual comunidad, Puerto Rico",453,364,89,72,37166,19.646799116997794
"San Sebasti�n zona urbana, Puerto Rico",4284,3230,1054,72,77500,24.6031746031746
"Fr�nquez comunidad, Puerto Rico",771,598,173,72,29555,22.43839169909209
"Trujillo Alto zona urbana, Puerto Rico",19513,16040,3473,72,83606,17.798390816378827
"Boquer�n comunidad (Cabo Rojo Municipio), Puerto Rico",1812,634,1178,72,07969,65.01103752759381
"Boquer�n comunidad (Las Piedras Municipio), Puerto Rico",552,523,29,72,08099,5.253623188405797
"Bairoa La Veinticinco comunidad, Puerto Rico",171,143,28,72,04620,16.374269005847953
"Hacienda San Jos� comunidad, Puerto Rico",1077,949,128,72,33184,11.884865366759517
"Alianza comunidad, Puerto Rico",1296,1078,218,72,01863,16.820987654320987
"Anon Raices comunidad, Puerto Rico",72,56,16,72,03174,22.22222222222222
"Buena Vista comunidad (Arroyo Municipio), Puerto Rico",658,388,270,72,09087,41.03343465045592
"Buena Vista comunidad (Humacao Municipio), Puerto Rico",492,206,286,72,09250,58.13008130081301
"Calzada comunidad, Puerto Rico",115,82,33,72,11151,28.695652173913043
"Candelero Abajo comunidad, Puerto Rico",214,113,101,72,12568,47.19626168224299
"El Combate comunidad, Puerto Rico",1804,108,1696,72,24954,94.01330376940133
"El Paraiso comunidad, Puerto Rico",742,635,107,72,25835,14.420485175202154
"El Tumbao comunidad, Puerto Rico",1042,658,384,72,26287,36.85220729366603
"La Liga comunidad, Puerto Rico",137,116,21,72,41274,15.328467153284672
"Las Carolinas comunidad, Puerto Rico",1036,751,285,72,42842,27.50965250965251
"Las Croabas comunidad, Puerto Rico",874,328,546,72,43057,62.47139588100686
"La Yuca comunidad, Puerto Rico",219,177,42,72,45170,19.17808219178082
"Los Panes comunidad, Puerto Rico",43,30,13,72,47336,30.23255813953488
"Los Prados comunidad, Puerto Rico",978,846,132,72,47422,13.496932515337424
"Maguayo comunidad, Puerto Rico",402,364,38,72,48862,9.45273631840796
"Monte Verde comunidad, Puerto Rico",108,14,94,72,54688,87.03703703703704
"Palmas del Mar comunidad, Puerto Rico",3428,601,2827,72,58602,82.46791131855309
"Parcelas de Navarro comunidad, Puerto Rico",809,714,95,72,59386,11.742892459826946
"Parcelas Mandry comunidad, Puerto Rico",246,149,97,72,59422,39.43089430894309
"Parcelas Viejas Borinquen comunidad, Puerto Rico",300,229,71,72,59450,23.666666666666668
"Piedra Aguza comunidad, Puerto Rico",1092,937,155,72,61545,14.194139194139193
"Pueblito del Carmen comunidad, Puerto Rico",247,178,69,72,64400,27.93522267206478
"Quebrada del Agua comunidad, Puerto Rico",494,412,82,72,67200,16.599190283400812
"Tibes comunidad, Puerto Rico",135,135,0,72,82055,0.0
"Rodr�guez Hevia comunidad, Puerto Rico",76,51,25,72,71996,32.89473684210527
"Vayas comunidad, Puerto Rico",174,157,17,72,85025,9.770114942528735
"Cerrillos Hoyos comunidad, Puerto Rico",341,283,58,72,17050,17.008797653958943
"Corral Viejo comunidad, Puerto Rico",117,117,0,72,20998,0.0
"Pastos comunidad, Puerto Rico",530,475,55,72,60257,10.377358490566039
"Liborio Negr�n Torres comunidad, Puerto Rico",437,387,50,72,45379,11.441647597254006
"Yaurel comunidad, Puerto Rico",489,385,104,72,88121,21.267893660531698
"Rafael Hern�ndez comunidad, Puerto Rico",561,429,132,72,68599,23.52941176470588
"B�falo comunidad, Puerto Rico",435,286,149,72,09603,34.25287356321839
"Aguilita comunidad, Puerto Rico",1630,1373,257,72,01089,15.766871165644172
"Guayabal comunidad, Puerto Rico",671,522,149,72,31877,22.205663189269746
"Camuy zona urbana, Puerto Rico",1833,1367,466,72,11925,25.4228041462084
"Cayey zona urbana, Puerto Rico",7510,5832,1678,72,15494,22.34354194407457
"Gu�nica zona urbana, Puerto Rico",3671,2265,1406,72,31189,38.3001906837374
"Hormigueros zona urbana, Puerto Rico",5633,4423,1210,72,35059,21.480560979939643
"Ant�n Ru�z comunidad, Puerto Rico",867,747,120,72,03196,13.84083044982699
"Bajandas comunidad, Puerto Rico",436,289,147,72,04701,33.715596330275226
"Esperanza comunidad, Puerto Rico",572,302,270,72,27190,47.2027972027972
"Punta Santiago comunidad, Puerto Rico",2144,1494,650,72,66492,30.317164179104477
"Cacao comunidad, Puerto Rico",470,441,29,72,10048,6.170212765957447
"Campanilla comunidad, Puerto Rico",2472,1709,763,72,11581,30.86569579288026
"San Jos� comunidad, Puerto Rico",1087,834,253,72,76683,23.275068997240112
"Vega Alta zona urbana, Puerto Rico",3881,3012,869,72,85197,22.391136305076014
"Lisman town, Alabama",328,219,109,01,43384,33.23170731707317
"Coker town, Alabama",279,241,38,01,16312,13.620071684587815
"Jackson city, Alabama",2432,1882,550,01,38152,22.615131578947366
"Dodge City town, Alabama",281,239,42,01,20955,14.94661921708185
"Beaverton town, Alabama",172,126,46,01,04948,26.744186046511626
"Detroit town, Alabama",111,91,20,01,20392,18.01801801801802
"Kennedy town, Alabama",245,193,52,01,39520,21.224489795918366
"Hytop town, Alabama",188,157,31,01,37264,16.48936170212766
"Pisgah town, Alabama",375,289,86,01,60720,22.933333333333334
"Coffeeville town, Alabama",246,136,110,01,16264,44.71544715447154
"Blountsville town, Alabama",833,634,199,01,07456,23.88955582232893
"Locust Fork town, Alabama",524,484,40,01,43888,7.633587786259542
"Smoke Rise CDP, Alabama",709,709,0,01,71201,0.0
"Thomasville city, Alabama",2024,1638,386,01,75960,19.07114624505929
"Memphis town, Alabama",14,14,0,01,48052,0.0
"Colony town, Alabama",183,152,31,01,16684,16.939890710382514
"Hanceville city, Alabama",1494,1202,292,01,32968,19.544846050870145
"Holly Pond town, Alabama",392,364,28,01,35560,7.142857142857142
"Hollywood town, Alabama",519,442,77,01,35632,14.836223506743737
"Emelle town, Alabama",39,31,8,01,23872,20.51282051282051
"Woodville town, Alabama",297,267,30,01,83664,10.1010101010101
"Montevallo city, Alabama",2440,2177,263,01,50312,10.778688524590164
"Myrtlewood town, Alabama",72,56,16,01,53112,22.22222222222222
"Chatom town, Alabama",517,366,151,01,14008,29.206963249516445
"Millry town, Alabama",285,203,82,01,48832,28.771929824561404
"Millport town, Alabama",601,533,68,01,48808,11.314475873544092
"Sulligent city, Alabama",1139,942,197,01,73728,17.295873573309922
"Anderson town, Alabama",138,113,25,01,01756,18.115942028985508
"Hackleburg town, Alabama",695,577,118,01,32560,16.97841726618705
"Trinity town, Alabama",1056,972,84,01,76872,7.954545454545454
"Gulf Shores city, Alabama",13067,5816,7251,01,32272,55.49093135379199
"Summerdale town, Alabama",416,337,79,01,73872,18.990384615384613
"Hammondville town, Alabama",235,211,24,01,32896,10.212765957446807
"Slocomb city, Alabama",1041,808,233,01,71040,22.382324687800192
"Livingston city, Alabama",1426,1175,251,01,43720,17.601683029453017
"Spanish Fort city, Alabama",3544,3304,240,01,71976,6.772009029345373
"Epes town, Alabama",254,206,48,01,24256,18.89763779527559
"Geiger town, Alabama",114,104,10,01,29392,8.771929824561402
"Pinckard town, Alabama",281,214,67,01,59832,23.843416370106763
"Greensboro city, Alabama",1318,1134,184,01,31720,13.960546282245827
"Union Grove town, Alabama",37,32,5,01,77784,13.513513513513514
"Riverview town, Alabama",62,38,24,01,65016,38.70967741935484
"Phenix City city, Alabama",17079,14462,2617,01,59472,15.322911177469406
"Cherokee town, Alabama",491,347,144,01,14152,29.327902240325866
"Cleveland town, Alabama",547,480,67,01,15472,12.248628884826324
"Sanford town, Alabama",91,79,12,01,68016,13.186813186813188
"Southside city, Alabama",3774,3297,477,01,71832,12.639109697933225
"Dora city, Alabama",1104,884,220,01,21136,19.92753623188406
"Selma city, Alabama",9379,7796,1583,01,69120,16.878131997014606
"Paint Rock town, Alabama",83,69,14,01,57696,16.867469879518072
"Hayden town, Alabama",524,446,78,01,33640,14.885496183206106
"McMullen town, Alabama",12,4,8,01,45640,66.66666666666666
"Thomaston town, Alabama",271,145,126,01,75936,46.494464944649444
"Beatrice town, Alabama",189,119,70,01,04900,37.03703703703704
"Cedar Bluff town, Alabama",1250,898,352,01,12760,28.16
"Union Springs city, Alabama",1645,1381,264,01,77880,16.048632218844986
"Collinsville town, Alabama",804,666,138,01,16600,17.16417910447761
"Sylacauga city, Alabama",5617,4794,823,01,74352,14.651949439202422
"Lester town, Alabama",58,50,8,01,42352,13.793103448275861
"Grove Hill town, Alabama",769,554,215,01,32080,27.95838751625488
"Headland city, Alabama",1908,1718,190,01,33856,9.958071278825996
"Dozier town, Alabama",195,148,47,01,21448,24.102564102564102
"Hodges town, Alabama",148,141,7,01,35200,4.72972972972973
"Lynn town, Alabama",298,257,41,01,44800,13.758389261744966
"Petrey town, Alabama",38,24,14,01,59328,36.84210526315789
"Centre city, Alabama",1982,1564,418,01,13648,21.089808274470233
"Moulton city, Alabama",1605,1401,204,01,51600,12.710280373831775
"Ridgeville town, Alabama",70,41,29,01,64656,41.42857142857143
"Cullman city, Alabama",6988,6177,811,01,18976,11.605609616485403
"Ragland town, Alabama",827,700,127,01,63216,15.356711003627568
"Enterprise city, Alabama",12475,10867,1608,01,24184,12.889779559118237
"Ranburne town, Alabama",247,205,42,01,63408,17.00404858299595
"Troy city, Alabama",9188,6892,2296,01,76920,24.989116238572052
"Crossville town, Alabama",789,719,70,01,18856,8.871989860583017
"Grimes town, Alabama",341,297,44,01,32056,12.903225806451612
"Coosada town, Alabama",441,421,20,01,17176,4.535147392290249
"Calera city, Alabama",5622,5058,564,01,11416,10.032017075773746
"Talladega Springs town, Alabama",89,65,24,01,74616,26.96629213483146
"Pickensville town, Alabama",416,311,105,01,59592,25.240384615384613
"Dadeville city, Alabama",1250,1077,173,01,19336,13.84
"Loachapoka town, Alabama",113,98,15,01,43744,13.274336283185843
"Vernon city, Alabama",1078,842,236,01,78480,21.89239332096475
"Shoal Creek CDP, Alabama",612,532,80,01,69978,13.071895424836603
"Sims Chapel CDP, Alabama",27,27,0,01,70632,0.0
"Spring Garden CDP, Alabama",86,86,0,01,72408,0.0
"Spruce Pine CDP, Alabama",98,76,22,01,72672,22.448979591836736
"Standing Rock CDP, Alabama",54,54,0,01,72720,0.0
"Tidmore Bend CDP, Alabama",493,448,45,01,76208,9.127789046653144
"Sterrett CDP, Alabama",430,365,65,01,73056,15.11627906976744
"Stewartville CDP, Alabama",806,581,225,01,73152,27.915632754342433
"Tibbie CDP, Alabama",27,27,0,01,76200,0.0
"Uriah CDP, Alabama",199,113,86,01,78120,43.21608040201005
"Vandiver CDP, Alabama",433,411,22,01,78312,5.080831408775981
"Vinegar Bend CDP, Alabama",125,69,56,01,79032,44.800000000000004
"Weogufka CDP, Alabama",144,121,23,01,80736,15.972222222222221
"Whatley CDP, Alabama",130,99,31,01,81744,23.846153846153847
"White Plains CDP, Alabama",396,354,42,01,82104,10.606060606060606
"Whitesboro CDP, Alabama",855,709,146,01,82176,17.076023391812868
"Cusseta town, Alabama",64,50,14,01,19216,21.875
"Munford town, Alabama",582,516,66,01,52848,11.34020618556701
"Pinson city, Alabama",2847,2700,147,01,60648,5.163329820864067
"Twin town, Alabama",227,201,26,01,77352,11.45374449339207
"Kellyton town, Alabama",137,80,57,01,39472,41.605839416058394
"Moody city, Alabama",5167,4893,274,01,51096,5.302883684923553
"Good Hope city, Alabama",939,857,82,01,30496,8.732694355697552
"Riverside city, Alabama",1102,920,182,01,64920,16.515426497277677
"Joppa CDP, Alabama",330,330,0,01,39064,0.0
"Morrison Crossroads CDP, Alabama",164,129,35,01,51469,21.341463414634145
"Semmes city, Alabama",2117,1983,134,01,69240,6.329711856400568
"Cottondale CDP, Alabama",1352,1122,230,01,17704,17.011834319526628
"Kimberly city, Alabama",1127,1036,91,01,39856,8.074534161490684
"Bon Secour CDP, Alabama",699,497,202,01,08272,28.898426323319025
"Lillian CDP, Alabama",714,556,158,01,42928,22.128851540616246
"Perdido CDP, Alabama",256,220,36,01,59064,14.0625
"Stapleton CDP, Alabama",542,495,47,01,72816,8.671586715867159
"Stockton CDP, Alabama",443,206,237,01,73272,53.49887133182845
"Red Bay city, Alabama",1374,1152,222,01,63576,16.157205240174672
"Union town, Alabama",116,82,34,01,77616,29.310344827586203
"Pennington town, Alabama",178,143,35,01,58968,19.662921348314608
"Samson city, Alabama",1022,832,190,01,67800,18.590998043052835
"Mount Vernon town, Alabama",530,437,93,01,52608,17.547169811320753
"Gadsden city, Alabama",17677,13713,3964,01,28696,22.424619562142897
"Smiths Station city, Alabama",2284,2112,172,01,71190,7.530647985989491
"Center Point city, Alabama",7206,6129,1077,01,13264,14.945878434637802
"Oppelo city, Arkansas",313,266,47,05,52430,15.015974440894569
"Valley Grande city, Alabama",1658,1358,300,01,78232,18.094089264173704
"Westover town, Alabama",644,589,55,01,81504,8.540372670807454
"Woodstock town, Alabama",769,674,95,01,83640,12.35370611183355
"Abanda CDP, Alabama",88,88,0,01,00100,0.0
"Axis CDP, Alabama",480,435,45,01,03508,9.375
"Ballplay CDP, Alabama",713,490,223,01,03820,31.276297335203367
"Belgreen CDP, Alabama",80,46,34,01,05140,42.5
"Bellamy CDP, Alabama",284,214,70,01,05188,24.647887323943664
"Belle Fontaine CDP, Alabama",220,198,22,01,05212,10.0
"Boykin CDP, Alabama",209,75,134,01,08680,64.11483253588517
"Brantleyville CDP, Alabama",381,351,30,01,09064,7.874015748031496
"Bristow Cove CDP, Alabama",287,252,35,01,09457,12.195121951219512
"Brook Highland CDP, Alabama",3928,3504,424,01,09500,10.79429735234216
"Broomtown CDP, Alabama",100,80,20,01,09880,20.0
"Bucks CDP, Alabama",35,35,0,01,10456,0.0
"Calvert CDP, Alabama",234,213,21,01,11488,8.974358974358974
"Carlisle-Rockledge CDP, Alabama",943,863,80,01,12070,8.48356309650053
"Ashford town, Alabama",1043,839,204,01,02836,19.55896452540748
"Ashland town, Alabama",961,777,184,01,02860,19.14672216441207
"Ashville city, Alabama",951,766,185,01,02908,19.453207150368033
"Chelsea city, Alabama",4398,4108,290,01,14104,6.593906321055025
"Bakerhill town, Alabama",170,117,53,01,03724,31.176470588235293
"Butler town, Alabama",992,815,177,01,11032,17.842741935483872
"Camden city, Alabama",840,661,179,01,11512,21.30952380952381
"Clio city, Alabama",538,386,152,01,15640,28.25278810408922
"Coaling town, Alabama",677,562,115,01,16000,16.986706056129986
"Creola city, Alabama",767,660,107,01,18304,13.95045632333768
"Eutaw town, Alabama",1495,1075,420,01,24664,28.093645484949832
"Florala town, Alabama",962,683,279,01,26848,29.002079002079
"Fruithurst town, Alabama",125,98,27,01,28432,21.6
"Goodwater town, Alabama",795,513,282,01,30640,35.471698113207545
"Henagar city, Alabama",1068,797,271,01,34096,25.374531835205993
"Indian Springs Village city, Alabama",956,874,82,01,37465,8.577405857740587
"Jemison city, Alabama",903,862,41,01,38608,4.540420819490587
"Pike Road town, Alabama",3545,3221,324,01,59760,9.139633286318759
"Reform town, Alabama",869,689,180,01,64104,20.713463751438436
"Springville city, Alabama",1632,1468,164,01,72600,10.049019607843137
"Stevenson town, Alabama",944,756,188,01,73080,19.915254237288135
"Uniontown town, Alabama",1182,773,409,01,77904,34.60236886632826
"Carlton CDP, Alabama",28,20,8,01,12112,28.57142857142857
"Catherine CDP, Alabama",10,10,0,01,12544,0.0
"Choccolocco CDP, Alabama",1070,960,110,01,14728,10.2803738317757
"Chunchula CDP, Alabama",131,67,64,01,14968,48.854961832061065
"Coats Bend CDP, Alabama",643,546,97,01,16080,15.085536547433904
"Cullomburg CDP, Alabama",77,65,12,01,19024,15.584415584415584
"Deer Park CDP, Alabama",89,55,34,01,20152,38.20224719101123
"Delta CDP, Alabama",204,94,110,01,20272,53.92156862745098
"Dunnavant CDP, Alabama",360,330,30,01,21890,8.333333333333332
"East Point CDP, Alabama",82,57,25,01,22504,30.48780487804878
"Egypt CDP, Alabama",344,262,82,01,23224,23.837209302325583
"Emerald Mountain CDP, Alabama",1056,1006,50,01,23880,4.734848484848484
"Eunola CDP, Alabama",143,116,27,01,24616,18.88111888111888
"Fairford CDP, Alabama",31,31,0,01,25216,0.0
"Fayetteville CDP, Alabama",772,582,190,01,25864,24.61139896373057
"Fitzpatrick CDP, Alabama",36,13,23,01,26152,63.888888888888886
"Fredonia CDP, Alabama",118,87,31,01,28120,26.27118644067797
"Fruitdale CDP, Alabama",99,67,32,01,28408,32.323232323232325
"Gallant CDP, Alabama",233,233,0,01,28816,0.0
"Graham CDP, Alabama",64,52,12,01,31000,18.75
"Gulfcrest CDP, Alabama",87,87,0,01,32248,0.0
"Hackneyville CDP, Alabama",160,141,19,01,32584,11.875
"Hatton CDP, Alabama",87,67,20,01,33544,22.988505747126435
"Highland Lakes CDP, Alabama",1932,1841,91,01,34490,4.710144927536232
"Hissop CDP, Alabama",312,244,68,01,34984,21.794871794871796
"Hobson CDP, Alabama",58,58,0,01,35130,0.0
"Hollins CDP, Alabama",338,300,38,01,35512,11.242603550295858
"Hollis Crossroads CDP, Alabama",255,218,37,01,35536,14.50980392156863
"Holtville CDP, Alabama",1852,1560,292,01,35752,15.766738660907128
"Ivalee CDP, Alabama",359,347,12,01,38032,3.3426183844011144
"Leroy CDP, Alabama",424,321,103,01,42304,24.29245283018868
"Lookout Mountain CDP, Alabama",690,536,154,01,44160,22.318840579710145
"Macedonia CDP, Alabama",171,135,36,01,45316,21.052631578947366
"Malcolm CDP, Alabama",155,113,42,01,46192,27.09677419354839
"Marbury CDP, Alabama",529,529,0,01,46600,0.0
"Megargel CDP, Alabama",6,6,0,01,47848,0.0
"Millerville CDP, Alabama",110,92,18,01,48784,16.363636363636363
"Mount Olive CDP (Coosa County), Alabama",181,116,65,01,52320,35.91160220994475
"Mount Olive CDP (Jefferson County), Alabama",1509,1463,46,01,52344,3.0483764082173623
"New Union CDP, Alabama",419,419,0,01,54582,0.0
"Movico CDP, Alabama",49,49,0,01,52680,0.0
"Nanafalia CDP, Alabama",16,16,0,01,53208,0.0
"Nances Creek CDP, Alabama",171,171,0,01,53232,0.0
"Clay city, Alabama",3717,3556,161,01,15256,4.3314500941619585
"Magnolia Springs town, Alabama",530,374,156,01,46072,29.433962264150942
"Our Town CDP, Alabama",427,217,210,01,57384,49.18032786885246
"Panola CDP, Alabama",46,8,38,01,57912,82.6086956521739
"Penton CDP, Alabama",37,37,0,01,59016,0.0
"Perdido Beach town, Alabama",422,295,127,01,59088,30.09478672985782
"Peterman CDP, Alabama",56,49,7,01,59232,12.5
"Pine Level CDP, Alabama",1600,1563,37,01,60264,2.3125
"Putnam CDP, Alabama",78,29,49,01,62952,62.82051282051282
"Ray CDP, Alabama",209,116,93,01,63495,44.49760765550239
"Redland CDP, Alabama",1581,1531,50,01,63730,3.1625553447185326
"Reeltown CDP, Alabama",285,131,154,01,64040,54.03508771929825
"Rockville CDP, Alabama",12,12,0,01,65784,0.0
"St. Stephens CDP, Alabama",176,153,23,01,67584,13.068181818181818
"Shelby CDP, Alabama",410,374,36,01,69672,8.780487804878048
"Atqasuk city, Alaska",66,49,17,02,04500,25.757575757575758
"Dry Creek CDP, Alaska",68,51,17,02,20020,25.0
"Unalaska city, Alaska",1175,958,217,02,80770,18.46808510638298
"Hollis CDP, Alaska",72,47,25,02,32810,34.72222222222222
"Hyder CDP, Alaska",54,15,39,02,34570,72.22222222222221
"Kasaan city, Alaska",50,36,14,02,37650,28.000000000000004
"Unalakleet city, Alaska",230,175,55,02,80660,23.91304347826087
"White Mountain city, Alaska",98,83,15,02,84070,15.306122448979592
"Whitestone Logging Camp CDP, Alaska",0,0,0,02,84200,
"Pitkas Point CDP, Alaska",42,30,12,02,60860,28.57142857142857
"Sand Point city, Alaska",500,421,79,02,67020,15.8
"Bear Creek CDP, Alaska",910,597,313,02,05585,34.395604395604394
"Clam Gulch CDP, Alaska",168,96,72,02,15320,42.857142857142854
"Dot Lake CDP, Alaska",21,0,21,02,19720,100.0
"Eagle Village CDP, Alaska",50,19,31,02,20600,62.0
"St. George city, Alaska",47,27,20,02,65800,42.5531914893617
"Saxman city, Alaska",136,118,18,02,67570,13.23529411764706
"Kupreanof city, Alaska",24,6,18,02,42160,75.0
"Nondalton city, Alaska",94,44,50,02,55030,53.191489361702125
"Port Alsworth CDP, Alaska",67,37,30,02,62620,44.776119402985074
"Yakutat CDP, Alaska",351,232,119,02,86490,33.903133903133906
"Thorne Bay city, Alaska",449,292,157,02,77140,34.96659242761693
"Skwentna CDP, Alaska",323,22,301,02,70870,93.18885448916409
"Talkeetna CDP, Alaska",710,384,326,02,74830,45.91549295774648
"Willow CDP, Alaska",1832,709,1123,02,85280,61.29912663755459
"Anvik city, Alaska",50,37,13,02,03880,26.0
"Flat CDP, Alaska",0,0,0,02,25880,
"Holy Cross city, Alaska",90,65,25,02,33030,27.77777777777778
"Lowell Point CDP, Alaska",38,26,12,02,45295,31.57894736842105
"Seward city, Alaska",1123,845,278,02,68560,24.75512021371327
"Sunrise CDP, Alaska",26,18,8,02,73950,30.76923076923077
"Ugashik CDP, Alaska",35,3,32,02,80100,91.42857142857143
"Noorvik city, Alaska",141,118,23,02,55140,16.312056737588655
"Red Devil CDP, Alaska",25,8,17,02,64930,68.0
"Chuathbaluk city, Alaska",42,34,8,02,14330,19.047619047619047
"Glacier View CDP, Alaska",238,99,139,02,28590,58.40336134453782
"Trapper Creek CDP, Alaska",617,189,428,02,78680,69.3679092382496
"Lake Minchumina CDP, Alaska",50,7,43,02,42820,86.0
"Tatitlek CDP, Alaska",78,20,58,02,75380,74.35897435897436
"Chignik city, Alaska",89,25,64,02,13550,71.91011235955057
"Port Graham CDP, Alaska",90,64,26,02,63280,28.888888888888886
"Tazlina CDP, Alaska",176,88,88,02,75480,50.0
"Crown Point CDP, Alaska",47,11,36,02,17960,76.59574468085107
"Naukati Bay CDP, Alaska",97,72,25,02,52845,25.773195876288657
"Gulkana CDP, Alaska",80,14,66,02,30500,82.5
"Anchorage municipality, Alaska",116493,106524,9969,02,03000,8.557595735366073
"Point Baker CDP, Alaska",8,0,8,02,61190,100.0
"St. Paul city, Alaska",185,126,59,02,66470,31.891891891891895
"Allakaket city, Alaska",81,59,22,02,01860,27.160493827160494
"Ridgeway CDP, Alaska",993,877,116,02,65345,11.681772406847935
"Hooper Bay city, Alaska",230,209,21,02,33470,9.130434782608695
"King Cove city, Alaska",347,284,63,02,39410,18.155619596541786
"Happy Valley CDP, Alaska",559,281,278,02,31710,49.73166368515206
"Slana CDP, Alaska",215,0,215,02,70930,100.0
"Deltana CDP, Alaska",1058,794,264,02,18675,24.95274102079395
"Two Rivers CDP, Alaska",263,187,76,02,79830,28.89733840304182
"Nenana city, Alaska",226,145,81,02,53050,35.84070796460177
"Selawik city, Alaska",206,175,31,02,68230,15.048543689320388
"Sleetmute CDP, Alaska",57,30,27,02,71090,47.368421052631575
"Birch Creek CDP, Alaska",12,2,10,02,07620,83.33333333333334
"Adak city, Alaska",512,40,472,02,00065,92.1875
"Nunam Iqua city, Alaska",51,40,11,02,56600,21.568627450980394
"Gustavus city, Alaska",513,190,323,02,30940,62.96296296296296
"Wrangell city and borough, Alaska",1481,1074,407,02,86380,27.481431465226198
"Haines CDP, Alaska",991,746,245,02,31050,24.72250252270434
"Clark's Point city, Alaska",53,17,36,02,15430,67.9245283018868
"Badger CDP, Alaska",8234,6906,1328,02,05000,16.12824872479961
"Chena Ridge CDP, Alaska",2762,2313,449,02,12920,16.256335988414193
"Eureka Roadhouse CDP, Alaska",126,0,126,02,23720,100.0
"Farmers Loop CDP, Alaska",2344,2182,162,02,24980,6.911262798634812
"Goldstream CDP, Alaska",2541,2014,527,02,29130,20.73986619441165
"Loring CDP, Alaska",0,0,0,02,45020,
"Mertarvik CDP, Alaska",0,0,0,02,48590,
"Nabesna CDP, Alaska",47,0,47,02,51960,100.0
"Point Possession CDP, Alaska",106,0,106,02,61825,100.0
"South Van Horn CDP, Alaska",255,187,68,02,72230,26.666666666666668
"Steele Creek CDP, Alaska",2919,2690,229,02,72985,7.845152449468997
"Susitna North CDP, Alaska",1335,397,938,02,74350,70.2621722846442
"Whitestone CDP, Alaska",31,13,18,02,84120,58.06451612903226
"Skagway CDP, Alaska",590,376,214,02,70760,36.271186440677965
"Denali Park CDP, Alaska",300,100,200,02,18805,66.66666666666666
"Utqiagvik city, Alaska",1701,1345,356,02,81920,20.92886537330982
"Whale Pass city, Alaska",79,36,43,02,84000,54.43037974683544
"Kachemak city, Alaska",313,215,98,02,36540,31.309904153354633
"Petersburg CDP, Alaska",1386,1101,285,02,60310,20.562770562770563
"Edna Bay city, Alaska",28,8,20,02,20970,71.42857142857143
"Mud Bay CDP, Alaska",173,95,78,02,51455,45.08670520231214
"Nikolski CDP, Alaska",20,12,8,02,54260,40.0
"Chignik Lagoon CDP, Alaska",63,26,37,02,13670,58.730158730158735
"Covenant Life CDP, Alaska",71,21,50,02,17670,70.4225352112676
"Moose Pass CDP, Alaska",162,126,36,02,50190,22.22222222222222
"Nanwalek CDP, Alaska",75,51,24,02,52210,32.0
"Chisana CDP, Alaska",0,0,0,02,13890,
"McCarthy CDP, Alaska",146,0,146,02,45790,100.0
"Paxson CDP, Alaska",239,0,239,02,59320,100.0
"Willow Creek CDP, Alaska",71,0,71,02,85290,100.0
"Point Lay CDP, Alaska",64,56,8,02,61700,12.5
"Sitka city and borough, Alaska",4199,3561,638,02,70540,15.19409383186473
"Prudhoe Bay CDP, Alaska",0,0,0,02,64380,
"Big Delta CDP, Alaska",321,216,105,02,06850,32.71028037383177
"Tok CDP, Alaska",735,439,296,02,77800,40.27210884353741
"Moose Creek CDP, Alaska",398,398,0,02,50080,0.0
"North Pole city, Alaska",1082,939,143,02,55910,13.216266173752311
"Marshall city, Alaska",87,68,19,02,47000,21.839080459770116
"Naknek CDP, Alaska",457,180,277,02,52060,60.61269146608315
"Koyuk city, Alaska",91,76,15,02,41940,16.483516483516482
"Wales city, Alaska",72,56,16,02,82860,22.22222222222222
"Pelican city, Alaska",77,46,31,02,59650,40.25974025974026
"Nulato city, Alaska",137,87,50,02,56350,36.496350364963504
"Wiseman CDP, Alaska",42,3,39,02,85610,92.85714285714286
"Cold Bay city, Alaska",73,27,46,02,16530,63.013698630136986
"Noatak CDP, Alaska",101,94,7,02,54700,6.9306930693069315
"Shungnak city, Alaska",79,62,17,02,70100,21.518987341772153
"Akiachak CDP, Alaska",166,133,33,02,00760,19.879518072289155
"Lime Village CDP, Alaska",21,5,16,02,44030,76.19047619047619
"Oscarville CDP, Alaska",26,13,13,02,58330,50.0
"Tuntutuliak CDP, Alaska",154,139,15,02,79120,9.740259740259742
"Buffalo Soapstone CDP, Alaska",364,295,69,02,09657,18.956043956043956
"Chickaloon CDP, Alaska",234,100,134,02,13340,57.26495726495726
"Knik River CDP, Alaska",342,263,79,02,40670,23.099415204678362
"Shaktoolik city, Alaska",80,71,9,02,68890,11.25
"King Salmon CDP, Alaska",309,135,174,02,39630,56.310679611650485
"Elim city, Alaska",99,85,14,02,22250,14.14141414141414
"Port Clarence CDP, Alaska",0,0,0,02,63170,
"Delta Junction city, Alaska",554,320,234,02,18620,42.238267148014444
"Dot Lake Village CDP, Alaska",36,15,21,02,19750,58.333333333333336
"Healy Lake CDP, Alaska",18,1,17,02,32310,94.44444444444444
"Atka city, Alaska",24,13,11,02,04210,45.83333333333333
"Igiugig CDP, Alaska",25,17,8,02,34790,32.0
"Kokhanok CDP, Alaska",58,45,13,02,41280,22.413793103448278
"Lutak CDP, Alaska",41,30,11,02,45700,26.82926829268293
"Hydaburg city, Alaska",126,111,15,02,34460,11.904761904761903
"Russian Mission city, Alaska",54,50,4,02,65700,7.4074074074074066
"Alcan Border CDP, Alaska",28,23,5,02,01390,17.857142857142858
"Chicken CDP, Alaska",24,7,17,02,13450,70.83333333333334
"Fort Greely CDP, Alaska",180,51,129,02,26100,71.66666666666667
"Northway CDP, Alaska",38,18,20,02,56220,52.63157894736842
"Kake city, Alaska",265,173,92,02,36770,34.71698113207547
"Port Alexander city, Alaska",86,33,53,02,62510,61.627906976744185
"Harding-Birch Lakes CDP, Alaska",827,121,706,02,31765,85.36880290205562
"Hughes city, Alaska",40,33,7,02,33910,17.5
"Huslia city, Alaska",134,113,21,02,34350,15.671641791044777
"McGrath city, Alaska",206,116,90,02,46010,43.689320388349515
"Angoon city, Alaska",237,129,108,02,03440,45.56962025316456
"Elfin Cove CDP, Alaska",28,8,20,02,22140,71.42857142857143
"Hobart Bay CDP, Alaska",14,0,14,02,32550,100.0
"Shishmaref city, Alaska",147,138,9,02,69770,6.122448979591836
"Teller city, Alaska",76,59,17,02,75930,22.36842105263158
"Manokotak city, Alaska",249,152,97,02,46890,38.95582329317269
"Kotlik city, Alaska",183,158,25,02,41720,13.661202185792352
"St. Mary's city, Alaska",223,167,56,02,66140,25.112107623318387
"Healy CDP, Alaska",736,377,359,02,32150,48.77717391304348
"Kaktovik city, Alaska",80,53,27,02,36990,33.75
"Anchor Point CDP, Alaska",1265,805,460,02,03110,36.36363636363637
"Cooper Landing CDP, Alaska",413,203,210,02,17190,50.847457627118644
"Ninilchik CDP, Alaska",932,329,603,02,54480,64.69957081545064
"Diamond Ridge CDP, Alaska",646,479,167,02,18925,25.851393188854487
"Fox River CDP, Alaska",285,130,155,02,26910,54.385964912280706
"Hope CDP, Alaska",116,23,93,02,33580,80.17241379310344
"Sterling CDP, Alaska",3280,1962,1318,02,73070,40.1829268292683
"Goodnews Bay city, Alaska",60,48,12,02,29290,20.0
"Napakiak city, Alaska",127,108,19,02,52390,14.960629921259844
"Chase CDP, Alaska",218,9,209,02,12350,95.87155963302753
"Lazy Mountain CDP, Alaska",638,573,65,02,43260,10.18808777429467
"Meadow Lakes CDP, Alaska",3153,2485,668,02,47735,21.18617189977799
"Point MacKenzie CDP, Alaska",196,90,106,02,61788,54.08163265306123
"Alatna CDP, Alaska",13,2,11,02,01305,84.61538461538461
"Levelock CDP, Alaska",43,31,12,02,43810,27.906976744186046
"Iliamna CDP, Alaska",58,19,39,02,35120,67.24137931034483
"Ivanof Bay CDP, Alaska",12,0,12,02,35890,100.0
"Perryville CDP, Alaska",52,24,28,02,60200,53.84615384615385
"Pope-Vannoy Landing CDP, Alaska",14,0,14,02,62125,100.0
"Tetlin CDP, Alaska",73,38,35,02,76590,47.94520547945205
"Mosquito Lake CDP, Alaska",189,97,92,02,50800,48.67724867724868
"Craig city, Alaska",562,476,86,02,17740,15.302491103202847
"Chignik Lake CDP, Alaska",38,23,15,02,13780,39.473684210526315
"Newhalen city, Alaska",45,37,8,02,53270,17.77777777777778
"Pedro Bay CDP, Alaska",31,9,22,02,59540,70.96774193548387
"Pilot Point city, Alaska",69,27,42,02,60640,60.86956521739131
"Eagle city, Alaska",165,35,130,02,20380,78.78787878787878
"Northway Junction CDP, Alaska",37,13,24,02,56250,64.86486486486487
"Northway Village CDP, Alaska",48,27,21,02,56260,43.75
"Tanacross CDP, Alaska",88,44,44,02,75050,50.0
"Juneau city and borough, Alaska",13586,12521,1065,02,36400,7.8389518622111
"Kenny Lake CDP, Alaska",236,9,227,02,38910,96.1864406779661
"Tyonek CDP, Alaska",152,94,58,02,79890,38.15789473684211
"Cordova city, Alaska",1188,1002,186,02,17410,15.656565656565657
"Gakona CDP, Alaska",137,62,75,02,27420,54.74452554744526
"Tolsona CDP, Alaska",55,0,55,02,78297,100.0
"Valdez city, Alaska",1550,1322,228,02,82200,14.709677419354838
"Klukwan CDP, Alaska",60,26,34,02,40510,56.666666666666664
"Gambell city, Alaska",184,150,34,02,27640,18.478260869565215
"Golovin city, Alaska",61,37,24,02,29180,39.34426229508197
"Karluk CDP, Alaska",29,16,13,02,37540,44.827586206896555
"Klawock city, Alaska",366,305,61,02,40400,16.666666666666664
"Metlakatla CDP, Alaska",541,480,61,02,48870,11.275415896487985
"Port Protection CDP, Alaska",70,29,41,02,63870,58.57142857142858
"South Naknek CDP, Alaska",132,18,114,02,72190,86.36363636363636
"Ketchikan city, Alaska",3881,3278,603,02,38970,15.537232671991754
"Coffman Cove city, Alaska",184,65,119,02,16360,64.67391304347827
"Excursion Inlet CDP, Alaska",11,0,11,02,23900,100.0
"Egegik city, Alaska",285,18,267,02,21150,93.6842105263158
"Port Heiden city, Alaska",53,27,26,02,63390,49.056603773584904
"Portage Creek CDP, Alaska",9,0,9,02,62285,100.0
"Togiak city, Alaska",246,180,66,02,77690,26.82926829268293
"Twin Hills CDP, Alaska",36,26,10,02,79780,27.77777777777778
"Kobuk city, Alaska",44,30,14,02,40840,31.818181818181817
"Chefornak city, Alaska",102,86,16,02,12680,15.686274509803921
"Kipnuk CDP, Alaska",183,156,27,02,39740,14.754098360655737
"Kwigillingok CDP, Alaska",102,73,29,02,42490,28.431372549019606
"Lower Kalskag city, Alaska",82,71,11,02,45460,13.414634146341465
"Toksook Bay city, Alaska",134,117,17,02,78240,12.686567164179104
"Upper Kalskag city, Alaska",79,68,11,02,81320,13.924050632911392
"Napaskiak city, Alaska",110,82,28,02,52720,25.454545454545453
"Butte CDP, Alaska",1260,1132,128,02,09710,10.158730158730158
"Knik-Fairview CDP, Alaska",5806,5007,799,02,40645,13.761625904236997
"Wasilla city, Alaska",3506,3061,445,02,83080,12.692527096406161
"Shageluk city, Alaska",49,26,23,02,68670,46.93877551020408
"Takotna CDP, Alaska",27,9,18,02,74610,66.66666666666666
"Dillingham city, Alaska",1054,784,270,02,18950,25.616698292220114
"Quinhagak city, Alaska",194,165,29,02,64600,14.948453608247423
"Pilot Station city, Alaska",126,122,4,02,60750,3.1746031746031744
"Glennallen CDP, Alaska",343,71,272,02,28740,79.30029154518951
"Port Lions city, Alaska",134,82,52,02,63610,38.80597014925373
"Mountain Village city, Alaska",199,167,32,02,51180,16.08040201005025
"Scammon Bay city, Alaska",123,119,4,02,67680,3.2520325203252036
"Point Hope city, Alaska",187,152,35,02,61630,18.71657754010695
"Hoonah city, Alaska",381,287,94,02,33360,24.671916010498688
"Stevens Village CDP, Alaska",46,7,39,02,73290,84.78260869565217
"Evansville CDP, Alaska",28,10,18,02,23790,64.28571428571429
"Four Mile Road CDP, Alaska",7,4,3,02,26835,42.857142857142854
"Kaltag city, Alaska",77,58,19,02,37430,24.675324675324674
"Koliganek CDP, Alaska",56,48,8,02,41500,14.285714285714285
"Ruby city, Alaska",116,69,47,02,65590,40.51724137931034
"Akutan city, Alaska",70,58,12,02,01090,17.142857142857142
"Aniak city, Alaska",222,156,66,02,03550,29.72972972972973
"Kasigluk CDP, Alaska",117,105,12,02,37975,10.256410256410255
"Kongiganak CDP, Alaska",101,86,15,02,41610,14.85148514851485
"Mekoryuk city, Alaska",92,80,12,02,47990,13.043478260869565
"Tuluksak CDP, Alaska",98,85,13,02,78790,13.26530612244898
"Farm Loop CDP, Alaska",348,330,18,02,25000,5.172413793103448
"Fishhook CDP, Alaska",1907,1756,151,02,25550,7.918196119559518
"Gateway CDP, Alaska",2031,1932,99,02,28200,4.874446085672083
"Lake Louise CDP, Alaska",230,9,221,02,42805,96.08695652173913
"Lakes CDP, Alaska",3223,2923,300,02,42832,9.308098045299412
"Susitna CDP, Alaska",117,0,117,02,74340,100.0
"Tanaina CDP, Alaska",3000,2797,203,02,75077,6.766666666666667
"Buckland city, Alaska",118,114,4,02,09600,3.389830508474576
"Deering city, Alaska",57,44,13,02,18510,22.807017543859647
"Central CDP, Alaska",165,32,133,02,11690,80.60606060606061
"Chalkyitsik CDP, Alaska",71,37,34,02,11800,47.88732394366197
"Livengood CDP, Alaska",39,4,35,02,44580,89.74358974358975
"Minto CDP, Alaska",117,79,38,02,49530,32.47863247863248
"Nikolai city, Alaska",47,38,9,02,54150,19.148936170212767
"Palmer city, Alaska",2179,2026,153,02,58660,7.021569527306104
"College CDP, Alaska",5573,5003,570,02,16750,10.227884442849453
"Newtok CDP, Alaska",73,71,2,02,53820,2.73972602739726
"Nunapitchuk city, Alaska",136,124,12,02,56680,8.823529411764707
"Platinum city, Alaska",17,6,11,02,61080,64.70588235294117
"Houston city, Alaska",942,669,273,02,33800,28.980891719745223
"Petersville CDP, Alaska",171,0,171,02,60460,100.0
"Sutton-Alpine CDP, Alaska",460,375,85,02,74525,18.478260869565215
"Beaver CDP, Alaska",59,22,37,02,05750,62.71186440677966
"Bettles city, Alaska",9,1,8,02,06630,88.88888888888889
"Circle CDP, Alaska",48,25,23,02,14880,47.91666666666667
"Koyukuk city, Alaska",47,34,13,02,42050,27.659574468085108
"Eielson AFB CDP, Alaska",1134,987,147,02,21370,12.962962962962962
"Cohoe CDP, Alaska",927,547,380,02,16420,40.99244875943905
"Homer city, Alaska",2892,2260,632,02,33140,21.853388658367912
"Soldotna city, Alaska",2057,1827,230,02,71640,11.18133203694701
"Aleneva CDP, Alaska",5,5,0,02,01560,0.0
"Salamatof CDP, Alaska",320,239,81,02,66510,25.3125
"Kodiak city, Alaska",2189,1958,231,02,40950,10.552763819095476
"Nikiski CDP, Alaska",2071,1617,454,02,54050,21.921776919362625
"Nikolaevsk CDP, Alaska",148,110,38,02,54085,25.675675675675674
"Seldovia city, Alaska",216,108,108,02,68340,50.0
"Chistochina CDP, Alaska",63,19,44,02,14000,69.84126984126983
"Chitina CDP, Alaska",124,42,82,02,14110,66.12903225806451
"Mentasta Lake CDP, Alaska",130,63,67,02,48540,51.53846153846153
"Tonsina CDP, Alaska",59,28,31,02,78350,52.54237288135594
"Whittier city, Alaska",298,129,169,02,84510,56.711409395973156
"Martorell comunidad, Puerto Rico",950,695,255,72,51657,26.842105263157894
"Palmarejo comunidad (Lajas Municipio), Puerto Rico",497,415,82,72,58150,16.498993963782695
"Ramos comunidad, Puerto Rico",653,519,134,72,68771,20.520673813169985
"Lluveras comunidad, Puerto Rico",808,511,297,72,46282,36.757425742574256
"Aceitunas comunidad, Puerto Rico",612,518,94,72,00186,15.359477124183007
"Lamboglia comunidad, Puerto Rico",495,283,212,72,41466,42.82828282828282
"Aguada zona urbana, Puerto Rico",1559,1063,496,72,00616,31.81526619627967
"Luyando comunidad, Puerto Rico",1089,759,330,72,47873,30.303030303030305
"Espino comunidad, Puerto Rico",472,255,217,72,27263,45.97457627118644
"Arecibo zona urbana, Puerto Rico",20065,15381,4684,72,03368,23.344131572389735
"Betances comunidad, Puerto Rico",334,288,46,72,07668,13.77245508982036
"Mora comunidad, Puerto Rico",692,615,77,72,54882,11.127167630057803
"Luis Llor�ns Torres comunidad, Puerto Rico",1418,1143,275,72,47615,19.3935119887165
"Santa B�rbara comunidad, Puerto Rico",1663,1418,245,72,77672,14.732411304870716
"Coamo zona urbana, Puerto Rico",4759,3890,869,72,18719,18.260138684597603
"San Antonio comunidad (Dorado Municipio), Puerto Rico",2912,2510,402,72,75694,13.804945054945057
"Fajardo zona urbana, Puerto Rico",13906,9850,4056,72,27964,29.16726592837624
"Gurabo zona urbana, Puerto Rico",3146,2524,622,72,32823,19.771137952956135
"Rafael Gonz�lez comunidad, Puerto Rico",832,702,130,72,68556,15.625
"La Plena comunidad, Puerto Rico",297,267,30,72,42197,10.1010101010101
"Luis M. Cintr�n comunidad, Puerto Rico",909,637,272,72,47701,29.92299229922992
"Corcovado comunidad, Puerto Rico",689,604,85,72,20482,12.336719883889694
"Daguao comunidad, Puerto Rico",750,416,334,72,23062,44.53333333333334
"Salinas zona urbana, Puerto Rico",2266,1749,517,72,74877,22.815533980582526
"San Germ�n zona urbana, Puerto Rico",5194,4044,1150,72,76167,22.140931844435887
"Candelaria Arenas comunidad, Puerto Rico",1521,1175,346,72,12560,22.74819197896121
"Sabana comunidad, Puerto Rico",578,414,164,72,73200,28.373702422145332
"Ceiba comunidad, Puerto Rico",1009,736,273,72,16139,27.056491575817642
"Aguas Buenas zona urbana, Puerto Rico",1548,1148,400,72,00874,25.839793281653744
"Animas comunidad, Puerto Rico",571,433,138,72,03024,24.168126094570926
"Cabo Rojo zona urbana, Puerto Rico",4433,3042,1391,72,09861,31.378299120234605
"Monte Grande comunidad, Puerto Rico",1290,1047,243,72,54366,18.83720930232558
"Bayam�n zona urbana, Puerto Rico",75583,61751,13832,72,06593,18.300411468187292
"San Isidro comunidad, Puerto Rico",2665,2196,469,72,76339,17.598499061913696
"Aguas Claras comunidad, Puerto Rico",1312,890,422,72,01003,32.16463414634146
"Candelaria comunidad, Puerto Rico",6440,5393,1047,72,12441,16.257763975155278
"Dorado zona urbana, Puerto Rico",6123,4239,1884,72,24008,30.76923076923077
"Coto Laurel comunidad, Puerto Rico",967,822,145,72,21213,14.99482936918304
"Candelero Arriba comunidad, Puerto Rico",459,361,98,72,12613,21.350762527233115
"Santo Domingo comunidad, Puerto Rico",1293,1144,149,72,79564,11.523588553750967
"Tallaboa Alta comunidad, Puerto Rico",642,536,106,72,81456,16.510903426791277
"Hato Candal comunidad, Puerto Rico",772,538,234,72,33683,30.310880829015545
"Sabana Seca comunidad, Puerto Rico",3707,2690,1017,72,74189,27.434583220933366
"Cayuco comunidad, Puerto Rico",499,328,171,72,15623,34.2685370741483
"Miranda comunidad, Puerto Rico",660,461,199,72,53678,30.151515151515152
"Utuado zona urbana, Puerto Rico",3617,2534,1083,72,84509,29.94194083494609
"Bre�as comunidad, Puerto Rico",1993,1309,684,72,08700,34.32012042147517
"Coto Norte comunidad, Puerto Rico",577,458,119,72,21385,20.623916811091856
"Rosa S�nchez comunidad, Puerto Rico",294,190,104,72,72555,35.374149659863946
"Guayanilla zona urbana, Puerto Rico",1864,1601,263,72,32307,14.109442060085836
"Playa Fortuna comunidad, Puerto Rico",804,461,343,72,63310,42.66169154228855
"Adjuntas zona urbana, Puerto Rico",1859,1409,450,72,00358,24.20656266810113
"Isabela zona urbana, Puerto Rico",5641,4008,1633,72,36478,28.94876794894522
"La Playa comunidad, Puerto Rico",885,643,242,72,42068,27.34463276836158
"Sabana Hoyos comunidad, Puerto Rico",904,754,150,72,73716,16.5929203539823
"Barranquitas zona urbana, Puerto Rico",1127,859,268,72,05690,23.77994676131322
"Pole Ojea comunidad, Puerto Rico",999,552,447,72,63697,44.74474474474475
"Puerto Real comunidad, Puerto Rico",2418,1870,548,72,65589,22.663358147229115
"Su�rez comunidad, Puerto Rico",724,523,201,72,80639,27.76243093922652
"Vieques comunidad, Puerto Rico",1342,905,437,72,85971,32.563338301043224
"Caguas zona urbana, Puerto Rico",34432,28746,5686,72,10334,16.513708178438662
"Ben�tez comunidad, Puerto Rico",540,445,95,72,07496,17.59259259259259
"Lomas comunidad, Puerto Rico",434,369,65,72,46626,14.976958525345621
"G. L. Garc�a comunidad, Puerto Rico",774,703,71,72,30544,9.17312661498708
"Culebra zona urbana, Puerto Rico",982,403,579,72,22589,58.96130346232179
"Las Ochenta comunidad, Puerto Rico",493,341,152,72,44003,30.831643002028397
"Jobos comunidad, Puerto Rico",993,790,203,72,38671,20.44310171198389
"Rafael Cap� comunidad, Puerto Rico",827,653,174,72,68513,21.039903264812576
"Humacao zona urbana, Puerto Rico",8272,6446,1826,72,35532,22.074468085106382
"San Antonio comunidad (Quebradillas Municipio), Puerto Rico",635,490,145,72,75780,22.83464566929134
"Bartolo comunidad, Puerto Rico",476,389,87,72,06421,18.277310924369747
"R�o Grande zona urbana, Puerto Rico",5193,4335,858,72,71136,16.522241478913923
"Central Aguirre comunidad, Puerto Rico",562,461,101,72,16526,17.97153024911032
"Playita comunidad (Salinas Municipio), Puerto Rico",322,240,82,72,63503,25.465838509316768
"Levittown comunidad, Puerto Rico",11298,8897,2401,72,45336,21.251548946716234
"Las Ollas comunidad, Puerto Rico",711,562,149,72,44089,20.956399437412095
"Galateo comunidad, Puerto Rico",960,798,162,72,29813,16.875
"P�jaros comunidad, Puerto Rico",3439,2999,440,72,57806,12.79441698168072
"Monserrate comunidad, Puerto Rico",960,660,300,72,53979,31.25
"Yauco zona urbana, Puerto Rico",7434,4855,2579,72,88035,34.691955878396556
"Barahona comunidad, Puerto Rico",964,823,141,72,05217,14.626556016597512
"Santa Clara comunidad, Puerto Rico",322,257,65,72,77826,20.18633540372671
"Aibonito zona urbana, Puerto Rico",3462,2953,509,72,01218,14.702484113229348
"R�o Ca�as Abajo comunidad, Puerto Rico",402,355,47,72,70706,11.691542288557214
"A�asco zona urbana, Puerto Rico",2490,1904,586,72,02680,23.53413654618474
"Cab�n comunidad, Puerto Rico",1560,1372,188,72,09689,12.051282051282051
"Bajadero comunidad, Puerto Rico",1628,1146,482,72,04658,29.606879606879605
"Garrochales comunidad, Puerto Rico",462,413,49,72,30372,10.606060606060606
"Lo�za zona urbana, Puerto Rico",1318,1131,187,72,46368,14.188163884673749
"Cata�o zona urbana, Puerto Rico",10654,8792,1862,72,15193,17.47700394218134
"Cidra zona urbana, Puerto Rico",2182,1761,421,72,18074,19.2942254812099
"Parcelas Nuevas comunidad, Puerto Rico",477,449,28,72,59425,5.870020964360587
"Comer�o zona urbana, Puerto Rico",1538,1280,258,72,19665,16.775032509752926
"Imb�ry comunidad, Puerto Rico",1588,1340,248,72,35962,15.617128463476071
"Aguadilla zona urbana, Puerto Rico",7276,5134,2142,72,00745,29.439252336448597
"Moca zona urbana, Puerto Rico",1370,1215,155,72,53807,11.313868613138686
"Palmer comunidad, Puerto Rico",425,367,58,72,58666,13.647058823529413
"Potala Pastillo comunidad, Puerto Rico",1263,961,302,72,64127,23.91132224861441
"Las Mar�as comunidad, Puerto Rico",731,583,148,72,43702,20.24623803009576
"Barceloneta zona urbana, Puerto Rico",1777,1357,420,72,05346,23.635340461451886
"Jayuya zona urbana, Puerto Rico",1191,899,292,72,38370,24.517212426532325
"Piedra Gorda comunidad, Puerto Rico",484,463,21,72,61590,4.338842975206612
"Palmarejo comunidad (Coamo Municipio), Puerto Rico",371,262,109,72,57978,29.380053908355798
"Corozal zona urbana, Puerto Rico",3857,3122,735,72,20783,19.056261343012704
"R�o Lajas comunidad, Puerto Rico",897,712,185,72,71437,20.624303232998887
"Mar�a Antonia comunidad, Puerto Rico",598,363,235,72,50754,39.297658862876254
"Palo Seco comunidad, Puerto Rico",319,257,62,72,59139,19.435736677115987
"Capitanejo comunidad, Puerto Rico",1352,1168,184,72,13925,13.609467455621301
"Marue�o comunidad, Puerto Rico",344,255,89,72,51700,25.872093023255815
"Coqu� comunidad, Puerto Rico",1490,1083,407,72,20310,27.31543624161074
"Ingenio comunidad, Puerto Rico",1903,1391,512,72,36263,26.904887020493955
"Villalba zona urbana, Puerto Rico",1231,1036,195,72,86831,15.840779853777418
"Excel town, Alabama",394,329,65,01,24880,16.49746192893401
"Greenville city, Alabama",3398,2440,958,01,31912,28.193054738081223
"Meridianville CDP, Alabama",2765,2635,130,01,48112,4.701627486437613
"Redstone Arsenal CDP, Alabama",355,320,35,01,63912,9.859154929577464
"Ladonia CDP, Alabama",1615,1291,324,01,40648,20.061919504643964
"York city, Alabama",1228,984,244,01,84096,19.86970684039088
"McKenzie town, Alabama",275,208,67,01,45496,24.363636363636363
"Columbiana city, Alabama",1747,1494,253,01,16768,14.481969089868347
"Centreville city, Alabama",993,878,115,01,13672,11.581067472306144
"Luverne city, Alabama",1269,1064,205,01,44728,16.15445232466509
"Rutledge town, Alabama",182,122,60,01,67176,32.967032967032964
"Yellow Bluff town, Alabama",62,39,23,01,83976,37.096774193548384
"West Blocton town, Alabama",663,484,179,01,80928,26.998491704374057
"Gordo town, Alabama",838,746,92,01,30736,10.978520286396181
"Brent city, Alabama",1219,915,304,01,09136,24.938474159146843
"Section town, Alabama",426,367,59,01,69000,13.849765258215962
"Skyline town, Alabama",489,382,107,01,70896,21.881390593047033
"South Vinemont town, Alabama",320,252,68,01,71900,21.25
"Carolina town, Alabama",129,109,20,01,12160,15.503875968992247
"River Falls town, Alabama",322,235,87,01,64776,27.018633540372672
"Gu-Win town, Alabama",64,50,14,01,32536,21.875
"Winfield city, Alabama",2088,1629,459,01,82992,21.982758620689655
"Billingsley town, Alabama",76,54,22,01,06460,28.947368421052634
"Addison town, Alabama",337,308,29,01,00484,8.605341246290802
"Arley town, Alabama",238,204,34,01,02500,14.285714285714285
"Allgood town, Alabama",273,224,49,01,01396,17.94871794871795
"Rosa town, Alabama",158,135,23,01,66408,14.556962025316455
"Brantley town, Alabama",418,331,87,01,09016,20.813397129186605
"Deatsville town, Alabama",454,438,16,01,20008,3.524229074889868
"Frisco City town, Alabama",692,566,126,01,28312,18.20809248554913
"Courtland town, Alabama",413,327,86,01,18040,20.823244552058114
"Aliceville city, Alabama",1045,851,194,01,01228,18.564593301435405
"Montgomery city, Alabama",92215,79368,12847,01,51000,13.931572954508486
"Bridgeport city, Alabama",1221,1044,177,01,09328,14.496314496314497
"Dutton town, Alabama",160,144,16,01,21952,10.0
"Pleasant Groves town, Alabama",179,150,29,01,61038,16.201117318435752
"Fayette city, Alabama",2304,1795,509,01,25840,22.09201388888889
"Notasulga town, Alabama",521,448,73,01,55440,14.011516314779271
"Baileyton town, Alabama",340,310,30,01,03676,8.823529411764707
"West Point town, Alabama",250,221,29,01,81528,11.600000000000001
"Oak Hill town, Alabama",29,20,9,01,55848,31.03448275862069
"Midway town, Alabama",401,286,115,01,48424,28.6783042394015
"Lakeview town, Alabama",60,49,11,01,40888,18.333333333333332
"Bon Air town, Alabama",45,41,4,01,08248,8.88888888888889
"Waldo town, Alabama",146,111,35,01,79488,23.972602739726025
"Newton town, Alabama",695,610,85,01,54480,12.23021582733813
"Coffee Springs town, Alabama",124,92,32,01,16240,25.806451612903224
"Alexander City city, Alabama",6844,6081,763,01,01132,11.148451198129749
"Taylor town, Alabama",970,794,176,01,75096,18.144329896907216
"Webb town, Alabama",634,504,130,01,80376,20.50473186119874
"Bayou La Batre city, Alabama",907,767,140,01,04684,15.43550165380375
"Mooresville town, Alabama",34,34,0,01,51264,0.0
"Tillmans Corner CDP, Alabama",7377,6486,891,01,76320,12.078080520536803
"Carbon Hill city, Alabama",799,619,180,01,12016,22.528160200250312
"Tuscaloosa city, Alabama",47851,35192,12659,01,77256,26.455037512277695
"Oneonta city, Alabama",2567,2334,233,01,57000,9.076743280093494
"Susan Moore town, Alabama",328,264,64,01,74160,19.51219512195122
"Fulton town, Alabama",104,74,30,01,28504,28.846153846153843
"Gaylesville town, Alabama",91,77,14,01,29296,15.384615384615385
"Glenwood town, Alabama",150,92,58,01,30160,38.666666666666664
"Marion city, Alabama",1277,901,376,01,46768,29.444009397024274
"Langston town, Alabama",210,103,107,01,41368,50.95238095238095
"Hazel Green CDP, Alabama",1540,1361,179,01,33808,11.623376623376624
"Madison city, Alabama",19548,18591,957,01,45784,4.895641497851442
"Edwardsville town, Alabama",80,65,15,01,23176,18.75
"Lake View town, Alabama",984,925,59,01,40928,5.995934959349594
"Nectar town, Alabama",154,121,33,01,53448,21.428571428571427
"Snead town, Alabama",390,331,59,01,71280,15.128205128205128
"Vance town, Alabama",646,572,74,01,78264,11.455108359133128
"Pelham city, Alabama",9448,8765,683,01,58848,7.229043183742591
"Linden city, Alabama",1140,874,266,01,43240,23.333333333333332
"Ethelsville town, Alabama",48,48,0,01,24472,0.0
"Pine Apple town, Alabama",95,65,30,01,59880,31.57894736842105
"Haleyville city, Alabama",1947,1520,427,01,32704,21.931176168464305
"County Line town, Alabama",126,102,24,01,17968,19.047619047619047
"Nauvoo town, Alabama",115,81,34,01,53400,29.565217391304348
"Holt CDP, Alabama",1575,1300,275,01,35704,17.46031746031746
"Northport city, Alabama",10497,9425,1072,01,55200,10.212441649995236
"Hillsboro town, Alabama",252,217,35,01,34816,13.88888888888889
"Highland Lake town, Alabama",243,160,83,01,34480,34.15637860082305
"Elmore town, Alabama",547,476,71,01,23656,12.979890310786105
"Tallassee city, Alabama",2224,1926,298,01,74688,13.399280575539569
"Elkmont town, Alabama",169,154,15,01,23488,8.875739644970414
"Trussville city, Alabama",8146,7695,451,01,76944,5.536459612079548
"Elba city, Alabama",1596,1368,228,01,23296,14.285714285714285
"Columbia town, Alabama",396,308,88,01,16744,22.22222222222222
"Grand Bay CDP, Alabama",1481,1267,214,01,31024,14.449696151249155
"McDonald Chapel CDP, Alabama",328,228,100,01,45208,30.48780487804878
"Sipsey town, Alabama",192,143,49,01,70704,25.520833333333332
"Brighton city, Alabama",1525,1092,433,01,09400,28.393442622950822
"Edgewater CDP, Alabama",464,256,208,01,23032,44.827586206896555
"Mountain Brook city, Alabama",7934,7410,524,01,51696,6.6044870178976565
"North Johns town, Alabama",80,69,11,01,55152,13.750000000000002
"Rock Creek CDP, Alabama",644,576,68,01,65412,10.559006211180124
"Babbie town, Alabama",277,242,35,01,03556,12.63537906137184
"Shorter town, Alabama",230,194,36,01,70128,15.65217391304348
"Pine Hill town, Alabama",388,297,91,01,60240,23.45360824742268
"Tuskegee city, Alabama",4530,3076,1454,01,77304,32.09713024282561
"Clayton town, Alabama",622,516,106,01,15376,17.041800643086816
"Heath town, Alabama",141,111,30,01,33904,21.27659574468085
"Opp city, Alabama",3206,2730,476,01,57120,14.847161572052403
"Hayneville town, Alabama",463,403,60,01,33712,12.958963282937367
"Carrollton town, Alabama",447,357,90,01,12304,20.13422818791946
"Boaz city, Alabama",4163,3561,602,01,07912,14.46072543838578
"Rainbow City city, Alabama",4606,4036,570,01,63288,12.375162831089883
"Lowndesboro town, Alabama",61,44,17,01,44536,27.86885245901639
"Alexandria CDP, Alabama",1641,1475,166,01,01180,10.1157830591103
"Brookside town, Alabama",641,542,99,01,09736,15.44461778471139
"Forestdale CDP, Alabama",4385,3761,624,01,27088,14.230330672748003
"Gardendale city, Alabama",5975,5502,473,01,29056,7.916317991631799
"Grayson Valley CDP, Alabama",2909,2674,235,01,31348,8.07837744929529
"Graysville city, Alabama",1057,825,232,01,31384,21.948912015137182
"Hueytown city, Alabama",6401,5615,786,01,36448,12.279331354475863
"Trafford town, Alabama",304,246,58,01,76680,19.078947368421055
"Reece City town, Alabama",316,264,52,01,63984,16.455696202531644
"Fort Deposit town, Alabama",746,615,131,01,27520,17.560321715817693
"Toxey town, Alabama",68,50,18,01,76632,26.47058823529412
"Altoona town, Alabama",394,310,84,01,01660,21.31979695431472
"Benton town, Alabama",22,21,1,01,05692,4.545454545454546
"Mosses town, Alabama",441,416,25,01,51520,5.6689342403628125
"Ohatchee town, Alabama",664,529,135,01,56472,20.33132530120482
"Saks CDP, Alabama",4895,4240,655,01,67608,13.381001021450459
"New Brockton town, Alabama",560,470,90,01,53856,16.071428571428573
"Madrid town, Alabama",136,105,31,01,45904,22.794117647058822
"Oakman town, Alabama",375,317,58,01,55992,15.466666666666667
"Sylvan Springs town, Alabama",629,599,30,01,74424,4.769475357710652
"Birmingham city, Alabama",113838,89880,23958,01,07000,21.045696516101827
"Helena city, Alabama",6814,6534,280,01,34024,4.109186968007044
"Hoover city, Alabama",35456,32685,2771,01,35896,7.815320397111913
"Midfield city, Alabama",2309,1991,318,01,48376,13.772195755738414
"Vestavia Hills city, Alabama",14242,13091,1151,01,78552,8.08173009408791
"Andalusia city, Alabama",4328,3465,863,01,01708,19.93992606284658
"Horn Hill town, Alabama",118,98,20,01,36088,16.94915254237288
"Onycha town, Alabama",95,33,62,01,57024,65.26315789473685
"Red Level town, Alabama",219,137,82,01,63768,37.44292237442922
"Berry town, Alabama",601,560,41,01,05932,6.821963394342761
"Belk town, Alabama",112,99,13,01,05164,11.607142857142858
"Anniston city, Alabama",11689,9340,2349,01,01852,20.095816579690307
"Atmore city, Alabama",3720,2903,817,01,03004,21.96236559139785
"Lineville city, Alabama",1130,905,225,01,43264,19.911504424778762
"Heflin city, Alabama",1564,1323,241,01,33976,15.409207161125318
"Akron town, Alabama",196,117,79,01,00676,40.30612244897959
"Moundville town, Alabama",1071,961,110,01,51648,10.270774976657329
"Guntersville city, Alabama",3905,3275,630,01,32416,16.13316261203585
"Pollard town, Alabama",61,46,15,01,61536,24.59016393442623
"Orange Beach city, Alabama",12485,2653,9832,01,57144,78.75050060072087
"Goshen town, Alabama",158,75,83,01,30880,52.53164556962025
"Bay Minette city, Alabama",3168,2779,389,01,04660,12.279040404040405
"Elberta town, Alabama",908,761,147,01,23320,16.189427312775333
"Talladega city, Alabama",6707,5635,1072,01,74592,15.983301028775907
"New Site town, Alabama",383,327,56,01,54432,14.621409921671018
"Wedowee town, Alabama",396,321,75,01,80496,18.939393939393938
"Loxley town, Alabama",843,709,134,01,44608,15.895610913404507
"Sylvania town, Alabama",909,804,105,01,74400,11.55115511551155
"St. Florian town, Alabama",204,180,24,01,67536,11.76470588235294
"Somerville town, Alabama",290,241,49,01,71496,16.896551724137932
"Oak Grove town, Alabama",310,242,68,01,55752,21.935483870967744
"Vincent town, Alabama",959,766,193,01,79008,20.125130344108445
"Camp Hill town, Alabama",590,411,179,01,11680,30.338983050847457
"Geraldine town, Alabama",443,400,43,01,29608,9.706546275395034
"Powell town, Alabama",352,311,41,01,62075,11.647727272727272
"Hartselle city, Alabama",6191,5357,834,01,33448,13.471167824261023
"Mignon CDP, Alabama",639,396,243,01,48616,38.028169014084504
"Triana town, Alabama",382,308,74,01,76824,19.3717277486911
"Meadowbrook CDP, Alabama",3418,3344,74,01,47740,2.1650087770626096
"Dayton town, Alabama",9,9,0,01,19912,0.0
"Demopolis city, Alabama",3490,2825,665,01,20296,19.054441260744987
"Sweet Water town, Alabama",113,95,18,01,74304,15.929203539823009
"Huguley CDP, Alabama",1187,984,203,01,36592,17.101937657961248
"Shiloh town, Alabama",174,129,45,01,69840,25.862068965517242
"Ozark city, Alabama",7002,5849,1153,01,57648,16.466723793201943
"Goldville town, Alabama",14,14,0,01,30448,0.0
"Waverly town, Alabama",97,78,19,01,80256,19.587628865979383
"Valley city, Alabama",4496,3623,873,01,78204,19.41725978647687
"Littleville town, Alabama",458,403,55,01,43648,12.008733624454148
"Bear Creek town, Alabama",541,465,76,01,04852,14.048059149722736
"Lexington town, Alabama",411,359,52,01,42640,12.652068126520682
"Decatur city, Alabama",24888,22081,2807,01,20104,11.27852780456445
"Lincoln city, Alabama",3290,2495,795,01,43120,24.164133738601823
"Woodland town, Alabama",118,86,32,01,83400,27.11864406779661
"Fairhope city, Alabama",8986,7540,1446,01,25240,16.091698197195637
"Point Clear CDP, Alabama",1168,705,463,01,61488,39.64041095890411
"Robertsdale city, Alabama",2662,2449,213,01,65208,8.001502629601804
"Garden City town, Alabama",217,190,27,01,29032,12.442396313364055
"Georgiana town, Alabama",876,591,285,01,29560,32.534246575342465
"Brookwood town, Alabama",856,791,65,01,09808,7.593457943925233
"Walnut Grove town, Alabama",352,307,45,01,79728,12.784090909090908
"Dothan city, Alabama",31020,26001,5019,01,21184,16.179883945841393
"Kinsey town, Alabama",934,808,126,01,40072,13.49036402569593
"Theodore CDP, Alabama",2343,2148,195,01,75768,8.322663252240718
"Eldridge town, Alabama",58,44,14,01,23344,24.137931034482758
"Jasper city, Alabama",6398,5339,1059,01,38416,16.55204751484839
"Kansas town, Alabama",108,71,37,01,39280,34.25925925925926
"Fultondale city, Alabama",4057,3793,264,01,28552,6.507271382795168
"Foley city, Alabama",9345,7574,1771,01,26992,18.95131086142322
"Underwood-Petersville CDP, Alabama",1420,1256,164,01,77580,11.549295774647888
"Guin city, Alabama",1327,1016,311,01,32224,23.43632253202713
"Daphne city, Alabama",10794,9593,1201,01,19648,11.126551788030387
"Silverhill town, Alabama",314,278,36,01,70536,11.464968152866243
"Leesburg town, Alabama",606,415,191,01,42016,31.51815181518152
"Rainsville city, Alabama",2189,2010,179,01,63336,8.1772498857926
"Piedmont city, Alabama",2443,2037,406,01,59640,16.6189111747851
"Huntsville city, Alabama",92098,82858,9240,01,37000,10.032791157245542
"Castleberry town, Alabama",341,245,96,01,12496,28.152492668621704
"Owens Cross Roads town, Alabama",807,747,60,01,57504,7.434944237918216
"Abbeville city, Alabama",1362,993,369,01,00124,27.09251101321586
"Eclectic town, Alabama",454,375,79,01,22816,17.400881057268723
"Brewton city, Alabama",2616,2159,457,01,09208,17.46941896024465
"Flomaton town, Alabama",820,648,172,01,26824,20.975609756097562
"Five Points town, Alabama",98,77,21,01,26200,21.428571428571427
"Oxford city, Alabama",9008,7972,1036,01,57576,11.50088809946714
"Cowarts town, Alabama",980,806,174,01,18088,17.755102040816325
"Prichard city, Alabama",9879,7574,2305,01,62496,23.332321085130072
"Satsuma city, Alabama",2318,2248,70,01,68352,3.019844693701467
"Maytown town, Alabama",157,127,30,01,47728,19.10828025477707
"Morris town, Alabama",806,749,57,01,51456,7.07196029776675
"Pleasant Grove city, Alabama",4094,3745,349,01,61008,8.52467024914509
"Glencoe city, Alabama",2405,2018,387,01,29992,16.091476091476093
"Hokes Bluff city, Alabama",1962,1599,363,01,35392,18.501529051987767
"Gordonville town, Alabama",105,84,21,01,30808,20.0
"Lockhart town, Alabama",191,121,70,01,43816,36.64921465968586
"Autaugaville town, Alabama",477,393,84,01,03220,17.61006289308176
"Arab city, Alabama",3522,3188,334,01,02116,9.483248154457694
"Pell City city, Alabama",6423,5588,835,01,58896,13.000155690487311
"Rogersville town, Alabama",618,530,88,01,66216,14.239482200647249
"Sheffield city, Alabama",5045,4045,1000,01,69648,19.821605550049554
"Brilliant town, Alabama",523,398,125,01,09424,23.900573613766728
"Harvest CDP, Alabama",2218,1978,240,01,33472,10.820559062218214
"Evergreen city, Alabama",1947,1336,611,01,24808,31.38161273754494
"Repton town, Alabama",118,72,46,01,64368,38.983050847457626
"East Brewton city, Alabama",1282,1150,132,01,22216,10.29641185647426
"Auburn city, Alabama",27343,22850,4493,01,03076,16.43199356325202
"Opelika city, Alabama",13361,11974,1387,01,57048,10.380959509018787
"Leighton town, Alabama",584,376,208,01,42160,35.61643835616438
"Fort Rucker CDP, Alabama",1452,1246,206,01,27640,14.18732782369146
"Midland City town, Alabama",1111,909,202,01,48400,18.181818181818183
"Black town, Alabama",96,88,8,01,07120,8.333333333333332
"Geneva city, Alabama",2100,1799,301,01,29464,14.333333333333334
"Jacksons' Gap town, Alabama",358,283,75,01,38248,20.949720670391063
"Maplesville town, Alabama",286,260,26,01,46504,9.090909090909092
"Odenville town, Alabama",1470,1372,98,01,56400,6.666666666666667
"Brundidge city, Alabama",1095,706,389,01,10240,35.52511415525114
"Roanoke city, Alabama",2796,2352,444,01,65040,15.879828326180256
"Rock Mills CDP, Alabama",425,233,192,01,65592,45.1764705882353
"Russellville city, Alabama",3850,3143,707,01,67056,18.363636363636363
"Vina town, Alabama",177,142,35,01,78984,19.774011299435028
"Providence town, Alabama",108,82,26,01,62688,24.074074074074073
"Grant town, Alabama",357,347,10,01,31096,2.801120448179272
"Daviston town, Alabama",101,80,21,01,19816,20.792079207920793
"Clanton city, Alabama",3843,3291,552,01,15136,14.363778298204528
"Gurley town, Alabama",377,298,79,01,32440,20.954907161803714
"Moores Mill CDP, Alabama",2628,2607,21,01,51216,0.7990867579908676
"New Hope city, Alabama",1281,1134,147,01,54168,11.475409836065573
"New Market CDP, Alabama",723,505,218,01,54312,30.152143845089903
"Hurtsboro town, Alabama",291,236,55,01,37096,18.900343642611684
"Haleburg town, Alabama",63,49,14,01,32656,22.22222222222222
"Newville town, Alabama",272,193,79,01,54600,29.044117647058826
"Louisville town, Alabama",254,183,71,01,44344,27.95275590551181
"Orrville town, Alabama",135,102,33,01,57240,24.444444444444443
"Cuba town, Alabama",233,197,36,01,18952,15.450643776824036
"Gainesville town, Alabama",86,54,32,01,28768,37.2093023255814
"Libertyville town, Alabama",36,34,2,01,42808,5.555555555555555
"Alabaster city, Alabama",11852,11227,625,01,00820,5.273371582855215
"Harpersville town, Alabama",642,555,87,01,33256,13.551401869158877
"Gantt town, Alabama",92,50,42,01,28936,45.65217391304348
"Glen Allen town, Alabama",209,178,31,01,29944,14.832535885167463
"Franklin town, Alabama",113,84,29,01,28024,25.663716814159294
"Blue Springs town, Alabama",49,36,13,01,07672,26.53061224489796
"Hobson City town, Alabama",389,269,120,01,35152,30.848329048843187
"Cottonwood town, Alabama",670,492,178,01,17824,26.56716417910448
"Chickasaw city, Alabama",2529,2049,480,01,14392,18.979833926453143
"Saraland city, Alabama",5538,4881,657,01,68160,11.863488624052005
"Cordova city, Alabama",904,781,123,01,17368,13.606194690265486
"Parrish town, Alabama",507,409,98,01,58272,19.32938856015779
"Adamsville city, Alabama",1788,1472,316,01,00460,17.67337807606264
"Concord CDP, Alabama",689,663,26,01,16936,3.7735849056603774
"Fairfield city, Alabama",5367,4368,999,01,25120,18.613750698714366
"Homewood city, Alabama",11546,9916,1630,01,35800,14.117443270396674
"Irondale city, Alabama",5833,5092,741,01,37864,12.703583061889251
"Wilsonville town, Alabama",1063,882,181,01,82848,17.02728127939793
"Sardis City town, Alabama",722,688,34,01,68280,4.7091412742382275
"White Hall town, Alabama",445,379,66,01,81912,14.831460674157304
"Mulga town, Alabama",387,312,75,01,52776,19.379844961240313
"Monroeville city, Alabama",2591,2121,470,01,50192,18.139714395986108
"Minor CDP, Alabama",395,389,6,01,49072,1.5189873417721518
"Tarrant city, Alabama",2771,2183,588,01,74976,21.219776254059905
"Florence city, Alabama",20324,17482,2842,01,26896,13.98346782129502
"Hamilton city, Alabama",3325,2754,571,01,32848,17.172932330827066
"Banks town, Alabama",86,53,33,01,03940,38.372093023255815
"Wadley town, Alabama",236,216,20,01,79344,8.47457627118644
"Wilton town, Alabama",309,277,32,01,82872,10.355987055016183
"La Fayette city, Alabama",1254,1022,232,01,40672,18.50079744816587
"Lanett city, Alabama",3431,2674,757,01,41296,22.06353832701836
"Tuscumbia city, Alabama",3877,3168,709,01,77280,18.287335568738715
"Boligee town, Alabama",246,179,67,01,08104,27.235772357723576
"Malvern town, Alabama",771,714,57,01,46264,7.392996108949417
"Thorsby town, Alabama",848,736,112,01,76080,13.20754716981132
"Steele town, Alabama",513,475,38,01,72888,7.4074074074074066
"Mentone town, Alabama",378,162,216,01,48064,57.14285714285714
"Fort Payne city, Alabama",6280,5187,1093,01,27616,17.404458598726112
"Fyffe town, Alabama",517,470,47,01,28672,9.090909090909092
"Ider town, Alabama",326,288,38,01,37312,11.65644171779141
"Pine Ridge town, Alabama",123,110,13,01,60372,10.569105691056912
"Sand Rock town, Alabama",242,197,45,01,67920,18.59504132231405
"Valley Head town, Alabama",308,255,53,01,78240,17.20779220779221
"Waterloo town, Alabama",157,95,62,01,80064,39.490445859872615
"Eva town, Alabama",254,205,49,01,24688,19.291338582677163
"Falkville town, Alabama",489,392,97,01,25648,19.836400817995912
"Priceville town, Alabama",1105,1080,25,01,62472,2.262443438914027
"Childersburg city, Alabama",2198,2142,56,01,14464,2.547770700636943
"Attalla city, Alabama",2823,1991,832,01,03028,29.472192702798438
"Avon town, Alabama",216,177,39,01,03364,18.055555555555554
"West End-Cobb Town CDP, Alabama",1661,1288,373,01,81084,22.456351595424444
"Kinston town, Alabama",317,270,47,01,40096,14.826498422712934
"Rehobeth town, Alabama",656,585,71,01,64152,10.823170731707316
"Ardmore town, Alabama",545,506,39,01,02260,7.155963302752294
"Athens city, Alabama",10186,9222,964,01,02956,9.463970155114863
"Citronelle city, Alabama",1623,1392,231,01,15064,14.232902033271719
"Dauphin Island town, Alabama",1941,551,1390,01,19744,71.61257083977331
"Cardiff town, Alabama",21,13,8,01,12040,38.095238095238095
"Mobile city, Alabama",92480,77668,14812,01,50000,16.01643598615917
"Argo town, Alabama",1633,1473,160,01,02320,9.797917942437232
"Bessemer city, Alabama",13108,10431,2677,01,05980,20.4226426609704
"Leeds city, Alabama",5396,4783,613,01,41968,11.360266864343957
"Lipscomb city, Alabama",923,759,164,01,43336,17.768147345612135
"Sumiton city, Alabama",1219,1046,173,01,73848,14.191960623461854
"West Jefferson town, Alabama",221,188,33,01,81336,14.93212669683258
"Needham town, Alabama",73,45,28,01,53472,38.35616438356164
"Silas town, Alabama",288,210,78,01,70416,27.083333333333332
"Jacksonville city, Alabama",5169,4593,576,01,38272,11.14335461404527
"Weaver city, Alabama",1288,1120,168,01,80352,13.043478260869565
"Gordon town, Alabama",156,94,62,01,30760,39.743589743589745
"Faunsdale town, Alabama",42,17,25,01,25816,59.523809523809526
"Ariton town, Alabama",343,245,98,01,02428,28.57142857142857
"Clayhatchee town, Alabama",302,207,95,01,15304,31.456953642384107
"Level Plains town, Alabama",871,761,110,01,42472,12.629161882893225
"Newbern town, Alabama",94,75,19,01,53784,20.212765957446805
"Phil Campbell town, Alabama",598,518,80,01,59496,13.377926421404682
"Blue Ridge CDP, Alabama",608,608,0,01,07588,0.0
"Millbrook city, Alabama",6149,5705,444,01,48712,7.220686290453732
"Prattville city, Alabama",14854,13776,1078,01,62328,7.257304429783224
"Wetumpka city, Alabama",3668,3083,585,01,81720,15.948745910577971
"Town Creek town, Alabama",533,425,108,01,76584,20.26266416510319
"Rockford town, Alabama",315,254,61,01,65472,19.365079365079367
"Douglas town, Alabama",382,340,42,01,21328,10.99476439790576
"Daleville city, Alabama",2834,2026,808,01,19360,28.510938602681723
"Napier Field town, Alabama",220,177,43,01,53256,19.545454545454547
"Fairview town, Alabama",191,174,17,01,25384,8.900523560209423
"Vredenburgh town, Alabama",131,76,55,01,79272,41.98473282442748
"Scottsboro city, Alabama",7184,6014,1170,01,68736,16.28619153674833
"Eufaula city, Alabama",5918,4911,1007,01,24568,17.01588374450828
"Warrior city, Alabama",1659,1558,101,01,79944,6.088004822182038
"Double Springs town, Alabama",595,466,129,01,21280,21.680672268907564
"Natural Bridge town, Alabama",38,4,34,01,53376,89.47368421052632
"Selmont-West Selmont CDP, Alabama",1205,861,344,01,69180,28.54771784232365
"North Courtland town, Alabama",386,352,34,01,55044,8.808290155440414
"Margaret town, Alabama",1520,1364,156,01,46696,10.263157894736842
"Killen town, Alabama",475,441,34,01,39784,7.157894736842104
"McIntosh town, Alabama",147,131,16,01,45472,10.884353741496598
"Muscle Shoals city, Alabama",6067,5521,546,01,53016,8.999505521674633
"Forkland town, Alabama",350,226,124,01,27376,35.42857142857142
"Albertville city, Alabama",7893,7343,550,01,00988,6.968199670594196
"Hartford city, Alabama",1142,1008,134,01,33424,11.733800350262696
"Gilbertown town, Alabama",107,70,37,01,29704,34.57943925233645
"Supai CDP, Arizona",7,3,4,04,71230,57.14285714285714
"Tuba City CDP, Arizona",2719,2289,430,04,76010,15.814637734461199
"Gisela CDP, Arizona",334,184,150,04,27540,44.91017964071856
"Fountain Hills town, Arizona",14511,11579,2932,04,25300,20.205361449934532
"New River CDP, Arizona",6705,5922,783,04,49360,11.677852348993287
"Sun City West CDP, Arizona",18539,15230,3309,04,70355,17.848859161767088
"Sun Lakes CDP, Arizona",10483,8443,2040,04,70530,19.460078221883048
"Litchfield Park city, Arizona",2640,2411,229,04,41330,8.674242424242424
"Red Mesa CDP, Arizona",205,114,91,04,59550,44.390243902439025
"St. Johns city, Arizona",1363,997,366,04,62350,26.852531181217902
"Goodyear city, Arizona",28207,24835,3372,04,28380,11.954479384549934
"Guadalupe town, Arizona",1834,1745,89,04,30270,4.85278080697928
"Parker town, Arizona",1047,894,153,04,53070,14.613180515759314
"Williamson CDP, Arizona",3091,2528,563,04,83388,18.214170171465547
"Canyon Day CDP, Arizona",404,339,65,04,10040,16.08910891089109
"East Fork CDP, Arizona",174,156,18,04,21310,10.344827586206897
"Parker Strip CDP, Arizona",1472,386,1086,04,53210,73.77717391304348
"Gadsden CDP, Arizona",217,155,62,04,26070,28.57142857142857
"Taylor town, Arizona",1705,1550,155,04,72420,9.090909090909092
"Greasewood CDP, Arizona",170,119,51,04,29430,30.0
"Holbrook city, Arizona",1807,1494,313,04,33280,17.32152739346984
"Shonto CDP, Arizona",200,146,54,04,66260,27.0
"Catalina Foothills CDP, Arizona",27650,22971,4679,04,11230,16.922242314647377
"Winkelman town, Arizona",127,105,22,04,83790,17.322834645669293
"Oro Valley town, Arizona",22018,19295,2723,04,51600,12.367154146607321
"Sahuarita town, Arizona",11322,10239,1083,04,62140,9.565447800741918
"Pocahontas city, Arkansas",2917,2747,170,05,56540,5.8279053822420295
"Lavaca city, Arkansas",1049,972,77,05,38890,7.340324118207817
"Taylor city, Arkansas",217,183,34,05,68660,15.668202764976957
"Melbourne city, Arkansas",923,740,183,05,45080,19.826652221018417
"O'Kean town, Arkansas",159,109,50,05,51500,31.446540880503143
"Fort Smith city, Arkansas",39760,35415,4345,05,24550,10.928068410462776
"Hunter town, Arkansas",80,51,29,05,33910,36.25
"Calion city, Arkansas",355,243,112,05,10600,31.549295774647888
"Johnson city, Arkansas",1559,1440,119,05,35500,7.633098139833226
"Mayflower city, Arkansas",961,777,184,05,44750,19.14672216441207
"McNeil city, Arkansas",256,192,64,05,43100,25.0
"Ravenden Springs town, Arkansas",72,59,13,05,58280,18.055555555555554
"Clinton city, Arkansas",1195,1008,187,05,14260,15.648535564853555
"Fairfield Bay city, Arkansas",2448,1250,1198,05,22660,48.93790849673202
"Greenwood city, Arkansas",3603,3343,260,05,28780,7.216208714959755
"Augusta city, Arkansas",1289,1068,221,05,02740,17.14507370054306
"Norphlet city, Arkansas",349,261,88,05,50060,25.214899713467048
"Elm Springs city, Arkansas",798,772,26,05,21430,3.258145363408521
"Searcy city, Arkansas",9494,8311,1183,05,63020,12.460501369285865
"Eureka Springs city, Arkansas",1378,986,392,05,22240,28.44702467343977
"Concord town, Arkansas",98,77,21,05,15100,21.428571428571427
"Caldwell town, Arkansas",235,212,23,05,10450,9.787234042553191
"Moro town, Arkansas",102,87,15,05,46910,14.705882352941178
"Blue Mountain town, Arkansas",32,29,3,05,07210,9.375
"St. Charles town, Arkansas",194,120,74,05,61940,38.144329896907216
"Franklin town, Arkansas",98,76,22,05,25030,22.448979591836736
"Lafe town, Arkansas",217,184,33,05,37660,15.207373271889402
"Shirley town, Arkansas",183,122,61,05,63980,33.33333333333333
"Roe town, Arkansas",57,42,15,05,60380,26.31578947368421
"Carlisle city, Arkansas",1018,918,100,05,11500,9.823182711198427
"Bald Knob city, Arkansas",1368,1083,285,05,03280,20.833333333333336
"Amagon town, Arkansas",41,39,2,05,01270,4.878048780487805
"Wilmot city, Arkansas",309,166,143,05,75890,46.27831715210356
"Pangburn city, Arkansas",287,227,60,05,53240,20.905923344947734
"Delight city, Arkansas",229,189,40,05,18100,17.46724890829694
"Holly Grove city, Arkansas",319,230,89,05,32800,27.89968652037618
"Tenakee Springs city, Alaska",197,68,129,02,76260,65.48223350253807
"Pleasant Valley CDP, Alaska",348,191,157,02,61120,45.11494252873563
"Ester CDP, Alaska",723,397,326,02,23460,45.08990318118949
"Fairbanks city, Alaska",13009,11025,1984,02,24230,15.250980090706435
"Fox CDP, Alaska",258,258,0,02,26870,0.0
"Tununak CDP, Alaska",79,71,8,02,79230,10.126582278481013
"Big Lake CDP, Alaska",2845,1116,1729,02,07070,60.77328646748682
"New Stuyahok city, Alaska",139,110,29,02,53710,20.863309352517987
"Nightmute city, Alaska",48,39,9,02,53930,18.75
"Kiana city, Alaska",116,72,44,02,39300,37.93103448275862
"Akiak city, Alaska",97,81,16,02,00870,16.49484536082474
"Kwethluk city, Alaska",214,153,61,02,42380,28.504672897196258
"Stony River CDP, Alaska",19,10,9,02,73400,47.368421052631575
"Fort Yukon city, Alaska",319,209,110,02,26760,34.48275862068966
"Grayling city, Alaska",72,57,15,02,30060,20.833333333333336
"Rampart CDP, Alaska",42,20,22,02,64820,52.38095238095239
"Tanana city, Alaska",148,96,52,02,75160,35.13513513513514
"Kivalina city, Alaska",136,117,19,02,39960,13.970588235294118
"Red Dog Mine CDP, Alaska",0,0,0,02,64980,
"Aleknagik city, Alaska",129,62,67,02,01420,51.93798449612403
"Ekwok city, Alaska",44,25,19,02,21810,43.18181818181818
"Ambler city, Alaska",97,78,19,02,01970,19.587628865979383
"Kotzebue city, Alaska",1222,942,280,02,41830,22.913256955810148
"Arctic Village CDP, Alaska",81,55,26,02,03990,32.098765432098766
"Coldfoot CDP, Alaska",0,0,0,02,16630,
"Galena city, Alaska",270,193,77,02,27530,28.51851851851852
"Manley Hot Springs CDP, Alaska",124,35,89,02,46780,71.7741935483871
"Venetie CDP, Alaska",85,50,35,02,82420,41.17647058823529
"Salcha CDP, Alaska",480,347,133,02,66550,27.708333333333336
"Halibut Cove CDP, Alaska",222,39,183,02,31270,82.43243243243244
"Kalifornsky CDP, Alaska",3741,3063,678,02,37250,18.123496391339213
"Atmautluak CDP, Alaska",55,51,4,02,04430,7.2727272727272725
"Bethel city, Alaska",2439,1946,493,02,06520,20.213202132021323
"Crooked Creek CDP, Alaska",40,31,9,02,17850,22.5
"Eek city, Alaska",126,111,15,02,21040,11.904761904761903
"Kodiak Station CDP, Alaska",372,340,32,02,41210,8.60215053763441
"Brevig Mission city, Alaska",99,96,3,02,08740,3.0303030303030303
"Nome city, Alaska",1541,1269,272,02,54920,17.65087605451006
"Savoonga city, Alaska",253,211,42,02,67460,16.600790513833992
"Chiniak CDP, Alaska",18,0,18,02,13860,100.0
"Larsen Bay city, Alaska",84,25,59,02,43040,70.23809523809523
"Ouzinkie city, Alaska",104,65,39,02,58550,37.5
"Womens Bay CDP, Alaska",334,320,14,02,85680,4.191616766467066
"Nelson Lagoon CDP, Alaska",36,28,8,02,52940,22.22222222222222
"Beluga CDP, Alaska",25,4,21,02,06245,84.0
"Funny River CDP, Alaska",1064,431,633,02,27145,59.49248120300752
"Kasilof CDP, Alaska",236,149,87,02,38090,36.86440677966102
"Cantwell CDP, Alaska",214,93,121,02,10150,56.54205607476636
"Ferry CDP, Alaska",33,6,27,02,25220,81.81818181818183
"Wainwright city, Alaska",162,131,31,02,82750,19.1358024691358
"Attu Station CDP, Alaska",0,0,0,02,04670,
"Fritz Creek CDP, Alaska",1115,754,361,02,27090,32.37668161434978
"Kenai city, Alaska",3564,3117,447,02,38420,12.542087542087543
"Primrose CDP, Alaska",50,43,7,02,64240,14.000000000000002
"Seldovia Village CDP, Alaska",211,77,134,02,68370,63.507109004739334
"Game Creek CDP, Alaska",4,0,4,02,27700,100.0
"Diomede city, Alaska",48,32,16,02,19060,33.33333333333333
"St. Michael city, Alaska",125,108,17,02,66360,13.600000000000001
"Stebbins city, Alaska",121,112,9,02,72960,7.43801652892562
"Akhiok city, Alaska",32,16,16,02,00650,50.0
"Old Harbor city, Alaska",113,83,30,02,57340,26.548672566371685
"Chevak city, Alaska",263,215,48,02,13230,18.250950570342205
"Emmonak city, Alaska",215,179,36,02,22910,16.74418604651163
"Elaine city, Arkansas",316,276,40,05,20950,12.658227848101266
"Rector city, Arkansas",956,813,143,05,58490,14.958158995815898
"Sidney town, Arkansas",82,72,10,05,64280,12.195121951219512
"Warren city, Arkansas",2726,2321,405,05,73310,14.856933235509906
"Keo town, Arkansas",106,84,22,05,36550,20.754716981132077
"Bryant city, Arkansas",8520,8003,517,05,09460,6.068075117370892
"Haskell city, Arkansas",1269,1126,143,05,30640,11.268715524034672
"Crossett city, Arkansas",2648,2062,586,05,16240,22.129909365558913
"Parkdale city, Arkansas",118,78,40,05,53510,33.89830508474576
"Cherry Valley city, Arkansas",339,276,63,05,13540,18.58407079646018
"Marked Tree city, Arkansas",1172,922,250,05,44210,21.331058020477816
"Belleville city, Arkansas",218,166,52,05,04960,23.853211009174313
"Corinth town, Arkansas",31,24,7,05,15310,22.58064516129032
"Plainview city, Arkansas",355,233,122,05,55970,34.36619718309859
"Cammack Village city, Arkansas",365,353,12,05,10780,3.287671232876712
"College Station CDP, Arkansas",300,232,68,05,14860,22.666666666666664
"Little Rock city, Arkansas",95721,81369,14352,05,41000,14.993575077569185
"Marie town, Arkansas",27,23,4,05,44150,14.814814814814813
"Jennette town, Arkansas",71,48,23,05,35040,32.3943661971831
"West Memphis city, Arkansas",10976,9742,1234,05,74540,11.242711370262391
"Monette city, Arkansas",832,767,65,05,46400,7.8125
"Blytheville city, Arkansas",7742,5841,1901,05,07330,24.554378713510722
"McNab town, Arkansas",28,13,15,05,43070,53.57142857142857
"Birdsong town, Arkansas",23,14,9,05,06340,39.130434782608695
"Dyess town, Arkansas",125,100,25,05,20230,20.0
"Joiner city, Arkansas",266,245,21,05,35650,7.894736842105263
"Batesville city, Arkansas",4463,4023,440,05,04030,9.858839345731571
"Oak Grove Heights town, Arkansas",401,341,60,05,51060,14.962593516209477
"Calico Rock city, Arkansas",647,514,133,05,10570,20.556414219474497
"West Fork city, Arkansas",1007,940,67,05,74360,6.653426017874876
"Oil Trough town, Arkansas",145,82,63,05,51410,43.44827586206896
"McDougal town, Arkansas",91,68,23,05,42560,25.274725274725274
"Plumerville city, Arkansas",469,403,66,05,56480,14.072494669509595
"Austin city, Arkansas",1204,1109,95,05,02860,7.8903654485049834
"West Crossett CDP, Arkansas",570,447,123,05,74270,21.578947368421055
"Reed town, Arkansas",124,111,13,05,58880,10.483870967741936
"Bluff City town, Arkansas",70,52,18,05,07270,25.71428571428571
"De Queen city, Arkansas",2073,1775,298,05,18490,14.37530149541727
"Ben Lomond town, Arkansas",61,43,18,05,05260,29.508196721311474
"Cave City city, Arkansas",1056,919,137,05,12280,12.973484848484848
"Newark city, Arkansas",593,470,123,05,49010,20.741989881956155
"Gosnell city, Arkansas",1513,1302,211,05,27700,13.945803040317251
"Whelen Springs town, Arkansas",20,12,8,05,74930,40.0
"Altheimer city, Arkansas",443,312,131,05,01150,29.571106094808126
"White Hall city, Arkansas",2112,1892,220,05,75170,10.416666666666668
"Minturn town, Arkansas",45,45,0,05,46100,0.0
"North Little Rock city, Arkansas",31629,26612,5017,05,50450,15.86202535647665
"Sweet Home CDP, Arkansas",358,275,83,05,68330,23.18435754189944
"Stephens city, Arkansas",477,353,124,05,66860,25.995807127882596
"Colt city, Arkansas",260,208,52,05,14950,20.0
"Madison city, Arkansas",470,413,57,05,43280,12.127659574468085
"Palestine city, Arkansas",303,280,23,05,53150,7.590759075907591
"Cave Springs city, Arkansas",1354,1304,50,05,12340,3.6927621861152145
"Brinkley city, Arkansas",1590,1266,324,05,08950,20.37735849056604
"Alma city, Arkansas",2366,2171,195,05,00970,8.241758241758241
"Scott CDP, Arkansas",22,22,0,05,62900,0.0
"Woodson CDP, Arkansas",181,110,71,05,76730,39.226519337016576
"Corning city, Arkansas",1790,1426,364,05,15460,20.335195530726256
"Texarkana city, Arkansas",13444,11625,1819,05,68810,13.530199345432905
"Lonoke city, Arkansas",1742,1633,109,05,41420,6.257175660160735
"Chenega CDP, Alaska",41,14,27,02,12970,65.85365853658537
"Eudora city, Arkansas",1019,872,147,05,22180,14.425907752698725
"Kingsland city, Arkansas",224,181,43,05,36880,19.196428571428573
"Nelchina CDP, Alaska",49,38,11,02,52915,22.448979591836736
"Copper Center CDP, Alaska",212,77,135,02,17300,63.67924528301887
"Mendeltna CDP, Alaska",56,26,30,02,48200,53.57142857142857
"Silver Springs CDP, Alaska",77,40,37,02,70320,48.05194805194805
"Alakanuk city, Alaska",185,168,17,02,01200,9.18918918918919
"Anderson city, Alaska",147,50,97,02,03220,65.98639455782312
"Anaktuvuk Pass city, Alaska",108,74,34,02,02080,31.48148148148148
"Nuiqsut city, Alaska",129,106,23,02,56320,17.829457364341085
"False Pass city, Alaska",57,36,21,02,24660,36.84210526315789
"Santa Rosa CDP, Arizona",218,167,51,04,64310,23.394495412844037
"Lukachukai CDP, Arizona",729,385,344,04,42660,47.18792866941015
"St. Michaels CDP, Arizona",562,316,246,04,62420,43.77224199288256
"Hotevilla-Bacavi CDP, Arizona",380,261,119,04,33945,31.31578947368421
"Snowflake town, Arizona",1653,1554,99,04,67800,5.9891107078039925
"Quartzsite town, Arizona",4099,2168,1931,04,58010,47.109050988045865
"Kingman city, Arizona",12709,11303,1406,04,37620,11.063026201904162
"Mesquite Creek CDP, Arizona",282,240,42,04,46087,14.893617021276595
"New Kingman-Butler CDP, Arizona",6343,5289,1054,04,49270,16.61674286615166
"Globe city, Arizona",3452,2834,618,04,28030,17.902665121668598
"Apache Junction city, Arizona",22456,17056,5400,04,02830,24.047025293908085
"Cave Creek town, Arizona",3149,2615,534,04,11300,16.957764369641158
"Peoria city, Arizona",64631,58201,6430,04,54050,9.94878618619548
"Queen Creek town, Arizona",12405,10846,1559,04,58150,12.56751309955663
"Fredonia town, Arizona",559,443,116,04,25720,20.75134168157424
"Page city, Arizona",2799,2347,452,04,51810,16.148624508753127
"Willow Valley CDP, Arizona",1340,474,866,04,83570,64.62686567164178
"Seligman CDP, Arizona",272,200,72,04,65420,26.47058823529412
"Cordes Lakes CDP, Arizona",1374,1160,214,04,15765,15.574963609898107
"Cottonwood city, Arizona",5887,5253,634,04,16410,10.76949210124002
"Claypool CDP, Arizona",657,491,166,04,13960,25.266362252663622
"Payson town, Arizona",9125,6853,2272,04,53700,24.898630136986302
"Bluewater CDP, Arizona",765,466,299,04,07025,39.08496732026144
"Wenden CDP, Arizona",283,170,113,04,81550,39.92932862190813
"Chandler city, Arizona",95052,88987,6065,04,12000,6.3807179228211925
"El Mirage city, Arizona",11496,10478,1018,04,22220,8.855254001391788
"Glendale city, Arizona",90600,82455,8145,04,27820,8.990066225165563
"Mesa city, Arizona",209537,178390,31147,04,46000,14.86467783732706
"Wickenburg town, Arizona",3820,3313,507,04,82740,13.272251308900524
"Flagstaff city, Arizona",27452,23610,3842,04,23620,13.995337316042548
"Bitter Springs CDP, Arizona",153,117,36,04,06470,23.52941176470588
"Kachina Village CDP, Arizona",1531,1003,528,04,36475,34.48726322664925
"Phoenix city, Arizona",614870,555013,59857,04,55000,9.734903312895408
"Pima town, Arizona",989,795,194,04,55560,19.61577350859454
"Mountainaire CDP, Arizona",633,408,225,04,47820,35.54502369668246
"Gilbert town, Arizona",80626,75509,5117,04,27400,6.346587949296753
"Bouse CDP, Arizona",941,534,407,04,07310,43.251859723698196
"Williams city, Arizona",1416,1224,192,04,83160,13.559322033898304
"Strawberry CDP, Arizona",1199,421,778,04,70040,64.88740617180983
"Safford city, Arizona",4128,3308,820,04,62000,19.864341085271317
"Peach Springs CDP, Arizona",378,335,43,04,53770,11.375661375661375
"Show Low city, Arizona",7589,4287,3302,04,66470,43.51034391882989
"San Manuel CDP, Arizona",1640,1352,288,04,63540,17.560975609756095
"Vail CDP, Arizona",4353,4154,199,04,78540,4.571559843785895
"Mohave Valley CDP, Arizona",1269,1004,265,04,47400,20.882584712371948
"Gila Bend town, Arizona",769,626,143,04,27050,18.59557867360208
"Somerton city, Arizona",4860,4586,274,04,68080,5.637860082304527
"Mojave Ranch Estates CDP, Arizona",11,9,2,04,47495,18.181818181818183
"Leupp CDP, Arizona",313,296,17,04,40630,5.431309904153355
"Kayenta CDP, Arizona",1881,1321,560,04,36990,29.771398192450825
"Sierra Vista Southeast CDP, Arizona",7017,6296,721,04,66845,10.275046316089496
"Corona de Tucson CDP, Arizona",2738,2571,167,04,16030,6.099342585829072
"Parkin city, Arkansas",500,388,112,05,53600,22.400000000000002
"Van Buren city, Arkansas",9507,8802,705,05,71480,7.4155885137267274
"Salem city, Arkansas",866,756,110,05,62150,12.702078521939955
"Imboden town, Arkansas",350,309,41,05,34150,11.714285714285715
"Sedgwick town, Arkansas",106,86,20,05,63110,18.867924528301888
"Booneville city, Arkansas",1679,1442,237,05,07720,14.115544967242405
"Magazine city, Arkansas",406,351,55,05,43310,13.546798029556651
"Marmaduke city, Arkansas",575,516,59,05,44240,10.26086956521739
"Humphrey city, Arkansas",261,222,39,05,33850,14.942528735632186
"Marshall city, Arkansas",877,668,209,05,44300,23.831242873432153
"Pindall town, Arkansas",67,41,26,05,55280,38.80597014925373
"Rudy town, Arkansas",78,78,0,05,61460,0.0
"Hatfield town, Arkansas",207,161,46,05,30700,22.22222222222222
"Dover city, Arkansas",771,714,57,05,19600,7.392996108949417
"Russellville city, Arkansas",11429,9935,1494,05,61670,13.072009799632514
"Fordyce city, Arkansas",1959,1489,470,05,24220,23.991832567636546
"Sparkman city, Arkansas",261,185,76,05,65900,29.118773946360154
"Daisy town, Arkansas",114,41,73,05,17140,64.03508771929825
"Hughes city, Arkansas",692,563,129,05,33760,18.641618497109828
"Swifton city, Arkansas",420,363,57,05,68360,13.571428571428571
"Tupelo town, Arkansas",75,55,20,05,70340,26.666666666666668
"Mineral Springs city, Arkansas",476,432,44,05,46040,9.243697478991598
"Hot Springs city, Arkansas",19458,15359,4099,05,33400,21.06588549696783
"Lake View city, Arkansas",238,181,57,05,38110,23.949579831932773
"Gravette city, Arkansas",1509,1311,198,05,28360,13.12127236580517
"Valley Springs town, Arkansas",71,59,12,05,71390,16.901408450704224
"Marion city, Arkansas",4965,4474,491,05,44180,9.889224572004029
"Coal Hill city, Arkansas",558,460,98,05,14500,17.562724014336915
"Branch city, Arkansas",158,134,24,05,08440,15.18987341772152
"Sulphur Rock town, Arkansas",248,218,30,05,67730,12.096774193548388
"Datto town, Arkansas",46,38,8,05,17410,17.391304347826086
"Nimmons town, Arkansas",43,33,10,05,49820,23.25581395348837
"Gassville city, Arkansas",989,867,122,05,26050,12.335692618806876
"Zinc town, Arkansas",39,29,10,05,77600,25.64102564102564
"Anthonyville town, Arkansas",74,59,15,05,01457,20.27027027027027
"Russell town, Arkansas",129,102,27,05,61640,20.930232558139537
"Aubrey town, Arkansas",98,70,28,05,02680,28.57142857142857
"Haynes town, Arkansas",77,65,12,05,30880,15.584415584415584
"Casa town, Arkansas",78,57,21,05,11890,26.923076923076923
"Jericho town, Arkansas",26,19,7,05,35140,26.923076923076923
"Bono city, Arkansas",1060,936,124,05,07630,11.69811320754717
"Houston town, Arkansas",117,80,37,05,33490,31.62393162393162
"Paris city, Arkansas",1647,1438,209,05,53480,12.689738919247114
"Ratcliff city, Arkansas",108,94,14,05,58160,12.962962962962962
"Almyra town, Arkansas",132,109,23,05,01030,17.424242424242426
"Gillett city, Arkansas",417,308,109,05,26980,26.139088729016784
"Biggers town, Arkansas",164,126,38,05,06040,23.170731707317074
"Centerton city, Arkansas",4567,4425,142,05,12820,3.1092620976571053
"LaGrange town, Arkansas",46,26,20,05,37720,43.47826086956522
"Grady city, Arkansas",234,153,81,05,27790,34.61538461538461
"Lynn town, Arkansas",129,99,30,05,42260,23.25581395348837
"Paragould city, Arkansas",11476,10692,784,05,53390,6.831648658069013
"Ravenden town, Arkansas",236,206,30,05,58250,12.711864406779661
"Strawberry town, Arkansas",167,133,34,05,67250,20.35928143712575
"Stuttgart city, Arkansas",4346,3767,579,05,67490,13.322595490105845
"Mount Pleasant town, Arkansas",217,176,41,05,47900,18.89400921658986
"Bodcaw town, Arkansas",96,79,17,05,07450,17.708333333333336
"St. Joe town, Arkansas",95,63,32,05,62030,33.68421052631579
"Ola city, Arkansas",599,408,191,05,51560,31.886477462437394
"McAlmont CDP, Arkansas",964,681,283,05,42350,29.356846473029048
"Sherwood city, Arkansas",13432,12127,1305,05,63800,9.71560452650387
"Wrightsville city, Arkansas",375,253,122,05,76970,32.53333333333333
"Tanque Verde CDP, Arizona",7040,6345,695,04,72000,9.872159090909092
"Eagar town, Arizona",2213,1664,549,04,20960,24.807953004970628
"Pisinemo CDP, Arizona",106,77,29,04,56470,27.358490566037734
"Whiteriver CDP, Arizona",1100,922,178,04,82530,16.18181818181818
"Catalina CDP, Arizona",3223,2985,238,04,11160,7.384424449270865
"Green Valley CDP, Arizona",18076,13162,4914,04,29710,27.18521796857712
"Tucson city, Arizona",238177,210816,27361,04,77000,11.487675132359549
"Valencia West CDP, Arizona",4124,3782,342,04,78760,8.292919495635305
"Fortuna Foothills CDP, Arizona",20563,13500,7063,04,25030,34.34810095803142
"Casa Grande city, Arizona",22013,18196,3817,04,10530,17.339753781856178
"LeChee CDP, Arizona",447,360,87,04,40415,19.463087248322147
"Dewey-Humboldt town, Arizona",1809,1638,171,04,19145,9.45273631840796
"Maricopa city, Arizona",17442,14573,2869,04,44410,16.44880174291939
"Ali Chukson CDP, Arizona",57,17,40,04,01570,70.17543859649122
"Ali Molina CDP, Arizona",25,18,7,04,01620,28.000000000000004
"Alpine CDP, Arizona",222,72,150,04,01920,67.56756756756756
"Anegam CDP, Arizona",44,39,5,04,02270,11.363636363636363
"Antares CDP, Arizona",64,59,5,04,02410,7.8125
"Anthem CDP, Arizona",9470,8103,1367,04,02430,14.4350580781415
"Arivaca CDP, Arizona",534,382,152,04,03320,28.46441947565543
"Arivaca Junction CDP, Arizona",412,346,66,04,03380,16.019417475728158
"Arlington CDP, Arizona",85,64,21,04,04020,24.705882352941178
"Avenue B and C CDP, Arizona",1869,1344,525,04,04710,28.08988764044944
"Aztec CDP, Arizona",16,0,16,04,04930,100.0
"Bear Flat CDP, Arizona",48,0,48,04,05450,100.0
"Beaver Dam CDP, Arizona",1390,856,534,04,05490,38.41726618705036
"Beaver Valley CDP, Arizona",265,119,146,04,05495,55.094339622641506
"Beyerville CDP, Arizona",52,34,18,04,05970,34.61538461538461
"Bowie CDP, Arizona",222,150,72,04,07380,32.432432432432435
"Brenda CDP, Arizona",396,200,196,04,07590,49.494949494949495
"Bryce CDP, Arizona",26,26,0,04,07915,0.0
"Buckshot CDP, Arizona",34,13,21,04,08020,61.76470588235294
"Bylas CDP, Arizona",451,379,72,04,08710,15.96452328159645
"Cactus Flats CDP, Arizona",567,409,158,04,08920,27.86596119929453
"Cactus Forest CDP, Arizona",430,357,73,04,08990,16.97674418604651
"Campo Bonito CDP, Arizona",102,102,0,04,09580,0.0
"Cane Beds CDP, Arizona",189,98,91,04,09900,48.148148148148145
"Carrizo CDP, Arizona",17,17,0,04,10320,0.0
"Casa Blanca CDP, Arizona",470,318,152,04,10460,32.340425531914896
"Cedar Creek CDP, Arizona",151,136,15,04,11370,9.933774834437086
"Centennial Park CDP, Arizona",241,217,24,04,11500,9.95850622406639
"Central CDP, Arizona",162,142,20,04,11580,12.345679012345679
"Charco CDP, Arizona",37,18,19,04,12150,51.35135135135135
"Chiawuli Tak CDP, Arizona",0,0,0,04,12560,
"Chloride CDP, Arizona",257,202,55,04,12910,21.40077821011673
"Christopher Creek CDP, Arizona",352,78,274,04,13140,77.8409090909091
"Clay Springs CDP, Arizona",154,118,36,04,14030,23.376623376623375
"Cienega Springs CDP, Arizona",2248,890,1358,04,13540,60.40925266903915
"Citrus Park CDP, Arizona",1611,1498,113,04,13820,7.014276846679081
"Clacks Canyon CDP, Arizona",140,104,36,04,13850,25.71428571428571
"Comobabi CDP, Arizona",8,8,0,04,15080,0.0
"Concho CDP, Arizona",32,17,15,04,15150,46.875
"Copper Hill CDP, Arizona",72,0,72,04,15600,100.0
"Cornfields CDP, Arizona",64,55,9,04,15850,14.0625
"Cottonwood CDP, Arizona",84,68,16,04,16360,19.047619047619047
"Cowlic CDP, Arizona",62,38,24,04,16830,38.70967741935484
"Crozier CDP, Arizona",14,9,5,04,17460,35.714285714285715
"Crystal Beach CDP, Arizona",101,76,25,04,17500,24.752475247524753
"Kohls Ranch CDP, Arizona",231,87,144,04,38600,62.33766233766234
"Komatke CDP, Arizona",315,257,58,04,38655,18.412698412698415
"Lake of the Woods CDP, Arizona",2661,1490,1171,04,39790,44.00601277715145
"La Paz Valley CDP, Arizona",574,418,156,04,40160,27.177700348432055
"Bassett town, Arkansas",104,78,26,05,03940,25.0
"Emerson town, Arkansas",148,118,30,05,21580,20.27027027027027
"Magnolia city, Arkansas",5148,4152,996,05,43460,19.34731934731935
"Waldo city, Arkansas",817,605,212,05,72350,25.948592411260712
"Marianna city, Arkansas",1989,1574,415,05,44120,20.864756158873806
"Hoxie city, Arkansas",1271,1137,134,05,33580,10.54287962234461
"Clarksville city, Arkansas",3750,3433,317,05,14140,8.453333333333333
"Edmondson town, Arkansas",133,95,38,05,20830,28.57142857142857
"Jonesboro city, Arkansas",31389,28771,2618,05,35710,8.340501449552391
"Burdette town, Arkansas",83,75,8,05,09880,9.63855421686747
"Dell town, Arkansas",116,103,13,05,18160,11.206896551724139
"Manila city, Arkansas",1524,1318,206,05,43820,13.517060367454068
"Pine Bluff city, Arkansas",21205,16864,4341,05,55310,20.47158688988446
"Cedarville city, Arkansas",578,484,94,05,12520,16.26297577854671
"Enola town, Arkansas",144,124,20,05,21820,13.88888888888889
"Greenbrier city, Arkansas",2023,1949,74,05,28510,3.65793376173999
"Winthrop city, Arkansas",82,60,22,05,76250,26.82926829268293
"Foreman city, Arkansas",659,545,114,05,24250,17.298937784522003
"Guion town, Arkansas",74,46,28,05,29080,37.83783783783784
"Damascus town, Arkansas",181,160,21,05,17290,11.602209944751381
"Huntington city, Arkansas",277,221,56,05,33940,20.216606498194945
"Washington city, Arkansas",81,65,16,05,73370,19.753086419753085
"Bradley city, Arkansas",302,228,74,05,08290,24.503311258278146
"Buckner city, Arkansas",139,97,42,05,09550,30.215827338129497
"Highfill town, Arkansas",320,285,35,05,32200,10.9375
"Bergman town, Arkansas",238,218,20,05,05440,8.403361344537815
"Harrison city, Arkansas",6066,5369,697,05,30460,11.490273656445764
"Crawfordsville town, Arkansas",230,221,9,05,15940,3.91304347826087
"Cash town, Arkansas",123,113,10,05,11920,8.130081300813007
"Arkansas City city, Arkansas",281,189,92,05,01990,32.74021352313167
"Emmet city, Arkansas",312,262,50,05,21610,16.025641025641026
"Leslie city, Arkansas",415,314,101,05,39460,24.337349397590362
"Highland city, Arkansas",549,433,116,05,32257,21.129326047358834
"Williford town, Arkansas",60,40,20,05,75740,33.33333333333333
"Caulksville town, Arkansas",120,114,6,05,12190,5.0
"Western Grove town, Arkansas",223,179,44,05,74330,19.730941704035875
"Sherrill town, Arkansas",41,29,12,05,63740,29.268292682926827
"Black Rock city, Arkansas",348,301,47,05,06700,13.505747126436782
"Tull town, Arkansas",199,181,18,05,70220,9.045226130653267
"Wooster town, Arkansas",374,322,52,05,76820,13.903743315508022
"Mammoth Spring city, Arkansas",567,446,121,05,43670,21.340388007054674
"Decatur city, Arkansas",652,584,68,05,17740,10.429447852760736
"Bearden city, Arkansas",483,386,97,05,04420,20.082815734989648
"Chidester city, Arkansas",191,125,66,05,13750,34.55497382198953
"Cotton Plant city, Arkansas",482,322,160,05,15550,33.19502074688796
"Prairie Creek CDP, Arkansas",1165,1068,97,05,57125,8.326180257510728
"Bellefonte town, Arkansas",212,198,14,05,04900,6.60377358490566
"Tillar city, Arkansas",120,98,22,05,69230,18.333333333333332
"Mountain Home city, Arkansas",6634,5926,708,05,47390,10.672294241784746
"Perla town, Arkansas",107,96,11,05,54620,10.2803738317757
"Huntsville city, Arkansas",977,849,128,05,33970,13.101330603889458
"Kibler city, Arkansas",487,439,48,05,36670,9.856262833675565
"Camden city, Arkansas",5586,4504,1082,05,10720,19.36985320443967
"Greers Ferry city, Arkansas",912,456,456,05,28810,50.0
"Glenwood city, Arkansas",1021,853,168,05,27310,16.454456415279136
"Wheatley city, Arkansas",171,154,17,05,74840,9.941520467836257
"Pleasant Plains town, Arkansas",157,130,27,05,56270,17.197452229299362
"Clarendon city, Arkansas",943,784,159,05,13990,16.861081654294804
"Black Springs town, Arkansas",37,25,12,05,06730,32.432432432432435
"Mount Ida city, Arkansas",532,429,103,05,47690,19.360902255639097
"Fifty-Six city, Arkansas",112,60,52,05,23680,46.42857142857143
"Bauxite town, Arkansas",226,213,13,05,04090,5.752212389380531
"Lazy Y U CDP, Arizona",138,138,0,04,40400,0.0
"Linden CDP, Arizona",1500,1070,430,04,41085,28.666666666666668
"Littlefield CDP, Arizona",132,110,22,04,41470,16.666666666666664
"Lower Santan Village CDP, Arizona",76,68,8,04,42460,10.526315789473683
"Low Mountain CDP, Arizona",257,175,82,04,42590,31.906614785992215
"Lupton CDP, Arizona",8,4,4,04,42940,50.0
"McConnico CDP, Arizona",0,0,0,04,43150,
"McNeal CDP, Arizona",102,73,29,04,43570,28.431372549019606
"Maish Vaya CDP, Arizona",71,49,22,04,43920,30.985915492957744
"Maricopa Colony CDP, Arizona",199,167,32,04,44450,16.08040201005025
"Martinez Lake CDP, Arizona",614,38,576,04,44830,93.81107491856677
"Mead Ranch CDP, Arizona",106,0,106,04,45275,100.0
"Meadview CDP, Arizona",1325,509,816,04,45285,61.58490566037735
"Mesa del Caballo CDP, Arizona",380,303,77,04,46005,20.263157894736842
"Mescal CDP, Arizona",849,794,55,04,46070,6.478209658421672
"Miracle Valley CDP, Arizona",394,280,114,04,46840,28.934010152284262
"Moccasin CDP, Arizona",19,19,0,04,47190,0.0
"Nelson CDP, Arizona",162,152,10,04,49100,6.172839506172839
"Nolic CDP, Arizona",15,15,0,04,49710,0.0
"North Fork CDP, Arizona",468,428,40,04,50000,8.547008547008547
"Nutrioso CDP, Arizona",43,20,23,04,50340,53.48837209302325
"Oak Springs CDP, Arizona",26,17,9,04,50480,34.61538461538461
"Oatman CDP, Arizona",43,0,43,04,50620,100.0
"Orange Grove Mobile Manor CDP, Arizona",221,167,54,04,51465,24.43438914027149
"Oxbow Estates CDP, Arizona",164,104,60,04,51775,36.58536585365854
"Padre Ranchitos CDP, Arizona",39,39,0,04,51800,0.0
"Palominas CDP, Arizona",130,130,0,04,52230,0.0
"Picacho CDP, Arizona",179,141,38,04,55210,21.22905027932961
"Pimaco Two CDP, Arizona",399,330,69,04,55575,17.293233082706767
"Pinal CDP, Arizona",293,179,114,04,55630,38.907849829351534
"Pinedale CDP, Arizona",281,142,139,04,55840,49.46619217081851
"Pine Lake CDP, Arizona",131,48,83,04,55845,63.358778625954194
"Pinetop Country Club CDP, Arizona",4002,671,3331,04,55880,83.23338330834584
"Pinion Pines CDP, Arizona",64,64,0,04,55983,0.0
"Rainbow City CDP, Arizona",268,231,37,04,58620,13.805970149253731
"Rancho Mesa Verde CDP, Arizona",233,233,0,04,58870,0.0
"Alamo Lake CDP, Arizona",21,7,14,04,01170,66.66666666666666
"Rillito CDP, Arizona",27,0,27,04,59900,100.0
"Aguila CDP, Arizona",254,190,64,04,00730,25.196850393700785
"Ak Chin CDP, Arizona",0,0,0,04,00940,
"Ali Chuk CDP, Arizona",41,31,10,04,01560,24.390243902439025
"Star Valley town, Arizona",1330,994,336,04,69480,25.263157894736842
"Cutter CDP, Arizona",8,0,8,04,17810,100.0
"Dateland CDP, Arizona",231,182,49,04,18160,21.21212121212121
"Deer Creek CDP, Arizona",162,120,42,04,18448,25.925925925925924
"Del Muerto CDP, Arizona",80,66,14,04,18490,17.5
"Doney Park CDP, Arizona",2041,1816,225,04,19740,11.024007839294464
"Donovan Estates CDP, Arizona",406,368,38,04,19790,9.35960591133005
"Dragoon CDP, Arizona",76,32,44,04,20330,57.89473684210527
"Dripping Springs CDP, Arizona",135,98,37,04,20560,27.40740740740741
"Drysdale CDP, Arizona",161,161,0,04,20570,0.0
"East Globe CDP, Arizona",75,50,25,04,21410,33.33333333333333
"East Verde Estates CDP, Arizona",116,57,59,04,21545,50.86206896551724
"El Capitan CDP, Arizona",41,41,0,04,21900,0.0
"Elephant Head CDP, Arizona",275,275,0,04,21980,0.0
"Elfrida CDP, Arizona",286,165,121,04,22080,42.30769230769231
"El Prado Estates CDP, Arizona",229,180,49,04,22400,21.397379912663755
"Flowing Springs CDP, Arizona",52,28,24,04,23955,46.15384615384615
"Fort Apache CDP, Arizona",58,49,9,04,24250,15.517241379310345
"Fort Mohave CDP, Arizona",8120,6417,1703,04,24895,20.972906403940886
"Fort Thomas CDP, Arizona",231,171,60,04,24950,25.97402597402597
"Fort Valley CDP, Arizona",630,587,43,04,25045,6.825396825396825
"Benton city, Arkansas",14289,12926,1363,05,05290,9.538806074602842
"East End CDP, Arkansas",2881,2609,272,05,20470,9.441166261714683
"North Crossett CDP, Arkansas",1439,1185,254,05,50240,17.651146629603893
"Rison city, Arkansas",599,456,143,05,59480,23.87312186978297
"McGehee city, Arkansas",1886,1576,310,05,42770,16.436903499469775
"Cale town, Arkansas",72,53,19,05,10480,26.38888888888889
"Big Flat town, Arkansas",53,17,36,05,05980,67.9245283018868
"Gilbert town, Arkansas",26,9,17,05,26800,65.38461538461539
"Letona town, Arkansas",122,103,19,05,39520,15.573770491803279
"Amity city, Arkansas",388,316,72,05,01360,18.556701030927837
"Fourche town, Arkansas",35,31,4,05,24760,11.428571428571429
"Hazen city, Arkansas",731,623,108,05,30940,14.774281805745554
"Beebe city, Arkansas",3429,2999,430,05,04600,12.540099154272383
"Judsonia city, Arkansas",919,769,150,05,36040,16.32208922742111
"Arkadelphia city, Arkansas",4212,3616,596,05,01870,14.150047483380817
"Bigelow town, Arkansas",109,65,44,05,05920,40.36697247706422
"Harrisburg city, Arkansas",1034,957,77,05,30400,7.446808510638298
"Danville city, Arkansas",921,684,237,05,17320,25.732899022801302
"Rockport city, Arkansas",337,312,25,05,60020,7.418397626112759
"Sunset town, Arkansas",102,71,31,05,68060,30.392156862745097
"Tinsman town, Arkansas",48,16,32,05,69350,66.66666666666666
"Traskwood city, Arkansas",199,167,32,05,69830,16.08040201005025
"Tyronza city, Arkansas",417,374,43,05,70700,10.311750599520384
"Vilonia city, Arkansas",1565,1442,123,05,71960,7.859424920127796
"Wabbaseka town, Arkansas",144,121,23,05,72230,15.972222222222221
"Wilson city, Arkansas",437,386,51,05,75920,11.670480549199084
"Wilton city, Arkansas",166,132,34,05,75980,20.481927710843372
"Winchester town, Arkansas",81,63,18,05,76010,22.22222222222222
"Bethel Heights city, Arkansas",776,739,37,05,05740,4.768041237113402
"Alexander city, Arkansas",1142,990,152,05,00580,13.309982486865149
"Avilla CDP, Arkansas",475,475,0,05,03010,0.0
"Dennard CDP, Arkansas",277,183,94,05,18340,33.935018050541515
"Brookland city, Arkansas",1392,1315,77,05,09100,5.531609195402299
"Center Ridge CDP, Arkansas",138,132,6,05,12790,4.3478260869565215
"Cherokee City CDP, Arkansas",28,28,0,05,13420,0.0
"Guy city, Arkansas",311,254,57,05,29230,18.327974276527332
"Hagarville CDP, Arkansas",92,45,47,05,29320,51.08695652173913
"Holiday Island CDP, Arkansas",1713,1171,542,05,32650,31.64039696438996
"Kirby CDP, Arkansas",333,297,36,05,37060,10.81081081081081
"Landmark CDP, Arkansas",1550,1216,334,05,38540,21.548387096774192
"Lost Bridge Village CDP, Arkansas",480,161,319,05,41555,66.45833333333333
"Maysville CDP, Arkansas",84,84,0,05,44810,0.0
"Midway CDP, Arkansas",367,367,0,05,45530,0.0
"Natural Steps CDP, Arkansas",153,153,0,05,48680,0.0
"New Blaine CDP, Arkansas",53,38,15,05,49070,28.30188679245283
"New Edinburg CDP, Arkansas",147,134,13,05,49220,8.843537414965986
"Reader CDP, Arkansas",95,84,11,05,58400,11.578947368421053
"Roland CDP, Arkansas",349,264,85,05,60470,24.355300859598856
"Rye CDP, Arkansas",73,59,14,05,61730,19.17808219178082
"Staves CDP, Arkansas",76,76,0,05,66800,0.0
"Sulphur Springs CDP, Arkansas",487,408,79,05,67790,16.2217659137577
"Tumbling Shoals CDP, Arkansas",686,432,254,05,70310,37.02623906705539
"Woodlawn CDP, Arkansas",65,65,0,05,76690,0.0
"Yarborough Landing CDP, Arkansas",283,225,58,05,77203,20.49469964664311
"Hermitage city, Arkansas",448,320,128,05,31540,28.57142857142857
"Bella Vista city, Arkansas",13328,12162,1166,05,04840,8.748499399759904
"Magnet Cove CDP, Arkansas",220,206,14,05,43430,6.363636363636363
"Southside city, Arkansas",1693,1445,248,05,65630,14.648552864737152
"Prescott city, Arkansas",1450,1010,440,05,57260,30.344827586206897
"Perry town, Arkansas",103,88,15,05,54650,14.563106796116504
"Havana city, Arkansas",160,136,24,05,30790,15.0
"Hensley CDP, Arkansas",89,42,47,05,31390,52.80898876404494
"Franklin CDP, Arizona",39,25,14,04,25650,35.8974358974359
"Freedom Acres CDP, Arizona",73,49,24,04,25735,32.87671232876712
"Geronimo Estates CDP, Arizona",192,0,192,04,26780,100.0
"Gila Crossing CDP, Arizona",182,168,14,04,27260,7.6923076923076925
"Golden Shores CDP, Arizona",1556,607,949,04,28190,60.98971722365039
"Goodyear Village CDP, Arizona",119,77,42,04,28465,35.294117647058826
"Grand Canyon West CDP, Arizona",11,0,11,04,28985,100.0
"Greer CDP, Arizona",211,18,193,04,29850,91.4691943127962
"Gu Oidak CDP, Arizona",49,18,31,04,30550,63.26530612244898
"Hackberry CDP, Arizona",67,48,19,04,30830,28.35820895522388
"Haigler Creek CDP, Arizona",68,21,47,04,30840,69.11764705882352
"Haivana Nakya CDP, Arizona",67,67,0,04,30850,0.0
"Hard Rock CDP, Arizona",47,20,27,04,31182,57.446808510638306
"Hondah CDP, Arizona",376,255,121,04,33440,32.180851063829785
"Hunter Creek CDP, Arizona",124,9,115,04,34700,92.74193548387096
"Icehouse Canyon CDP, Arizona",293,239,54,04,34980,18.43003412969283
"Indian Wells CDP, Arizona",86,68,18,04,35310,20.930232558139537
"Jakes Corner CDP, Arizona",55,55,0,04,36010,0.0
"Joseph City CDP, Arizona",555,490,65,04,36430,11.711711711711711
"Kaka CDP, Arizona",51,39,12,04,36780,23.52941176470588
"Katherine CDP, Arizona",118,57,61,04,36920,51.69491525423729
"Kino Springs CDP, Arizona",84,76,8,04,37935,9.523809523809524
"Klagetoh CDP, Arizona",75,56,19,04,38250,25.333333333333336
"Kohatk CDP, Arizona",0,0,0,04,38530,
"Rincon Valley CDP, Arizona",2040,1902,138,04,60120,6.764705882352941
"Rio Rico CDP, Arizona",6592,6108,484,04,60180,7.342233009708737
"Rye CDP, Arizona",47,47,0,04,61690,0.0
"Rock House CDP, Arizona",63,55,8,04,60770,12.698412698412698
"Roosevelt CDP, Arizona",40,21,19,04,61300,47.5
"Round Valley CDP, Arizona",210,194,16,04,61448,7.6190476190476195
"Sacate Village CDP, Arizona",71,36,35,04,61715,49.29577464788733
"Sacaton Flats Village CDP, Arizona",203,171,32,04,61800,15.763546798029557
"Saddlebrooke CDP, Arizona",6406,5440,966,04,61940,15.07961286294099
"St. Johns CDP, Arizona",155,137,18,04,62362,11.612903225806452
"Sanders CDP, Arizona",169,116,53,04,63050,31.360946745562128
"San Jose CDP, Arizona",223,159,64,04,63260,28.699551569506728
"San Miguel CDP, Arizona",83,52,31,04,63610,37.34939759036144
"San Simon CDP, Arizona",113,65,48,04,63820,42.47787610619469
"Santa Cruz CDP, Arizona",0,0,0,04,63960,
"San Tan Valley CDP, Arizona",34721,28402,6319,04,64210,18.199360617493735
"Scenic CDP, Arizona",833,637,196,04,64650,23.52941176470588
"Seba Dalkai CDP, Arizona",60,39,21,04,65167,35.0
"Sehili CDP, Arizona",49,26,23,04,65400,46.93877551020408
"Wet Camp Village CDP, Arizona",85,52,33,04,82060,38.82352941176471
"Wheatfields CDP, Arizona",395,226,169,04,82120,42.78481012658228
"Whispering Pines CDP, Arizona",209,77,132,04,82270,63.1578947368421
"Whitecone CDP, Arizona",321,230,91,04,82390,28.34890965732087
"White Hills CDP, Arizona",246,148,98,04,82425,39.83739837398374
"White Mountain Lake CDP, Arizona",1747,1035,712,04,82450,40.75558099599313
"Wide Ruins CDP, Arizona",6,0,6,04,82810,100.0
"Wikieup CDP, Arizona",104,59,45,04,82880,43.269230769230774
"Willow Canyon CDP, Arizona",74,0,74,04,83475,100.0
"Wintersburg CDP, Arizona",21,8,13,04,84000,61.904761904761905
"Wittmann CDP, Arizona",156,156,0,04,84140,0.0
"Woodruff CDP, Arizona",116,101,15,04,84350,12.931034482758621
"York CDP, Arizona",313,254,59,04,85260,18.849840255591054
"Yucca CDP, Arizona",83,57,26,04,85470,31.32530120481928
"Buckeye city, Arizona",20350,17687,2663,04,07940,13.085995085995087
"Gold Canyon CDP, Arizona",7574,5431,2143,04,28140,28.294164246105098
"Ko Vaya CDP, Arizona",7,4,3,04,38950,42.857142857142854
"Morristown CDP, Arizona",119,102,17,04,47750,14.285714285714285
"Red Rock CDP (Apache County), Arizona",57,42,15,04,59690,26.31578947368421
"Waldron city, Arkansas",1770,1241,529,05,72380,29.887005649717512
"Widener town, Arkansas",160,133,27,05,75560,16.875
"Viola town, Arkansas",182,143,39,05,72140,21.428571428571427
"Poyen town, Arkansas",107,92,15,05,57080,14.018691588785046
"Louann town, Arkansas",78,43,35,05,41630,44.871794871794876
"Fredonia (Biscoe) town, Arkansas",191,159,32,05,25060,16.75392670157068
"Bradford city, Arkansas",356,267,89,05,08260,25.0
"McRae city, Arkansas",336,311,25,05,43220,7.440476190476191
"Weiner city, Arkansas",352,322,30,05,73940,8.522727272727272
"Dardanelle city, Arkansas",1949,1629,320,05,17380,16.418676244227807
"Jacksonville city, Arkansas",12049,10286,1763,05,34750,14.631919661382685
"Blue Eye town, Arkansas",20,20,0,05,07150,0.0
"Egypt town, Arkansas",35,24,11,05,20920,31.428571428571427
"Rogers city, Arkansas",25266,23836,1430,05,60410,5.659779941423256
"Alpena town, Arkansas",159,146,13,05,01060,8.176100628930817
"Everton town, Arkansas",79,37,42,05,22450,53.16455696202531
"Hope city, Arkansas",4504,3422,1082,05,33190,24.02309058614565
"Hartman city, Arkansas",244,208,36,05,30520,14.754098360655737
"Barling city, Arkansas",2122,1932,190,05,03640,8.953817153628654
"McCrory city, Arkansas",791,617,174,05,42500,21.997471554993677
"Huttig city, Arkansas",311,227,84,05,34090,27.009646302250808
"Newport city, Arkansas",2732,2081,651,05,49580,23.828696925329428
"Fayetteville city, Arkansas",36956,34480,2476,05,23290,6.699859292131183
"Springdale city, Arkansas",27472,26168,1304,05,66080,4.746651135701805
"Tontitown city, Arkansas",1415,1319,96,05,69740,6.784452296819787
"Lake Hamilton CDP, Arkansas",1645,888,757,05,37930,46.01823708206687
"Marvell city, Arkansas",713,532,181,05,44420,25.385694249649372
"Charleston city, Arkansas",1215,1047,168,05,13300,13.82716049382716
"West Point town, Arkansas",55,48,7,05,74660,12.727272727272727
"Green Forest city, Arkansas",1077,936,141,05,28600,13.09192200557103
"St. Paul town, Arkansas",48,32,16,05,62060,33.33333333333333
"Ashdown city, Arkansas",2148,1925,223,05,02380,10.381750465549349
"Scranton city, Arkansas",115,101,14,05,62960,12.173913043478262
"Delaplaine town, Arkansas",56,43,13,05,18010,23.214285714285715
"Pineville town, Arkansas",116,84,32,05,55580,27.586206896551722
"Black Oak town, Arkansas",131,108,23,05,06610,17.557251908396946
"Subiaco town, Arkansas",166,151,15,05,67520,9.036144578313253
"Hackett city, Arkansas",398,344,54,05,29290,13.5678391959799
"Gentry city, Arkansas",1517,1427,90,05,26290,5.932762030323006
"Earle city, Arkansas",1046,855,191,05,20320,18.26003824091778
"Willisville town, Arkansas",169,163,6,05,75770,3.5502958579881656
"Jasper city, Arkansas",271,206,65,05,34900,23.985239852398525
"Mountainburg city, Arkansas",328,254,74,05,47300,22.5609756097561
"Bay city, Arkansas",894,789,105,05,04180,11.74496644295302
"Oxford city, Arkansas",382,254,128,05,52880,33.50785340314136
"Coy town, Arkansas",54,44,10,05,15790,18.51851851851852
"St. Francis city, Arkansas",110,83,27,05,61970,24.545454545454547
"Norman town, Arkansas",224,186,38,05,50030,16.964285714285715
"Cabot city, Arkansas",10557,9903,654,05,10300,6.1949417448138675
"Osceola city, Arkansas",3308,2886,422,05,52580,12.756952841596132
"Leachville city, Arkansas",945,844,101,05,39010,10.687830687830688
"El Dorado city, Arkansas",8767,7077,1690,05,21070,19.276833580472225
"Lincoln city, Arkansas",1010,927,83,05,39970,8.217821782178218
"Quitman city, Arkansas",448,380,68,05,57950,15.178571428571427
"Mulberry city, Arkansas",840,728,112,05,48200,13.333333333333334
"Mena city, Arkansas",2765,2315,450,05,45170,16.2748643761302
"Hector town, Arkansas",213,187,26,05,31150,12.206572769953052
"Beedeville town, Arkansas",55,34,21,05,04720,38.18181818181819
"Jacksonport town, Arkansas",78,65,13,05,34720,16.666666666666664
"Lonsdale town, Arkansas",50,44,6,05,41450,12.0
"Rockwell CDP, Arkansas",2286,1754,532,05,60110,23.27209098862642
"Beaver town, Arkansas",48,35,13,05,04540,27.083333333333332
"Red Rock CDP (Pinal County), Arizona",1144,1018,126,04,59760,11.013986013986015
"Theba CDP, Arizona",34,25,9,04,73490,26.47058823529412
"Whetstone CDP, Arizona",1155,976,179,04,82156,15.497835497835496
"Why CDP, Arizona",71,45,26,04,82670,36.61971830985916
"Tusayan town, Arizona",176,130,46,04,77490,26.136363636363637
"Seven Mile CDP, Arizona",214,205,9,04,65780,4.205607476635514
"Six Shooter Canyon CDP, Arizona",529,412,117,04,67295,22.117202268431
"So-Hi CDP, Arizona",181,157,24,04,67920,13.259668508287293
"Solomon CDP, Arizona",142,118,24,04,68010,16.901408450704224
"South Komelik CDP, Arizona",59,48,11,04,68670,18.64406779661017
"Stotonic Village CDP, Arizona",220,166,54,04,69872,24.545454545454547
"Summerhaven CDP, Arizona",182,42,140,04,70175,76.92307692307693
"Sunizona CDP, Arizona",212,115,97,04,70460,45.75471698113208
"Sun Valley CDP, Arizona",166,64,102,04,71160,61.44578313253012
"Sunwest CDP, Arizona",42,7,35,04,71220,83.33333333333334
"Sweet Water Village CDP, Arizona",27,22,5,04,71642,18.51851851851852
"Tonopah CDP, Arizona",25,25,0,04,74540,0.0
"Tat Momoli CDP, Arizona",13,13,0,04,72280,0.0
"Tees Toh CDP, Arizona",147,132,15,04,72630,10.204081632653061
"Tolani Lake CDP, Arizona",95,77,18,04,74120,18.947368421052634
"Tonto Village CDP, Arizona",167,118,49,04,74665,29.34131736526946
"Topawa CDP, Arizona",126,94,32,04,74680,25.396825396825395
"Topock CDP, Arizona",15,15,0,04,74750,0.0
"Toyei CDP, Arizona",3,0,3,04,75310,100.0
"Truxton CDP, Arizona",57,35,22,04,75590,38.59649122807017
"Turkey Creek CDP, Arizona",96,96,0,04,77415,0.0
"Upper Santan Village CDP, Arizona",188,161,27,04,78300,14.361702127659576
"Utting CDP, Arizona",74,67,7,04,78400,9.45945945945946
"Vaiva Vo CDP, Arizona",0,0,0,04,78680,
"Valentine CDP, Arizona",30,28,2,04,78820,6.666666666666667
"Valle CDP, Arizona",237,112,125,04,78855,52.742616033755276
"Valle Vista CDP, Arizona",1127,984,143,04,78865,12.688553682342501
"Ventana CDP, Arizona",16,11,5,04,79590,31.25
"Verde Village CDP, Arizona",5247,4748,499,04,79830,9.510196302649133
"Vernon CDP, Arizona",59,10,49,04,79870,83.05084745762711
"Vicksburg CDP, Arizona",412,345,67,04,79940,16.2621359223301
"Village of Oak Creek (Big Park) CDP, Arizona",4046,3120,926,04,80095,22.886801779535343
"Wagon Wheel CDP, Arizona",1223,561,662,04,80380,54.12919051512674
"Wahak Hotrontk CDP, Arizona",39,29,10,04,80430,25.64102564102564
"Wall Lane CDP, Arizona",139,125,14,04,80790,10.071942446043165
"Walnut Creek CDP, Arizona",304,304,0,04,80825,0.0
"Washington Park CDP, Arizona",174,70,104,04,81175,59.77011494252874
"Wellton Hills CDP, Arizona",135,102,33,04,81490,24.444444444444443
"Nazlini CDP, Arizona",155,96,59,04,49010,38.064516129032256
"Rock Point CDP, Arizona",195,148,47,04,60880,24.102564102564102
"Benson city, Arizona",2963,2236,727,04,05770,24.53594330070874
"Douglas city, Arizona",4666,3798,868,04,20050,18.602657522503215
"Huachuca City town, Arizona",1074,899,175,04,34120,16.294227188081937
"Black Canyon City CDP, Arizona",1838,1406,432,04,06610,23.5038084874864
"Camp Verde town, Arizona",4488,3956,532,04,09690,11.853832442067738
"Cornville CDP, Arizona",1664,1369,295,04,15920,17.728365384615387
"Lake Montezuma CDP, Arizona",2667,2177,490,04,39720,18.37270341207349
"Coolidge city, Arizona",4255,3567,688,04,15500,16.16921269095182
"Florence town, Arizona",6705,4559,2146,04,23760,32.00596569724086
"Top-of-the-World CDP, Arizona",142,142,0,04,74820,0.0
"Kykotsmovi Village CDP, Arizona",349,252,97,04,39100,27.793696275071632
"Winslow city, Arizona",2933,2496,437,04,83930,14.899420388680532
"Ajo CDP, Arizona",2131,1333,798,04,00870,37.44720788362271
"Marana town, Arizona",17536,15936,1600,04,44270,9.124087591240876
"Tacna CDP, Arizona",411,284,127,04,71790,30.900243309002434
"Window Rock CDP, Arizona",1061,824,237,04,83720,22.33741753063148
"Sierra Vista city, Arizona",19923,17027,2896,04,66820,14.535963459318376
"Norfork city, Arkansas",365,228,137,05,50000,37.534246575342465
"Moorefield town, Arkansas",80,68,12,05,46730,15.0
"Fargo town, Arkansas",48,36,12,05,23140,25.0
"England city, Arkansas",1248,1106,142,05,21730,11.378205128205128
"Humnoke city, Arkansas",118,99,19,05,33820,16.101694915254235
"Banks town, Arkansas",81,66,15,05,03430,18.51851851851852
"Montrose city, Arkansas",181,150,31,05,46670,17.12707182320442
"Wynne city, Arkansas",3489,3019,470,05,77090,13.47090856979077
"Dumas city, Arkansas",2031,1734,297,05,19990,14.623338257016247
"Rosston town, Arkansas",158,130,28,05,61040,17.72151898734177
"Horatio city, Arkansas",435,371,64,05,33310,14.71264367816092
"Wiederkehr Village city, Arkansas",15,15,0,05,75570,0.0
"Ash Flat city, Arkansas",530,473,57,05,02470,10.754716981132075
"Wilmar city, Arkansas",198,144,54,05,75860,27.27272727272727
"Piney CDP, Arkansas",2227,1945,282,05,55610,12.662775033677592
"London city, Arkansas",432,320,112,05,41270,25.925925925925924
"Menifee town, Arkansas",98,63,35,05,45200,35.714285714285715
"Morrilton city, Arkansas",3116,2819,297,05,46970,9.531450577663671
"Maynard town, Arkansas",223,195,28,05,44780,12.556053811659194
"Hardy city, Arkansas",715,375,340,05,29920,47.55244755244755
"Horseshoe Bend city, Arkansas",1356,1021,335,05,33370,24.705014749262535
"Hindsville town, Arkansas",30,15,15,05,32470,50.0
"Salesville city, Arkansas",220,153,67,05,62240,30.454545454545457
"Donaldson town, Arkansas",169,125,44,05,19450,26.035502958579883
"Friendship town, Arkansas",88,64,24,05,25180,27.27272727272727
"Malvern city, Arkansas",4520,3875,645,05,43610,14.269911504424778
"Chester town, Arkansas",81,68,13,05,13570,16.049382716049383
"Cove town, Arkansas",180,120,60,05,15700,33.33333333333333
"Grannis city, Arkansas",352,267,85,05,27970,24.147727272727273
"Wickes town, Arkansas",359,310,49,05,75500,13.649025069637883
"Atkins city, Arkansas",1258,1146,112,05,02590,8.90302066772655
"Sheridan city, Arkansas",2150,1899,251,05,63710,11.674418604651162
"Heber Springs city, Arkansas",3195,2811,384,05,31090,12.018779342723004
"Denning town, Arkansas",119,76,43,05,18370,36.134453781512605
"Berryville city, Arkansas",2117,1885,232,05,05560,10.95890410958904
"Prattsville town, Arkansas",158,124,34,05,57230,21.518987341772153
"East Camden town, Arkansas",453,383,70,05,20440,15.45253863134658
"Antoine town, Arkansas",63,37,26,05,01540,41.269841269841265
"Diaz city, Arkansas",551,478,73,05,18940,13.248638838475499
"Weldon town, Arkansas",39,36,3,05,74000,7.6923076923076925
"Tollette town, Arkansas",217,135,82,05,69500,37.78801843317972
"Bentonville city, Arkansas",18094,16937,1157,05,05320,6.394384878965403
"Gateway town, Arkansas",159,137,22,05,26110,13.836477987421384
"Little Flock city, Arkansas",1195,1104,91,05,40120,7.615062761506277
"Omaha town, Arkansas",79,46,33,05,52160,41.77215189873418
"South Lead Hill town, Arkansas",65,61,4,05,65480,6.153846153846154
"Monticello city, Arkansas",4310,3641,669,05,46580,15.522041763341068
"Goshen town, Arkansas",755,693,62,05,27670,8.211920529801324
"Lewisville city, Arkansas",607,396,211,05,39640,34.76112026359143
"Bull Shoals city, Arkansas",1210,881,329,05,09790,27.1900826446281
"Pyatt town, Arkansas",123,101,22,05,57890,17.88617886178862
"Summit city, Arkansas",242,178,64,05,67940,26.446280991735538
"Hampton city, Arkansas",746,604,142,05,29650,19.034852546916888
"Des Arc city, Arkansas",859,780,79,05,18550,9.19674039580908
"Caddo Valley town, Arkansas",309,281,28,05,10360,9.06148867313916
"Okolona town, Arkansas",100,72,28,05,51530,28.000000000000004
"Perryville city, Arkansas",666,540,126,05,54710,18.91891891891892
"Waldenburg town, Arkansas",22,22,0,05,72320,0.0
"Gibson CDP, Arkansas",1810,1687,123,05,26710,6.795580110497237
"Elkins city, Arkansas",1165,1076,89,05,21190,7.639484978540772
"Farmington city, Arkansas",2904,2676,228,05,23170,7.851239669421488
"Greenland city, Arkansas",690,631,59,05,28660,8.550724637681158
"Ash Fork CDP, Arizona",328,271,57,04,04440,17.378048780487802
"Yuma city, Arizona",40944,33960,6984,04,85540,17.057444314185226
"Tumacacori-Carmen CDP, Arizona",97,60,37,04,77367,38.144329896907216
"Arizona Village CDP, Arizona",607,470,137,04,03915,22.57001647446458
"Colorado City town, Arizona",759,601,158,04,14870,20.816864295125164
"Kaibab CDP, Arizona",78,61,17,04,36500,21.794871794871796
"Heber-Overgaard CDP, Arizona",3737,1087,2650,04,32310,70.91249665507091
"Cameron CDP, Arizona",357,293,64,04,09340,17.92717086834734
"Amado CDP, Arizona",82,25,57,04,01990,69.51219512195121
"Chilchinbito CDP, Arizona",296,221,75,04,12630,25.33783783783784
"McNary CDP, Arizona",143,131,12,04,43430,8.391608391608392
"Ganado CDP, Arizona",436,283,153,04,26210,35.091743119266056
"Rough Rock CDP, Arizona",187,147,40,04,61370,21.390374331550802
"Springerville town, Arizona",917,675,242,04,68990,26.39040348964013
"Tsaile CDP, Arizona",405,272,133,04,75660,32.839506172839506
"Naco CDP, Arizona",374,291,83,04,48310,22.192513368983956
"St. David CDP, Arizona",768,602,166,04,62280,21.614583333333336
"Bagdad CDP, Arizona",835,637,198,04,05140,23.7125748502994
"Clarkdale town, Arizona",2267,2226,41,04,13890,1.8085575650639611
"Peeples Valley CDP, Arizona",408,274,134,04,53910,32.84313725490196
"Prescott city, Arizona",21743,18759,2984,04,57380,13.723957135629858
"Spring Valley CDP, Arizona",695,597,98,04,69060,14.100719424460431
"Cibecue CDP, Arizona",480,412,68,04,13400,14.166666666666666
"Jeddito CDP, Arizona",122,76,46,04,36150,37.704918032786885
"Keams Canyon CDP, Arizona",85,48,37,04,37130,43.529411764705884
"Pinetop-Lakeside town, Arizona",3810,1920,1890,04,55980,49.60629921259843
"Pinon CDP, Arizona",341,226,115,04,56120,33.724340175953074
"South Tucson city, Arizona",2383,2038,345,04,68850,14.477549307595469
"Winslow West CDP, Arizona",248,202,46,04,83960,18.548387096774192
"Casas Adobes CDP, Arizona",31278,28933,2345,04,10670,7.4972824349382945
"Ak-Chin Village CDP, Arizona",349,317,32,04,01090,9.169054441260744
"Blackwater CDP, Arizona",483,427,56,04,06820,11.594202898550725
"Dudleyville CDP, Arizona",397,224,173,04,20680,43.57682619647355
"Stanfield CDP, Arizona",224,185,39,04,69130,17.410714285714285
"Superior town, Arizona",1631,1218,413,04,71300,25.321888412017167
"Duncan town, Arizona",403,271,132,04,20750,32.754342431761785
"Morenci CDP, Arizona",660,464,196,04,47610,29.6969696969697
"Fort Defiance CDP, Arizona",1271,1073,198,04,24460,15.578284815106217
"Pirtleville CDP, Arizona",631,510,121,04,56400,19.17591125198098
"Eloy city, Arizona",3760,2944,816,04,22360,21.70212765957447
"Nogales city, Arizona",7501,6453,1048,04,49640,13.971470470603919
"Sonoita CDP, Arizona",435,316,119,04,68220,27.35632183908046
"Arizona City CDP, Arizona",5520,4548,972,04,03530,17.608695652173914
"Hayden town, Arizona",325,195,130,04,32020,40.0
"Second Mesa CDP, Arizona",376,332,44,04,65280,11.702127659574469
"Three Points CDP, Arizona",2398,2065,333,04,73700,13.886572143452877
"Tucson Estates CDP, Arizona",6233,5167,1066,04,77035,17.10251885127547
"Dennehotso CDP, Arizona",283,192,91,04,18580,32.15547703180212
"Houck CDP, Arizona",403,279,124,04,33980,30.76923076923077
"Many Farms CDP, Arizona",549,398,151,04,44200,27.504553734061933
"Drexel Heights CDP, Arizona",10224,9437,787,04,20540,7.697574334898278
"Picture Rocks CDP, Arizona",3963,3543,420,04,55300,10.598031794095382
"Summit CDP, Arizona",1743,1464,279,04,70240,16.00688468158348
"Chuichu CDP, Arizona",108,69,39,04,13190,36.11111111111111
"Kearny town, Arizona",957,750,207,04,37200,21.630094043887148
"Burnside CDP, Arizona",170,140,30,04,08535,17.647058823529413
"Chinle CDP, Arizona",1602,1234,368,04,12770,22.971285892634207
"Round Rock CDP, Arizona",257,155,102,04,61440,39.688715953307394
"Sedona city, Arizona",6788,5348,1440,04,65350,21.21390689451974
"Chino Valley town, Arizona",5361,4641,720,04,12840,13.430330162283155
"Paulden CDP, Arizona",2308,1894,414,04,53560,17.937608318890817
"Prescott Valley town, Arizona",19878,18024,1854,04,57450,9.32689405372774
"Siloam Springs city, Arkansas",5929,5358,571,05,64370,9.630629111148592
"Lead Hill town, Arkansas",168,91,77,05,39040,45.83333333333333
"Mountain Pine city, Arkansas",356,287,69,05,47450,19.382022471910112
"Horseshoe Lake town, Arkansas",312,217,95,05,33375,30.448717948717945
"Dierks city, Arkansas",481,405,76,05,18970,15.800415800415802
"Nashville city, Arkansas",1983,1687,296,05,48560,14.926878466969237
"Altus city, Arkansas",409,347,62,05,01210,15.158924205378973
"Ozark city, Arkansas",1628,1395,233,05,52970,14.312039312039312
"Junction City city, Arkansas",238,202,36,05,36130,15.126050420168067
"Smackover city, Arkansas",1013,798,215,05,64730,21.224086870681145
"Prairie Grove city, Arkansas",2073,1948,125,05,57170,6.02990834539315
"Winslow city, Arkansas",211,169,42,05,76190,19.90521327014218
"Avoca town, Arkansas",196,189,7,05,03040,3.571428571428571
"Garfield town, Arkansas",248,225,23,05,25750,9.274193548387096
"Lowell city, Arkansas",3218,3158,60,05,41720,1.8645121193287757
"Pea Ridge city, Arkansas",2066,1957,109,05,54200,5.2758954501452076
"Sulphur Springs city, Arkansas",255,198,57,05,67760,22.35294117647059
"Turrell city, Arkansas",266,231,35,05,70430,13.157894736842104
"Blevins city, Arkansas",161,134,27,05,07030,16.77018633540373
"Patmos town, Arkansas",41,31,10,05,53900,24.390243902439025
"Conway city, Arkansas",26918,23828,3090,05,15190,11.479307526562152
"Twin Groves town, Arkansas",154,136,18,05,70540,11.688311688311687
"Lamar city, Arkansas",857,756,101,05,38290,11.785297549591599
"Flippin city, Arkansas",636,541,95,05,24010,14.937106918238992
"Yellville city, Arkansas",515,421,94,05,77330,18.25242718446602
"Etowah town, Arkansas",135,114,21,05,22120,15.555555555555555
"Keiser city, Arkansas",281,221,60,05,36310,21.352313167259787
"Victoria town, Arkansas",9,3,6,05,71900,66.66666666666666
"Redfield city, Arkansas",739,622,117,05,58580,15.832205683355886
"Gould city, Arkansas",478,383,95,05,27730,19.874476987447697
"Star City city, Arkansas",1005,758,247,05,66440,24.577114427860696
"Alicia town, Arkansas",70,60,10,05,00700,14.285714285714285
"Powhatan town, Arkansas",31,31,0,05,57050,0.0
"Morrison Bluff town, Arkansas",56,45,11,05,47030,19.642857142857142
"Salem CDP, Arkansas",764,736,28,05,62210,3.664921465968586
"Midland town, Arkansas",132,102,30,05,45500,22.727272727272727
"Oden town, Arkansas",78,64,14,05,51290,17.94871794871795
"Allport town, Arkansas",67,44,23,05,00940,34.32835820895522
"Central City town, Arkansas",280,242,38,05,13120,13.571428571428571
"Hartford city, Arkansas",326,231,95,05,30490,29.141104294478527
"Mansfield city, Arkansas",594,487,107,05,43880,18.013468013468014
"Felsenthal town, Arkansas",245,34,211,05,23320,86.12244897959184
"Thornton city, Arkansas",248,188,60,05,69050,24.193548387096776
"Dermott city, Arkansas",1199,892,307,05,18520,25.604670558798997
"Fountain Hill town, Arkansas",104,67,37,05,24670,35.57692307692308
"Hamburg city, Arkansas",1223,1051,172,05,29500,14.063777596075225
"Ulm town, Arkansas",107,105,2,05,70760,1.8691588785046727
"Garner town, Arkansas",95,67,28,05,25900,29.47368421052631
"Georgetown town, Arkansas",51,32,19,05,26440,37.254901960784316
"Rose Bud town, Arkansas",223,202,21,05,60770,9.417040358744394
"Gurdon city, Arkansas",1252,1074,178,05,29200,14.217252396166133
"Higden town, Arkansas",189,49,140,05,32080,74.07407407407408
"Carthage city, Arkansas",226,171,55,05,11830,24.336283185840706
"Magness town, Arkansas",71,58,13,05,43370,18.30985915492958
"Piggott city, Arkansas",2078,1669,409,05,55130,19.682386910490855
"Success town, Arkansas",72,50,22,05,67550,30.555555555555557
"Garland town, Arkansas",179,129,50,05,25780,27.932960893854748
"Hot Springs Village CDP, Arkansas",8896,7041,1855,05,33482,20.85206834532374
"Hickory Ridge city, Arkansas",152,106,46,05,31900,30.263157894736842
"Yarnell CDP, Arizona",560,382,178,04,84980,31.785714285714285
"Higginson town, Arkansas",237,222,15,05,32140,6.329113924050633
"Griffithville town, Arkansas",81,70,11,05,28990,13.580246913580247
"Lepanto city, Arkansas",843,738,105,05,39370,12.455516014234876
"Clifton town, Arizona",1613,1210,403,04,14380,24.984500929944204
"Dolan Springs CDP, Arizona",1599,1104,495,04,19630,30.95684803001876
"San Luis city, Arizona",8668,8116,552,04,63470,6.368251038301801
"Wellton town, Arizona",2060,1270,790,04,81480,38.349514563106794
"Elgin CDP, Arizona",90,67,23,04,22150,25.555555555555554
"Patagonia town, Arizona",563,387,176,04,53490,31.261101243339258
"Tubac CDP, Arizona",1141,731,410,04,75940,35.93339176161262
"Dilkon CDP, Arizona",376,285,91,04,19280,24.20212765957447
"First Mesa CDP, Arizona",564,460,104,04,23512,18.439716312056735
"Oljato-Monument Valley CDP, Arizona",62,31,31,04,51142,50.0
"Shongopovi CDP, Arizona",259,236,23,04,66190,8.880308880308881
"Avra Valley CDP, Arizona",2468,2208,260,04,04880,10.53484602917342
"Flowing Wells CDP, Arizona",6948,6071,877,04,23960,12.622337363270006
"Sells CDP, Arizona",873,662,211,04,65490,24.169530355097365
"Mammoth town, Arizona",728,573,155,04,43990,21.291208791208792
"Oracle CDP, Arizona",1860,1478,382,04,51180,20.537634408602152
"Queen Valley CDP, Arizona",667,480,187,04,58290,28.035982008995504
"Sacaton CDP, Arizona",813,656,157,04,61720,19.311193111931118
"Teec Nos Pos CDP, Arizona",290,208,82,04,72560,28.27586206896552
"Sawmill CDP, Arizona",245,163,82,04,64590,33.46938775510204
"Steamboat CDP, Arizona",95,77,18,04,69585,18.947368421052634
"Bisbee city, Arizona",3545,2520,1025,04,06260,28.913963328631876
"Tombstone city, Arizona",948,721,227,04,74400,23.945147679324894
"Willcox city, Arizona",1738,1339,399,04,83090,22.957422324510933
"Desert Hills CDP, Arizona",1923,1247,676,04,18740,35.15340613624545
"Lake Havasu City city, Arizona",32550,24086,8464,04,39370,26.003072196620586
"Jerome town, Arizona",272,227,45,04,36290,16.544117647058822
"Mayer CDP, Arizona",923,733,190,04,45180,20.585048754062836
"Tonalea CDP, Arizona",126,70,56,04,74470,44.44444444444444
"Peridot CDP, Arizona",361,297,64,04,54190,17.72853185595568
"Rio Verde CDP, Arizona",1793,1122,671,04,60250,37.423312883435585
"Scottsdale city, Arizona",135092,111221,23871,04,65000,17.670180321558643
"Sun City CDP, Arizona",29029,23416,5613,04,70320,19.335836577215886
"Youngtown town, Arizona",2736,2456,280,04,85400,10.23391812865497
"Poston CDP, Arizona",95,69,26,04,57170,27.368421052631582
"Salome CDP, Arizona",1220,567,653,04,62700,53.52459016393443
"Bullhead City city, Arizona",23931,16974,6957,04,08220,29.071079353140277
"Golden Valley CDP, Arizona",4526,3933,593,04,28195,13.102076889085284
"San Carlos CDP, Arizona",1140,987,153,04,62910,13.421052631578947
"Swift Trail Junction CDP, Arizona",844,718,126,04,71650,14.928909952606634
"Avondale city, Arizona",27602,25789,1813,04,04720,6.568364611260054
"Tempe city, Arizona",79006,70981,8025,04,73000,10.157456395716782
"Tolleson city, Arizona",2255,2134,121,04,74190,5.365853658536586
"Parks CDP, Arizona",1371,679,692,04,53350,50.474106491611956
"Congress CDP, Arizona",947,662,285,04,15220,30.095036958817317
"Wilhoit CDP, Arizona",528,438,90,04,82950,17.045454545454543
"Tonto Basin CDP, Arizona",1297,784,513,04,74610,39.55281418658442
"Munds Park CDP, Arizona",3263,499,2764,04,48170,84.70732454796199
"Cibola CDP, Arizona",254,102,152,04,13470,59.84251968503938
"Young CDP, Arizona",594,260,334,04,85330,56.22895622895623
"Central Heights-Midland City CDP, Arizona",1436,1218,218,04,11720,15.181058495821729
"Miami town, Arizona",1144,789,355,04,46350,31.03146853146853
"Pine CDP, Arizona",2783,895,1888,04,55700,67.84045993532159
"Ehrenberg CDP, Arizona",962,461,501,04,21800,52.07900207900208
"Surprise city, Arizona",56021,48095,7926,04,71510,14.148265828885599
"Thatcher town, Arizona",1859,1636,223,04,73420,11.995696611081225
"Carefree town, Arizona",2669,1955,714,04,10180,26.751592356687897
"Paradise Valley town, Arizona",6214,5441,773,04,52930,12.439652397811393
"Grand Canyon Village CDP, Arizona",919,612,307,04,28981,33.405875952121875
"Kaibito CDP, Arizona",446,344,102,04,36640,22.869955156950674
"Moenkopi CDP, Arizona",377,336,41,04,47330,10.875331564986737
"Avalon city, California",2330,1493,837,06,03274,35.922746781115876
"Woodland city, California",21182,20408,774,06,86328,3.654045888018129
"Acton CDP, California",2863,2667,196,06,00212,6.845965770171149
"Arcadia city, California",21198,19316,1882,06,02462,8.87819605623172
"Bell city, California",9095,8825,270,06,04870,2.9686641011544808
"Carson city, California",26113,25469,644,06,11530,2.4662045724351858
"Compton city, California",24939,23974,965,06,15044,3.8694414371065395
"Diamond Bar city, California",18232,17645,587,06,19192,3.2196138657305835
"East San Gabriel CDP, California",5432,5096,336,06,21096,6.185567010309279
"Westminster city, California",28313,27529,784,06,84550,2.7690460212623176
"Marysville city, California",4967,4592,375,06,46170,7.549828870545601
"Plumas Lake CDP, California",2126,2093,33,06,57829,1.5522107243650047
"Ponderosa CDP, California",176,0,176,06,58134,100.0
"Posey CDP, California",28,0,28,06,58422,100.0
"Poso Park CDP, California",60,2,58,06,58436,96.66666666666667
"Potrero CDP, California",113,113,0,06,58478,0.0
"Potter Valley CDP, California",203,203,0,06,58506,0.0
"Princeton CDP, California",165,132,33,06,58758,20.0
"Proberta CDP, California",45,45,0,06,58814,0.0
"Rackerby CDP, California",123,81,42,06,59115,34.146341463414636
"Red Corral CDP, California",893,705,188,06,59896,21.052631578947366
"Redcrest CDP, California",23,13,10,06,59906,43.47826086956522
"Redwood Valley CDP, California",660,578,82,06,60214,12.424242424242424
"Reliez Valley CDP, California",1496,1482,14,06,60279,0.9358288770053476
"Richfield CDP, California",152,93,59,06,60592,38.81578947368421
"Richvale CDP, California",103,78,25,06,60662,24.271844660194176
"Rio Oso CDP, California",144,121,23,06,60970,15.972222222222221
"Smith River CDP, California",225,180,45,06,72380,20.0
"Snelling CDP, California",67,47,20,06,72408,29.850746268656714
"Soda Bay CDP, California",918,489,429,06,72478,46.73202614379085
"Soda Springs CDP, California",159,21,138,06,72492,86.79245283018868
"South Monrovia Island CDP, California",1769,1664,105,06,73167,5.9355568117580555
"Spaulding CDP, California",542,86,456,06,73554,84.13284132841329
"Spring Valley CDP (Lake County), California",495,412,83,06,73690,16.767676767676768
"Spring Valley CDP (San Diego County), California",10391,9885,506,06,73696,4.869598691175056
"Spring Valley Lake CDP, California",3090,2676,414,06,73700,13.398058252427184
"Stevenson Ranch CDP, California",6375,6213,162,06,74130,2.541176470588235
"Stevinson CDP, California",158,106,52,06,74144,32.91139240506329
"Stirling City CDP, California",85,85,0,06,74186,0.0
"Stonyford CDP, California",78,65,13,06,75154,16.666666666666664
"Strawberry CDP (Marin County), California",2655,2533,122,06,75315,4.595103578154426
"Strawberry CDP (Tuolumne County), California",210,0,210,06,75322,100.0
"Sugarloaf Mountain Park CDP, California",0,0,0,06,75588,
"Sugarloaf Saw Mill CDP, California",70,0,70,06,75592,100.0
"Sugarloaf Village CDP, California",24,5,19,06,75596,79.16666666666666
"Sultana CDP, California",292,252,40,06,75672,13.698630136986301
"Sunnyside CDP, California",1625,1556,69,06,75994,4.246153846153846
"Sunny Slopes CDP, California",212,65,147,06,76040,69.33962264150944
"Tarpey Village CDP, California",1377,1230,147,06,77960,10.675381263616558
"Sun Village CDP, California",3452,3301,151,06,77308,4.374275782155272
"Swall Meadows CDP, California",199,124,75,06,77430,37.68844221105528
"Tahoma CDP, California",2132,361,1771,06,77728,83.06754221388368
"Terminous CDP, California",230,190,40,06,78232,17.391304347826086
"Teviston CDP, California",324,292,32,06,78336,9.876543209876543
"Thermal CDP, California",693,472,221,06,78456,31.89033189033189
"Thornton CDP, California",325,290,35,06,78568,10.76923076923077
"Berry Creek CDP, California",908,512,396,06,06070,43.61233480176212
"Bieber CDP, California",165,86,79,06,06336,47.878787878787875
"Big Creek CDP, California",105,53,52,06,06518,49.523809523809526
"Big Lagoon CDP, California",117,55,62,06,06567,52.991452991452995
"Blackhawk CDP, California",3630,3511,119,06,06928,3.278236914600551
"Blacklake CDP, California",643,468,175,06,06935,27.216174183514774
"Bloomfield CDP, California",152,129,23,06,07036,15.131578947368421
"Bodega CDP, California",220,220,0,06,07246,0.0
"Bonny Doon CDP, California",1208,1086,122,06,07470,10.099337748344372
"Boonville CDP, California",346,261,85,06,07512,24.566473988439306
"Boulevard CDP, California",247,202,45,06,07694,18.218623481781375
"Bridgeport CDP, California",378,195,183,06,08240,48.41269841269841
"Brookdale CDP, California",1004,928,76,06,08478,7.569721115537849
"Brooktrails CDP, California",1493,1435,58,06,08530,3.884795713328868
"Buckhorn CDP, California",1784,1034,750,06,08680,42.04035874439462
"Buck Meadows CDP, California",34,34,0,06,08716,0.0
"Buena Vista CDP, California",196,196,0,06,08828,0.0
"Burnt Ranch CDP, California",207,157,50,06,09150,24.154589371980677
"Butte Creek Canyon CDP, California",523,428,95,06,09310,18.164435946462714
"Butte Meadows CDP, California",261,53,208,06,09318,79.6934865900383
"Butte Valley CDP, California",245,231,14,06,09324,5.714285714285714
"California Hot Springs CDP, California",69,20,49,06,09822,71.01449275362319
"California Pines CDP, California",395,268,127,06,09834,32.151898734177216
"Taft Heights CDP, California",918,750,168,06,77588,18.30065359477124
"Biola CDP, California",340,327,13,06,06728,3.823529411764706
"Santa Cruz city, California",24251,22363,1888,06,69112,7.785245969238382
"Ceres city, California",13332,12888,444,06,12524,3.3303330333033303
"Hawaiian Gardens city, California",4016,3855,161,06,32506,4.008964143426295
"La Puente city, California",9654,9318,336,06,40340,3.480422622747048
"Monterey Park city, California",21304,19892,1412,06,48914,6.627863312054075
"Paramount city, California",15041,14452,589,06,55618,3.9159630343727145
"San Fernando city, California",6893,6551,342,06,66140,4.961555200928478
"Santa Monica city, California",50901,45487,5414,06,70000,10.636333274395394
"South El Monte city, California",5306,5161,145,06,72996,2.7327553712777988
"South Gate city, California",24385,23926,459,06,73080,1.8823046955095346
"South Pasadena city, California",10893,10007,886,06,73220,8.13366382080235
"West Covina city, California",31946,30513,1433,06,84200,4.48569460965379
"West Hollywood city, California",25781,23538,2243,06,84410,8.700205577751056
"Garden Grove city, California",49261,48031,1230,06,29000,2.496904244737216
"Laguna Niguel city, California",27140,25360,1780,06,39248,6.5585851142225495
"Yorba Linda city, California",23016,22366,650,06,86832,2.824122349669795
"Challenge-Brownsville CDP, California",513,401,112,06,12612,21.832358674463936
"Linda CDP, California",6848,6506,342,06,41572,4.994158878504673
"Wheatland city, California",1362,1332,30,06,85012,2.2026431718061676
"Santa Maria city, California",28798,27651,1147,06,69196,3.982915480241683
"Buellton city, California",1960,1872,88,06,08758,4.489795918367347
"Guadalupe city, California",2089,2014,75,06,31414,3.590234561991384
"Santa Barbara city, California",39457,36699,2758,06,69070,6.989887725878805
"Moss Beach CDP, California",1202,1163,39,06,49446,3.24459234608985
"Fall River Mills CDP, California",256,139,117,06,23532,45.703125
"French Gulch CDP, California",207,187,20,06,26056,9.66183574879227
"Tahoe Vista CDP, California",1574,493,1081,06,77700,68.67852604828462
"Inyokern CDP, California",366,273,93,06,36658,25.40983606557377
"Burlingame city, California",12755,12029,726,06,09066,5.69188553508428
"San Carlos city, California",11843,11327,516,06,65070,4.35700413746517
"South San Francisco city, California",22164,21083,1081,06,73262,4.877278469590326
"Edwards AFB CDP, California",749,652,97,06,21600,12.950600801068092
"Frazier Park CDP, California",1373,1032,341,06,25534,24.836125273124544
"McKittrick CDP, California",47,47,0,06,44924,0.0
"Squirrel Mountain Valley CDP, California",557,493,64,06,73815,11.490125673249551
"Weedpatch CDP, California",685,631,54,06,83863,7.883211678832117
"Mira Monte CDP, California",3084,2820,264,06,48046,8.560311284046692
"Oxnard city, California",55148,51460,3688,06,54652,6.687459200696308
"Black Point-Green Point CDP, California",658,646,12,06,06982,1.82370820668693
"Lucas Valley-Marinwood CDP, California",2436,2436,0,06,44399,0.0
"Ross town, California",905,807,98,06,62980,10.828729281767956
"San Geronimo CDP, California",176,176,0,06,67070,0.0
"Tamalpais-Homestead Valley CDP, California",4695,4515,180,06,77805,3.8338658146964857
"Woodacre CDP, California",737,722,15,06,86216,2.03527815468114
"Grass Valley city, California",6505,5992,513,06,30798,7.886241352805534
"Penn Valley CDP, California",677,560,117,06,56518,17.2821270310192
"Greenville CDP, California",539,460,79,06,31162,14.656771799628942
"Lake Almanor Peninsula CDP, California",597,175,422,06,39420,70.68676716917923
"Taylorsville CDP, California",117,81,36,06,78008,30.76923076923077
"Tobin CDP, California",0,0,0,06,78792,
"Planada CDP, California",1329,1232,97,06,57582,7.298720842738901
"Winton CDP, California",3270,3132,138,06,86076,4.220183486238533
"Broadmoor CDP, California",1578,1578,0,06,08338,0.0
"Colma town, California",496,477,19,06,14736,3.8306451612903225
"Emerald Lake Hills CDP, California",1619,1582,37,06,22587,2.285361334156887
"Blythe city, California",6314,4970,1344,06,07218,21.286031042128602
"Woodside town, California",2142,1899,243,06,86440,11.344537815126051
"Buttonwillow CDP, California",469,426,43,06,09332,9.168443496801707
"Ripley CDP, California",342,181,161,06,61012,47.07602339181287
"River Pines CDP, California",215,215,0,06,61124,0.0
"Robbins CDP, California",131,112,19,06,62168,14.50381679389313
"Robinson Mill CDP, California",84,35,49,06,62200,58.333333333333336
"Rodriguez Camp CDP, California",32,32,0,06,62496,0.0
"Rolling Hills CDP, California",323,323,0,06,62625,0.0
"Rose Hills CDP, California",1029,997,32,06,62860,3.1098153547133136
"Rough and Ready CDP, California",367,367,0,06,63106,0.0
"Rouse CDP, California",661,582,79,06,63168,11.951588502269288
"Ruth CDP, California",324,89,235,06,63386,72.53086419753086
"Rutherford CDP, California",49,30,19,06,63400,38.775510204081634
"Salmon Creek CDP, California",102,10,92,06,64252,90.19607843137256
"Samoa CDP, California",123,99,24,06,64392,19.51219512195122
"San Miguel CDP (Contra Costa County), California",1153,1082,71,06,68263,6.157849089332177
"San Miguel CDP (San Luis Obispo County), California",871,807,64,06,68266,7.347876004592423
"San Pasqual CDP, California",996,895,101,06,68308,10.140562248995984
"San Simeon CDP, California",347,267,80,06,68434,23.054755043227665
"Santa Margarita CDP, California",525,525,0,06,69182,0.0
"Santa Nella CDP, California",634,608,26,06,70028,4.100946372239748
"Santa Rosa Valley CDP, California",1200,1108,92,06,70130,7.666666666666666
"Sattley CDP, California",68,68,0,06,70336,0.0
"Santa Susana CDP, California",386,379,7,06,70140,1.8134715025906734
"Saranap CDP, California",2520,2464,56,06,70266,2.2222222222222223
"Saticoy CDP, California",270,245,25,06,70322,9.25925925925926
"Scotia CDP, California",251,216,35,06,70518,13.94422310756972
"Seacliff CDP, California",1946,1493,453,06,70644,23.278520041109967
"Sea Ranch CDP, California",1908,601,1307,06,70712,68.50104821802935
"Sequoia Crest CDP, California",93,15,78,06,70966,83.87096774193549
"Sereno del Mar CDP, California",142,41,101,06,71000,71.12676056338029
"Seville CDP, California",155,139,16,06,71078,10.32258064516129
"Shasta CDP, California",754,695,59,06,71218,7.824933687002653
"Shell Ridge CDP, California",464,448,16,06,71362,3.4482758620689653
"Shelter Cove CDP, California",521,314,207,06,71372,39.731285988483684
"Acalanes Ridge CDP, California",287,287,0,06,00135,0.0
"Acampo CDP, California",138,138,0,06,00156,0.0
"Adin CDP, California",128,84,44,06,00310,34.375
"Agua Dulce CDP, California",1260,1161,99,06,00450,7.857142857142857
"Aguanga CDP, California",554,337,217,06,00464,39.16967509025271
"Ahwahnee CDP, California",1063,911,152,06,00478,14.299153339604892
"Airport CDP, California",482,461,21,06,00535,4.356846473029045
"Albion CDP, California",98,84,14,06,00716,14.285714285714285
"Alderpoint CDP, California",75,75,0,06,00786,0.0
"Alhambra Valley CDP, California",277,270,7,06,00898,2.527075812274368
"Alleghany CDP, California",53,30,23,06,00982,43.39622641509434
"Allendale CDP, California",555,519,36,06,00996,6.486486486486487
"Allensworth CDP, California",138,128,10,06,01010,7.246376811594203
"Alta CDP, California",297,204,93,06,01276,31.313131313131315
"Alto CDP, California",371,304,67,06,01416,18.059299191374663
"Anchor Bay CDP, California",349,169,180,06,02028,51.57593123209169
"Antelope CDP, California",14724,14399,325,06,02210,2.2072806302635155
"Anza CDP, California",1313,1041,272,06,02294,20.715917745620715
"Artois CDP, California",117,110,7,06,02910,5.982905982905983
"Aspen Springs CDP, California",17,17,0,06,03026,0.0
"Auburn Lake Trails CDP, California",1480,1365,115,06,03205,7.77027027027027
"Baker CDP, California",221,180,41,06,03512,18.552036199095024
"Ballard CDP, California",181,160,21,06,03694,11.602209944751381
"Ballico CDP, California",140,140,0,06,03708,0.0
"Bangor CDP, California",214,149,65,06,03792,30.373831775700932
"Bass Lake CDP, California",963,229,734,06,04198,76.22014537902389
"Bayview CDP (Contra Costa County), California",610,610,0,06,04470,0.0
"Bayview CDP (Humboldt County), California",1163,1022,141,06,04478,12.123817712811693
"Bear Creek CDP, California",73,73,0,06,04632,0.0
"Bear Valley CDP (Alpine County), California",483,24,459,06,04716,95.03105590062113
"Bear Valley CDP (Mariposa County), California",84,84,0,06,04730,0.0
"Bella Vista CDP, California",1127,969,158,06,04926,14.019520851818989
"Bell Canyon CDP, California",743,723,20,06,04938,2.6917900403768504
"Benbow CDP, California",112,79,33,06,05262,29.464285714285715
"Bend CDP, California",249,202,47,06,05276,18.87550200803213
"Benton CDP, California",135,134,1,06,05346,0.7407407407407408
"Sheridan CDP, California",547,406,141,06,71414,25.776965265082268
"Sierra Brooks CDP, California",116,105,11,06,71774,9.482758620689655
"Sierra City CDP, California",420,76,344,06,71778,81.9047619047619
"Sierra Village CDP, California",563,195,368,06,71834,65.36412078152753
"Sierraville CDP, California",107,55,52,06,71848,48.598130841121495
"Silverado Resort CDP, California",1285,465,820,06,71927,63.81322957198443
"Silver City CDP, California",38,0,38,06,71932,100.0
"Sleepy Hollow CDP, California",758,743,15,06,72184,1.978891820580475
"Silver Lakes CDP, California",2769,2330,439,06,71964,15.854098952690501
"Sisquoc CDP, California",59,59,0,06,72086,0.0
"Sky Valley CDP, California",1901,1023,878,06,72156,46.186217780115726
"Smartsville CDP, California",67,67,0,06,72282,0.0
"Smith Corner CDP, California",117,117,0,06,72338,0.0
"Callender CDP, California",546,546,0,06,09948,0.0
"Calpella CDP, California",238,189,49,06,09990,20.588235294117645
"Calpine CDP, California",180,102,78,06,10004,43.333333333333336
"Camanche North Shore CDP, California",370,318,52,06,10042,14.054054054054054
"Camanche Village CDP, California",240,240,0,06,10044,0.0
"Camino CDP, California",851,684,167,06,10270,19.623971797884842
"Camino Tassajara CDP, California",1126,1077,49,06,10301,4.351687388987567
"Camp Nelson CDP, California",273,0,273,06,10494,100.0
"Campo CDP, California",1294,917,377,06,10508,29.134466769706336
"Camptonville CDP, California",104,77,27,06,10676,25.961538461538463
"Canby CDP, California",48,48,0,06,10732,0.0
"Carmet CDP, California",45,0,45,06,11376,100.0
"Carnelian Bay CDP, California",928,222,706,06,11418,76.07758620689656
"Casmalia CDP, California",36,36,0,06,11754,0.0
"Caspar CDP, California",315,315,0,06,11768,0.0
"Cassel CDP, California",160,86,74,06,11782,46.25
"Castaic CDP, California",5844,5743,101,06,11796,1.728268309377139
"Castle Hill CDP, California",438,438,0,06,11915,0.0
"Catheys Valley CDP, California",503,437,66,06,12062,13.12127236580517
"Cazadero CDP, California",296,131,165,06,12146,55.74324324324324
"Cedar Ridge CDP, California",862,510,352,06,12300,40.835266821345705
"Three Rocks CDP, California",44,44,0,06,78652,0.0
"Timber Cove CDP, California",167,82,85,06,78715,50.898203592814376
"Tonyville CDP, California",165,165,0,06,78932,0.0
"Tooleville CDP, California",117,95,22,06,78949,18.803418803418804
"Topanga CDP, California",3493,3134,359,06,78960,10.277698253650156
"Topaz CDP, California",51,51,0,06,79030,0.0
"Tres Pinos CDP, California",225,212,13,06,80364,5.777777777777778
"Trinity Center CDP, California",397,87,310,06,80476,78.08564231738035
"Trinity Village CDP, California",292,145,147,06,80483,50.34246575342466
"Trona CDP, California",19,15,4,06,80515,21.052631578947366
"Trowbridge CDP, California",91,89,2,06,80560,2.197802197802198
"Tuttle CDP, California",33,33,0,06,80882,0.0
"Tuttletown CDP, California",447,447,0,06,80896,0.0
"Valley Ford CDP, California",39,39,0,06,81778,0.0
"Valley Home CDP, California",73,73,0,06,81792,0.0
"Valley Wells CDP, California",0,0,0,06,81925,
"Verdi CDP, California",117,93,24,06,82334,20.51282051282051
"Victor CDP, California",201,151,50,06,82562,24.875621890547265
"Vina CDP, California",86,86,0,06,82786,0.0
"Vista Santa Rosa CDP, California",1022,855,167,06,83085,16.34050880626223
"Volcano CDP, California",60,35,25,06,83094,41.66666666666667
"Volta CDP, California",90,90,0,06,83108,0.0
"Walker CDP, California",496,327,169,06,83262,34.07258064516129
"Warm Springs CDP, California",580,550,30,06,83460,5.172413793103448
"Warner Valley CDP, California",86,0,86,06,83494,100.0
"Washington CDP, California",83,30,53,06,83570,63.85542168674698
"Waterloo CDP, California",222,222,0,06,83626,0.0
"Waukena CDP, California",64,57,7,06,83724,10.9375
"Wawona CDP, California",363,76,287,06,83766,79.06336088154269
"West Rancho Dominguez CDP, California",6463,6252,211,06,84780,3.2647377378926192
"Weott CDP, California",154,121,33,06,84004,21.428571428571427
"West Goshen CDP, California",142,142,0,06,84345,0.0
"West Park CDP, California",309,275,34,06,84680,11.003236245954692
"Whitley Gardens CDP, California",111,60,51,06,85222,45.94594594594595
"Wilsonia CDP, California",423,0,423,06,85866,100.0
"Woodbridge CDP, California",1541,1485,56,06,86230,3.6340038935756005
"Woodlands CDP, California",838,773,65,06,86380,7.756563245823389
"Yankee Hill CDP, California",184,156,28,06,86678,15.217391304347828
"Yettem CDP, California",102,84,18,06,86734,17.647058823529413
"Yolo CDP, California",168,153,15,06,86804,8.928571428571429
"Zayante CDP, California",395,361,34,06,87090,8.60759493670886
"Cedar Slope CDP, California",21,0,21,06,12314,100.0
"Cedarville CDP, California",256,167,89,06,12328,34.765625
"Centerville CDP, California",142,119,23,06,12412,16.19718309859155
"Chalfant CDP, California",276,253,23,06,12594,8.333333333333332
"Cherokee CDP, California",43,43,0,06,12818,0.0
"Cherokee Strip CDP, California",54,49,5,06,12860,9.25925925925926
"Clarksburg CDP, California",172,172,0,06,13784,0.0
"Clay CDP, California",425,407,18,06,13854,4.235294117647059
"Clear Creek CDP, California",222,74,148,06,13910,66.66666666666666
"Montgomery Creek CDP, California",78,45,33,06,48998,42.30769230769231
"Shasta Lake city, California",4079,3767,312,06,71225,7.648933562147585
"Mountain Ranch CDP, California",920,690,230,06,49628,25.0
"Crestline CDP, California",7396,3729,3667,06,17162,49.58085451595457
"Grand Terrace city, California",4635,4392,243,06,30658,5.242718446601942
"Hesperia city, California",27951,26492,1459,06,33434,5.219849021501914
"Lake Arrowhead CDP, California",12066,3764,8302,06,39444,68.80490634841703
"Yucaipa city, California",19683,18445,1238,06,87042,6.2896916120510085
"Isla Vista CDP, California",5718,5390,328,06,36868,5.736271423574676
"Mission Hills CDP, California",1321,1313,8,06,48186,0.6056018168054504
"Rosemont CDP, California",8966,8383,583,06,62910,6.502342181574838
"Hamilton City CDP, California",724,682,42,06,31890,5.801104972375691
"Big Bear City CDP, California",12872,5446,7426,06,06406,57.6911124922312
"Chino Hills city, California",25588,24374,1214,06,13214,4.744411442863843
"Fontana city, California",55561,53510,2051,06,24680,3.6914382390525726
"Rancho Cucamonga city, California",58649,55950,2699,06,59451,4.601953997510614
"Upland city, California",27795,26875,920,06,81344,3.3099478323439464
"Mono Vista CDP, California",1655,1370,285,06,48641,17.220543806646525
"East Quincy CDP, California",1152,1030,122,06,21026,10.590277777777777
"Johnsville CDP, California",102,0,102,06,37512,100.0
"Keddie CDP, California",79,17,62,06,37904,78.48101265822784
"Madera Acres CDP, California",2597,2494,103,06,45050,3.9661147477859067
"Parkwood CDP, California",601,601,0,06,55842,0.0
"Mokelumne Hill CDP, California",326,228,98,06,48480,30.061349693251532
"Rail Road Flat CDP, California",305,159,146,06,59220,47.868852459016395
"East Sonora CDP, California",1234,1125,109,06,21188,8.833063209076176
"North Edwards CDP, California",653,390,263,06,51812,40.275650842266465
"Fellows CDP, California",23,20,3,06,23812,13.043478260869565
"Maricopa city, California",493,418,75,06,45736,15.212981744421908
"Ridgecrest city, California",12268,10954,1314,06,60704,10.710792305184219
"Tupman CDP, California",64,61,3,06,80784,4.6875
"Weldon CDP, California",1475,1050,425,06,83948,28.8135593220339
"Meiners Oaks CDP, California",1302,1193,109,06,46702,8.37173579109063
"Oak View CDP, California",1642,1586,56,06,53182,3.41047503045067
"Piru CDP, California",602,593,9,06,57372,1.495016611295681
"Hydesville CDP, California",476,436,40,06,36126,8.403361344537815
"Blue Lake city, California",528,453,75,06,07162,14.204545454545455
"Cutten CDP, California",1314,1191,123,06,17722,9.360730593607306
"Ferndale city, California",741,599,142,06,23910,19.163292847503374
"Antioch city, California",35758,34102,1656,06,02252,4.631131495050059
"Clyde CDP, California",293,293,0,06,14232,0.0
"Kensington CDP, California",2380,2333,47,06,38086,1.9747899159663864
"Knightsen CDP, California",596,543,53,06,38772,8.89261744966443
"Orinda city, California",7403,7093,310,06,54232,4.187491557476699
"Lake Isabella CDP, California",2469,1601,868,06,39570,35.1559335763467
"Shingle Springs CDP, California",1453,1453,0,06,71554,0.0
"South Lake Tahoe city, California",17285,8706,8579,06,73108,49.63262944749783
"Lockeford CDP, California",1215,1186,29,06,42104,2.386831275720165
"Morada CDP, California",1349,1231,118,06,49180,8.747220163083766
"Stockton city, California",102490,95191,7299,06,75000,7.121670406868963
"Lakeport city, California",2567,2132,435,06,39710,16.94585118815738
"Rancho Murieta CDP, California",2408,2347,61,06,59506,2.5332225913621262
"El Segundo city, California",6975,6639,336,06,22412,4.817204301075269
"Irwindale city, California",415,381,34,06,36826,8.19277108433735
"Lomita city, California",8431,8078,353,06,42468,4.186929189894437
"Long Beach city, California",175235,166460,8775,06,43000,5.007561274859475
"Pasadena city, California",60396,54394,6002,06,56000,9.93774422147162
"Pomona city, California",40772,39122,1650,06,58072,4.04689492789169
"South San Jose Hills CDP, California",4269,4144,125,06,73290,2.928086202857812
"Val Verde CDP, California",774,751,23,06,81967,2.9715762273901807
"Walnut city, California",9567,9038,529,06,83332,5.529424061879377
"West Carson CDP, California",7952,7522,430,06,84144,5.407444668008048
"West Whittier-Los Nietos CDP, California",7239,7146,93,06,84921,1.28470783257356
"Copperopolis CDP, California",2429,1649,780,06,16210,32.11198023878139
"Murphys CDP, California",1261,1010,251,06,50034,19.904837430610627
"Napa city, California",30408,28457,1951,06,50258,6.41607471717969
"St. Helena city, California",3143,2600,543,06,64140,17.276487432389438
"Colton city, California",18864,16549,2315,06,14890,12.272052586938083
"Loma Linda city, California",9421,8788,633,06,42370,6.719031949899161
"Mentone CDP, California",3531,3381,150,06,46884,4.248088360237893
"Muscoy CDP, California",2776,2680,96,06,50132,3.45821325648415
"Summerland CDP, California",691,512,179,06,75714,25.904486251808972
"Vandenberg AFB CDP, California",961,917,44,06,82072,4.578563995837669
"Dixon Lane-Meadow Creek CDP, California",1224,1181,43,06,19406,3.5130718954248366
"Shoshone CDP, California",23,10,13,06,71680,56.52173913043478
"Belden CDP, California",39,0,39,06,04856,100.0
"Bucks Lake CDP, California",286,8,278,06,08744,97.2027972027972
"Lake San Marcos CDP, California",2843,2408,435,06,39724,15.300738656348928
"Carmel Valley Village CDP, California",2080,1717,363,06,11324,17.451923076923077
"Mount Hebron CDP, California",48,42,6,06,49768,12.5
"Mount Shasta city, California",1961,1710,251,06,49852,12.799592044875062
"Chualar CDP, California",293,255,38,06,13364,12.969283276450511
"Monterey city, California",13441,11596,1845,06,48872,13.726657242764675
"Soledad city, California",4042,3732,310,06,72520,7.669470559129143
"Camp Pendleton South CDP, California",3186,2842,344,06,10561,10.797237915881984
"Coronado city, California",10884,8396,2488,06,16378,22.859242925395076
"Encinitas city, California",26142,23996,2146,06,22678,8.209012317343738
"Escondido city, California",48268,46338,1930,06,22804,3.9985083284992124
"Newman city, California",3342,3251,91,06,51140,2.722920406941951
"Riverdale Park CDP, California",373,348,25,06,61106,6.702412868632708
"Porterville city, California",18219,16933,1286,06,58240,7.058565234096273
"Dorrington CDP, California",1643,110,1533,06,19570,93.30493000608642
"Galt city, California",8394,7911,483,06,28112,5.754110078627591
"La Riviera CDP, California",4677,4350,327,06,40410,6.991661321359846
"Arnold CDP, California",5108,1248,3860,06,02770,75.56773688332028
"San Jacinto city, California",14225,12717,1508,06,67112,10.601054481546573
"Arvin city, California",5193,4873,320,06,02924,6.162141344117081
"California City city, California",4632,4021,611,06,09780,13.190846286701207
"Derby Acres CDP, California",166,130,36,06,18926,21.686746987951807
"Yreka city, California",3664,3394,270,06,86944,7.368995633187773
"El Paso de Robles (Paso Robles) city, California",12590,12109,481,06,22300,3.8204924543288326
"Lake Nacimiento CDP, California",1967,1142,825,06,39670,41.94204372140315
"Etna city, California",331,283,48,06,22972,14.501510574018129
"Live Oak city, California",2444,2444,0,06,41936,0.0
"Sutter CDP, California",1117,1044,73,06,77378,6.535362578334826
"East Foothills CDP, California",2262,2098,164,06,20598,7.250221043324491
"Lexington Hills CDP, California",933,901,32,06,41282,3.429796355841372
"Carmel-by-the-Sea city, California",3874,1873,2001,06,11250,51.65203923593186
"Del Monte Forest CDP, California",2865,1760,1105,06,18590,38.56893542757417
"San Lucas CDP, California",104,100,4,06,68140,3.8461538461538463
"Spreckels CDP, California",171,142,29,06,73612,16.95906432748538
"Fallbrook CDP, California",11289,10606,683,06,23462,6.050137301798211
"Granite Hills CDP, California",1068,999,69,06,30703,6.460674157303371
"Georgetown CDP, California",1119,968,151,06,29350,13.494191242180516
"McCloud CDP, California",745,489,256,06,44784,34.36241610738255
"Montague city, California",651,551,100,06,48690,15.360983102918588
"Cottonwood CDP, California",1318,1244,74,06,16630,5.614567526555387
"Shingletown CDP, California",1182,969,213,06,71568,18.02030456852792
"August CDP, California",2578,2331,247,06,03209,9.581070597362297
"Escalon city, California",2779,2704,75,06,22790,2.6988125224901043
"Ridgemark CDP, California",1276,1200,76,06,60706,5.956112852664576
"Cantua Creek CDP, California",100,84,16,06,10816,16.0
"Sebastopol city, California",3425,3263,162,06,70770,4.72992700729927
"Lemoore Station CDP, California",1821,1683,138,06,41166,7.57825370675453
"Parlier city, California",4206,3963,243,06,55856,5.777460770328103
"Willowbrook CDP, California",5263,5060,203,06,85614,3.857115713471404
"Hidden Valley Lake CDP, California",2537,2284,253,06,33549,9.972408356326369
"Lancaster city, California",52516,47650,4866,06,40130,9.265747581689391
"Rowland Heights CDP, California",15450,14644,806,06,63218,5.216828478964401
"Mi-Wuk Village CDP, California",1224,483,741,06,48298,60.5392156862745
"Carpinteria city, California",6023,5102,921,06,11446,15.291383031711772
"Beckwourth CDP, California",320,146,174,06,04772,54.37499999999999
"Montara CDP, California",1196,1064,132,06,48760,11.036789297658862
"San Anselmo town, California",5491,5293,198,06,64434,3.60590056456019
"Yosemite Lakes CDP, California",2124,1995,129,06,86878,6.073446327683616
"Rancho Mirage city, California",15555,9406,6149,06,59500,39.53069752491161
"Lathrop city, California",5698,5373,325,06,40704,5.703755703755704
"El Granada CDP, California",2212,2119,93,06,21936,4.204339963833634
"San Mateo city, California",41226,38583,2643,06,68252,6.411002765245234
"South Taft CDP, California",655,505,150,06,73388,22.900763358778626
"Boron CDP, California",1203,963,240,06,07568,19.950124688279303
"Eureka city, California",12701,11284,1417,06,23042,11.156601842374616
"Isleton city, California",365,260,105,06,36882,28.767123287671232
"Ladera Heights CDP, California",3115,2909,206,06,39108,6.613162118780096
"Westmont CDP, California",11385,10505,880,06,84592,7.729468599033816
"Fair Oaks CDP, California",13213,12395,818,06,23294,6.190872625444638
"Bakersfield city, California",124227,116854,7373,06,03526,5.935102674941841
"Cabazon CDP, California",1030,973,57,06,09360,5.533980582524272
"Corona city, California",51504,49658,1846,06,16350,3.584187635911774
"Woodcrest CDP, California",4960,4678,282,06,86244,5.685483870967742
"Mammoth Lakes town, California",9767,2679,7088,06,45358,72.570902016996
"French Camp CDP, California",623,543,80,06,26028,12.841091492776885
"Clearlake Oaks CDP, California",1733,1075,658,06,13966,37.96884016156953
"Canyon Lake city, California",4489,3936,553,06,10928,12.319002004900868
"Winters city, California",2488,2448,40,06,86034,1.607717041800643
"Deer Park CDP, California",658,411,247,06,18324,37.537993920972646
"Tara Hills CDP, California",1851,1759,92,06,77924,4.970286331712588
"Mill Valley city, California",6502,6081,421,06,47710,6.474930790525992
"Le Grand CDP, California",551,525,26,06,41040,4.71869328493648
"Brentwood city, California",20122,19543,579,06,08142,2.877447569824073
"Pleasant Hill city, California",14122,13679,443,06,57764,3.136949440589152
"Roseville city, California",51422,49204,2218,06,62938,4.313328925362685
"Williams city, California",1589,1501,88,06,85586,5.538074260541221
"Loyalton city, California",392,322,70,06,44364,17.857142857142858
"Sunnyside-Tahoe City CDP, California",2050,529,1521,06,76015,74.1951219512195
"East Richmond Heights CDP, California",1515,1408,107,06,21061,7.062706270627063
"Chino city, California",21895,20536,1359,06,13210,6.206896551724138
"Salton Sea Beach CDP, California",212,141,71,06,64308,33.490566037735846
"Fillmore city, California",4593,4302,291,06,24092,6.3357282821685175
"El Rio CDP, California",1637,1597,40,06,22370,2.443494196701283
"Vallecito CDP, California",142,120,22,06,81652,15.492957746478872
"San Bernardino city, California",62760,58385,4375,06,65000,6.97100063734863
"Orland city, California",2666,2539,127,06,54274,4.7636909227306825
"Running Springs CDP, California",3781,1694,2087,06,63316,55.19703782068236
"Delleker CDP, California",372,172,200,06,18485,53.76344086021505
"Fairbanks Ranch CDP, California",1153,800,353,06,23150,30.615784908933218
"Imperial Beach city, California",10488,9175,1313,06,36294,12.51906941266209
"Poway city, California",16465,15766,699,06,58520,4.245368964470088
"Valley Center CDP, California",3237,2942,295,06,81736,9.113376583256102
"Concow CDP, California",391,327,64,06,16035,16.36828644501279
"Greenfield city, California",3934,3739,195,06,30994,4.956786985256737
"Pacific Grove city, California",8431,6835,1596,06,54848,18.930138773573717
"San Ardo CDP, California",167,153,14,06,64476,8.383233532934131
"Seaside city, California",11333,10458,875,06,70742,7.720815318097592
"Suisun City city, California",9495,9318,177,06,75630,1.8641390205371249
"Rancho Calaveras CDP, California",2304,2115,189,06,59426,8.203125
"Apple Valley town, California",26119,24161,1958,06,02364,7.496458516788544
"Barstow city, California",9390,8303,1087,06,04030,11.576144834930778
"Big River CDP, California",1063,540,523,06,06635,49.20037629350894
"Shannon Hills city, Arkansas",1279,1188,91,05,63470,7.114933541829554
"Vandervoort town, Arkansas",48,38,10,05,71510,20.833333333333336
"Walnut Ridge city, Arkansas",2183,1818,365,05,72890,16.720109940448925
"Rondo town, Arkansas",171,139,32,05,60590,18.71345029239766
"Murfreesboro city, Arkansas",901,753,148,05,48290,16.426193118756938
"Gum Springs town, Arkansas",91,63,28,05,29140,30.76923076923077
"Lakeview city, Arkansas",479,414,65,05,38050,13.569937369519833
"Maumelle city, Arkansas",7742,7265,477,05,44600,6.161198656677861
"Forrest City city, Arkansas",4911,4064,847,05,24430,17.24699653838322
"Diamond City city, Arkansas",596,407,189,05,18850,31.711409395973156
"Strong city, Arkansas",300,192,108,05,67370,36.0
"Fountain Lake town, Arkansas",188,147,41,05,24700,21.808510638297875
"Oak Grove town, Arkansas",171,154,17,05,50810,9.941520467836257
"Portia town, Arkansas",282,268,14,05,56720,4.964539007092199
"Tuckerman city, Arkansas",973,862,111,05,70100,11.408016443987668
"Springtown town, Arkansas",43,37,6,05,66200,13.953488372093023
"Leola town, Arkansas",206,175,31,05,39310,15.048543689320388
"Cotter city, Arkansas",546,405,141,05,15490,25.82417582417583
"Holland city, Arkansas",262,221,41,05,32710,15.648854961832063
"Stamps city, Arkansas",952,627,325,05,66320,34.13865546218487
"Kensett city, Arkansas",812,681,131,05,36430,16.133004926108374
"Trumann city, Arkansas",3144,2789,355,05,70010,11.291348600508906
"Smithville town, Arkansas",38,38,0,05,64910,0.0
"Ward city, Arkansas",1870,1769,101,05,73130,5.401069518716577
"Mountain View city, Arkansas",1554,1272,282,05,47540,18.146718146718147
"Lake Village city, Arkansas",1161,996,165,05,38170,14.21188630490956
"Portland city, Arkansas",218,173,45,05,56750,20.642201834862387
"Mitchellville city, Arkansas",228,174,54,05,46190,23.684210526315788
"Watson city, Arkansas",151,114,37,05,73550,24.503311258278146
"Gillham town, Arkansas",124,99,25,05,27010,20.161290322580644
"Clarkedale city, Arkansas",153,137,16,05,14050,10.457516339869281
"Midway town, Arkansas",176,155,21,05,45560,11.931818181818182
"Briarcliff city, Arkansas",122,90,32,05,08665,26.229508196721312
"Cherokee Village city, Arkansas",3180,2320,860,05,13450,27.044025157232703
"DeWitt city, Arkansas",1413,1231,182,05,18790,12.880396319886767
"Adona city, Arkansas",86,74,12,05,00250,13.953488372093023
"Bonanza city, Arkansas",246,194,52,05,07540,21.138211382113823
"Campbell Station city, Arkansas",111,95,16,05,10900,14.414414414414415
"Caraway city, Arkansas",566,462,104,05,11410,18.374558303886925
"Cushman city, Arkansas",220,161,59,05,16930,26.81818181818182
"De Valls Bluff city, Arkansas",358,295,63,05,18640,17.59776536312849
"Dyer city, Arkansas",360,285,75,05,20200,20.833333333333336
"Evening Shade city, Arkansas",237,190,47,05,22360,19.831223628691983
"Fisher city, Arkansas",136,117,19,05,23800,13.970588235294118
"Fouke city, Arkansas",349,283,66,05,24640,18.911174785100286
"Fulton town, Arkansas",88,57,31,05,25360,35.22727272727273
"Gilmore city, Arkansas",108,84,24,05,27040,22.22222222222222
"Greenway city, Arkansas",93,72,21,05,28720,22.58064516129032
"Grubbs city, Arkansas",209,171,38,05,29020,18.181818181818183
"Harrell town, Arkansas",159,142,17,05,30310,10.69182389937107
"Helena-West Helena city, Arkansas",5860,4174,1686,05,31190,28.77133105802048
"Jerome town, Arkansas",25,20,5,05,35170,20.0
"Knobel city, Arkansas",120,85,35,05,37240,29.166666666666668
"Knoxville town, Arkansas",398,325,73,05,37300,18.341708542713565
"Lake City city, Arkansas",963,895,68,05,37780,7.061266874350987
"Lexa town, Arkansas",112,90,22,05,39670,19.642857142857142
"Lockesburg city, Arkansas",397,327,70,05,41090,17.632241813602015
"Luxora city, Arkansas",500,417,83,05,42170,16.6
"McCaskill town, Arkansas",44,25,19,05,42410,43.18181818181818
"Mount Vernon town, Arkansas",56,48,8,05,48020,14.285714285714285
"Oakhaven town, Arkansas",30,30,0,05,51080,0.0
"Ogden city, Arkansas",89,72,17,05,51350,19.101123595505616
"Ozan town, Arkansas",55,39,16,05,52940,29.09090909090909
"Patterson city, Arkansas",208,174,34,05,53990,16.346153846153847
"Peach Orchard city, Arkansas",79,46,33,05,54140,41.77215189873418
"Perrytown town, Arkansas",160,143,17,05,54680,10.625
"Pollard city, Arkansas",111,82,29,05,56600,26.126126126126124
"Pottsville city, Arkansas",1133,1054,79,05,56990,6.972639011473963
"Reyno city, Arkansas",251,196,55,05,59180,21.91235059760956
"Golden Hills CDP, California",3634,3315,319,06,30282,8.778205833791965
"Keene CDP, California",166,103,63,06,37946,37.95180722891566
"Calwa CDP, California",555,457,98,06,10032,17.65765765765766
"Lost Hills CDP, California",544,508,36,06,44280,6.61764705882353
"Cloverdale city, California",3226,3144,82,06,14190,2.5418474891506513
"Castro Valley CDP, California",23380,22458,922,06,11964,3.943541488451668
"Clovis city, California",37808,36418,1390,06,14218,3.6764705882352944
"Glen Ellen CDP, California",479,376,103,06,30028,21.50313152400835
"Rohnert Park city, California",16589,15969,620,06,62546,3.7374163602387123
"Chico city, California",40176,35903,4273,06,13014,10.635702907208284
"Oroville East CDP, California",3276,2958,318,06,54388,9.706959706959708
"Garden Acres CDP, California",3061,2890,171,06,28182,5.58640967004247
"Lincoln Village CDP, California",1682,1647,35,06,41558,2.080856123662307
"Carlsbad city, California",47117,43293,3824,06,11194,8.115966636245942
"Chula Vista city, California",85810,78940,6870,06,13392,8.006059899778581
"Hidden Meadows CDP, California",1672,1376,296,06,33532,17.703349282296653
"Jamul CDP, California",2108,1889,219,06,37120,10.388994307400381
"La Mesa city, California",24898,23298,1600,06,40004,6.42621897341152
"Aromas CDP, California",885,863,22,06,02812,2.4858757062146895
"Boronda CDP, California",303,303,0,06,07578,0.0
"Gonzales city, California",2124,2087,37,06,30392,1.7419962335216574
"Marina city, California",8066,7549,517,06,45778,6.409620629804117
"Pajaro CDP, California",681,660,21,06,55044,3.0837004405286343
"Vacaville city, California",34195,32922,1273,06,81554,3.7227664863284105
"Mesa Vista CDP, California",111,69,42,06,47086,37.83783783783784
"Cayucos CDP, California",2461,1367,1094,06,12132,44.453474197480695
"Templeton CDP, California",3026,2930,96,06,78162,3.1725049570389956
"Dunsmuir city, California",1131,762,369,06,20242,32.62599469496021
"Greenview CDP, California",117,117,0,06,31134,0.0
"Macdoel CDP, California",36,36,0,06,44812,0.0
"Weed city, California",1341,1157,184,06,83850,13.72110365398956
"Cambrian Park CDP, California",1048,1021,27,06,10088,2.5763358778625953
"Campbell city, California",17819,16510,1309,06,10345,7.3460912509119485
"Cupertino city, California",21788,20657,1131,06,17610,5.190930787589499
"Gilroy city, California",16585,16208,377,06,29504,2.2731383780524568
"Larkfield-Wikiup CDP, California",3606,3460,146,06,40426,4.048807542983916
"Elmira CDP, California",139,139,0,06,22146,0.0
"Rio Vista city, California",4629,4286,343,06,60984,7.409807733851805
"Vallejo city, California",44869,41991,2878,06,81666,6.414228086206513
"Burbank CDP, California",2098,2020,78,06,08968,3.7178265014299336
"Colfax city, California",931,868,63,06,14498,6.7669172932330826
"San Joaquin city, California",1147,1065,82,06,67126,7.149084568439407
"Shaver Lake CDP, California",2188,257,1931,06,71246,88.25411334552102
"Alum Rock CDP, California",2832,2777,55,06,01458,1.9420903954802262
"Fruitdale CDP, California",438,359,79,06,27080,18.036529680365295
"Los Altos city, California",11040,10585,455,06,43280,4.121376811594203
"Milpitas city, California",23574,22637,937,06,47766,3.974717909561381
"Morgan Hill city, California",15070,14670,400,06,49278,2.6542800265428004
"Magalia CDP, California",5723,5054,669,06,45120,11.689673248296348
"Paradise town, California",12595,11118,1477,06,55520,11.726875744342994
"Willits city, California",2087,2055,32,06,85600,1.5333013895543843
"Talmage CDP, California",191,191,0,06,77784,0.0
"Home Garden CDP, California",452,415,37,06,34281,8.185840707964601
"Guerneville CDP, California",3312,2372,940,06,31470,28.381642512077292
"Manton CDP, California",182,145,37,06,45512,20.32967032967033
"Rancho Tehama Reserve CDP, California",791,630,161,06,59604,20.353982300884958
"Durham CDP, California",2229,2108,121,06,20270,5.428443248093315
"Armona CDP, California",1210,1094,116,06,02700,9.586776859504132
"Huron city, California",1888,1771,117,06,36084,6.197033898305085
"Buena Park city, California",24313,23443,870,06,08786,3.578332579278575
"San Leandro city, California",33068,31727,1341,06,68084,4.0552800290310875
"Bowles CDP, California",40,40,0,06,07750,0.0
"Sanger city, California",7340,7086,254,06,67056,3.4604904632152587
"Alhambra city, California",31394,29427,1967,06,00884,6.265528444925781
"Bradbury city, California",394,292,102,06,07946,25.888324873096447
"Citrus CDP, California",2530,2451,79,06,13560,3.122529644268775
"San Andreas CDP, California",1109,975,134,06,64420,12.082957619477007
"London CDP, California",486,466,20,06,42566,4.11522633744856
"Felton CDP, California",1851,1564,287,06,23826,15.505132360886007
"Twin Lakes CDP, California",2738,2378,360,06,81050,13.148283418553689
"Bret Harte CDP, California",1382,1338,44,06,08172,3.183791606367583
"Modesto city, California",75423,72106,3317,06,48354,4.397862720920674
"Salida CDP, California",4188,4117,71,06,64210,1.6953199617956063
"Turlock city, California",25838,24696,1142,06,80812,4.4198467373635735
"Westley CDP, California",192,173,19,06,84480,9.895833333333332
"Rio Linda CDP, California",5002,4796,206,06,60942,4.118352658936426
"Hickman CDP, California",198,186,12,06,33504,6.0606060606060606
"Hughson city, California",2570,2456,114,06,34904,4.43579766536965
"Cutler CDP, California",1304,1267,37,06,17708,2.8374233128834354
"Goshen CDP, California",1053,1011,42,06,30476,3.9886039886039883
"Springville CDP, California",483,483,0,06,73710,0.0
"Kings Beach CDP, California",2358,1189,1169,06,38548,49.57591178965225
"Lincoln city, California",18210,17607,603,06,41474,3.3113673805601316
"North Auburn CDP, California",5738,5177,561,06,51637,9.776925758103868
"Bluewater CDP, California",535,88,447,06,07172,83.55140186915888
"Rialto city, California",27100,25922,1178,06,60466,4.346863468634686
"Wrightwood CDP, California",2772,1590,1182,06,86594,42.64069264069264
"Orcutt CDP, California",11221,10829,392,06,54120,3.4934497816593884
"Santa Ynez CDP, California",1832,1633,199,06,70182,10.862445414847162
"Carmichael CDP, California",27801,26144,1657,06,11390,5.960217258372001
"Florin CDP, California",16047,14939,1108,06,24498,6.904717392659064
"Vineyard CDP, California",8445,8239,206,06,82852,2.4393132030787448
"Corcoran city, California",4232,3850,382,06,16224,9.026465028355387
"Stratford CDP, California",188,188,0,06,75252,0.0
"Laguna Hills city, California",10980,10555,425,06,39220,3.8706739526411655
"Alpaugh CDP, California",282,266,16,06,01164,5.673758865248227
"Farmersville city, California",2842,2760,82,06,23616,2.8852920478536244
"Strathmore CDP, California",854,794,60,06,75280,7.02576112412178
"Visalia city, California",44819,42209,2610,06,82954,5.8234231018095
"Laguna Woods city, California",12500,11156,1344,06,39259,10.752
"La Habra city, California",19421,18660,761,06,39290,3.918438803357191
"Seal Beach city, California",13774,12500,1274,06,70686,9.249310294758239
"Villa Park city, California",2107,1993,114,06,82744,5.410536307546274
"Meadow Vista CDP, California",1434,1367,67,06,46632,4.672245467224546
"Hayward city, California",49715,47768,1947,06,33000,3.916323041335613
"Livermore city, California",32559,31534,1025,06,41992,3.1481310851070363
"Lemon Grove city, California",8957,8441,516,06,41124,5.760857429943061
"Fetters Hot Springs-Agua Caliente CDP, California",1761,1596,165,06,23973,9.369676320272573
"Healdsburg city, California",5236,4666,570,06,33056,10.886172650878533
"Petaluma city, California",23172,22505,667,06,56784,2.8784740203694112
"Mineral CDP, California",585,118,467,06,47794,79.82905982905983
"Red Bluff city, California",5984,5597,387,06,59892,6.467245989304812
"Laytonville CDP, California",601,520,81,06,40928,13.477537437603992
"Hollister city, California",11104,10700,404,06,34120,3.6383285302593658
"Cerritos city, California",16231,15406,825,06,12552,5.082866120386914
"Artesia city, California",4853,4594,259,06,02896,5.336905007212033
"Azusa city, California",13767,12697,1070,06,03386,7.772208905353381
"Baldwin Park city, California",18803,17859,944,06,03666,5.020475456044248
"Commerce city, California",3684,3549,135,06,14974,3.664495114006515
"Hidden Hills city, California",580,544,36,06,33518,6.206896551724138
"Industry city, California",91,82,9,06,36490,9.89010989010989
"Inglewood city, California",38354,36604,1750,06,36546,4.562757469885801
"Lennox CDP, California",5569,5272,297,06,41180,5.33309391273119
"Canyondam CDP, California",55,41,14,06,10914,25.454545454545453
"Crescent Mills CDP, California",139,114,25,06,17050,17.985611510791365
"La Porte CDP, California",115,0,115,06,40312,100.0
"Little Grass Valley CDP, California",113,0,113,06,41789,100.0
"Mohawk Vista CDP, California",80,33,47,06,48448,58.75
"Chinese Camp CDP, California",73,73,0,06,13182,0.0
"Sonora city, California",2433,2115,318,06,72674,13.070283600493218
"Twain Harte CDP, California",2442,1268,1174,06,80966,48.075348075348074
"Redway CDP, California",709,443,266,06,60088,37.51763046544429
"Rio Dell city, California",1597,1381,216,06,60900,13.525360050093926
"Moss Landing CDP, California",52,34,18,06,49488,34.61538461538461
"Belvedere city, California",1065,916,149,06,05164,13.990610328638498
"Fairfax town, California",3729,3390,339,06,23168,9.090909090909092
"West Puente Valley CDP, California",5123,5034,89,06,84774,1.7372633222721063
"Colusa city, California",2325,2119,206,06,14946,8.860215053763442
"Forest Meadows CDP, California",762,526,236,06,24897,30.971128608923888
"El Cerrito CDP, California",1542,1464,78,06,21810,5.058365758754864
"Idyllwild-Pine Cove CDP, California",4142,1145,2997,06,36203,72.35634958957026
"Winterhaven CDP, California",232,147,85,06,86020,36.637931034482754
"Chowchilla city, California",3947,3578,369,06,13294,9.348872561439068
"Parksdale CDP, California",605,496,109,06,55751,18.016528925619834
"Cathedral City city, California",22679,17984,4695,06,12048,20.70197098637506
"Highgrove CDP, California",1477,1382,95,06,33574,6.431956668923494
"Norco city, California",7438,7152,286,06,51560,3.845119655821457
"Riverside city, California",96797,90866,5931,06,62000,6.12725601000031
"Temecula city, California",35936,33889,2047,06,78120,5.696237756010686
"Gustine city, California",2172,2033,139,06,31568,6.39963167587477
"Pacifica city, California",14632,13954,678,06,54806,4.633679606342263
"Dustin Acres CDP, California",195,154,41,06,20284,21.025641025641026
"Ford City CDP, California",1506,1281,225,06,24764,14.940239043824702
"Kernville CDP, California",826,533,293,06,38310,35.47215496368039
"Lower Lake CDP, California",889,688,201,06,44350,22.609673790776153
"Lagunitas-Forest Knolls CDP, California",773,635,138,06,39283,17.852522639068564
"Larkspur city, California",6264,5895,369,06,40438,5.890804597701149
"Tomales CDP, California",195,144,51,06,78890,26.153846153846157
"Farmington CDP, California",55,29,26,06,23630,47.27272727272727
"Mission Viejo city, California",34664,33358,1306,06,48256,3.7675975075005774
"Amesti CDP, California",822,786,36,06,01651,4.37956204379562
"Corralitos CDP, California",860,845,15,06,16434,1.744186046511628
"Lodi city, California",24033,22933,1100,06,42202,4.577039903466067
"Freedom CDP, California",1142,1125,17,06,25576,1.4886164623467601
"Scotts Valley city, California",4634,4364,270,06,70588,5.826499784203712
"Coto de Caza CDP, California",5124,4863,261,06,16580,5.0936768149882905
"La Palma city, California",5062,4922,140,06,40256,2.7657052548399843
"Newport Beach city, California",44801,37870,6931,06,51182,15.470636816142497
"San Clemente city, California",27868,24530,3338,06,65084,11.977895794459595
"Loma Rica CDP, California",1139,1040,99,06,42412,8.691834942932397
"Firebaugh city, California",2240,2172,68,06,24134,3.0357142857142856
"Berkeley city, California",48248,44978,3270,06,06000,6.77748300447687
"Fremont city, California",77756,74445,3311,06,26000,4.258192293842276
"Auberry CDP, California",934,921,13,06,03190,1.3918629550321198
"Squaw Valley CDP, California",1268,1070,198,06,73794,15.615141955835963
"Avocado Heights CDP, California",4058,3885,173,06,03344,4.263183834401183
"Bellflower city, California",25209,23517,1692,06,04982,6.711888611210282
"Calabasas city, California",9208,8893,315,06,09598,3.420938314509123
"Tiburon town, California",4248,3817,431,06,78666,10.145951035781545
"Prunedale CDP, California",6247,5824,423,06,58870,6.771250200096047
"Grover Beach city, California",5748,5216,532,06,31393,9.255393180236604
"Hornbrook CDP, California",133,104,29,06,34694,21.804511278195488
"Tennant CDP, California",91,14,77,06,78176,84.61538461538461
"Yuba City city, California",23765,22572,1193,06,86972,5.019987376393856
"Los Altos Hills town, California",3356,3053,303,06,43294,9.02860548271752
"Monte Sereno city, California",1251,1139,112,06,48956,8.952837729816148
"Saratoga city, California",11417,10950,467,06,70280,4.090391521415433
"Sunnyvale city, California",58915,55938,2977,06,77000,5.053042518883136
"Cotati city, California",2978,2824,154,06,16560,5.171255876427132
"Forestville CDP, California",1709,1635,74,06,24960,4.330017554125219
"Graton CDP, California",833,768,65,06,30812,7.803121248499399
"Occidental CDP, California",705,491,214,06,53266,30.354609929078013
"Corning city, California",2773,2537,236,06,16322,8.51063829787234
"Gridley city, California",2487,2172,315,06,31260,12.665862484921592
"Tehama city, California",215,191,24,06,78106,11.162790697674419
"Casa de Oro-Mount Helix CDP, California",7242,6894,348,06,11691,4.8053024026512015
"San Diego city, California",540644,503463,37181,06,66000,6.877168709908924
"Bradley CDP, California",41,35,6,06,07974,14.634146341463413
"King City city, California",3431,3235,196,06,38520,5.712620227338968
"Salinas city, California",42231,40623,1608,06,64224,3.8076294665056474
"Fairfield city, California",37892,36348,1544,06,23182,4.074738731130582
"Alpine Village CDP, California",65,35,30,06,01228,46.15384615384615
"Kirkwood CDP, California",702,27,675,06,38646,96.15384615384616
"San Luis Obispo city, California",20550,18708,1842,06,68154,8.963503649635037
"Edgewood CDP, California",15,15,0,06,21530,0.0
"Gazelle CDP, California",31,31,0,06,29252,0.0
"Los Gatos town, California",12925,12108,817,06,44112,6.321083172147002
"Loyola CDP, California",1194,1122,72,06,44378,6.030150753768844
"Stanford CDP, California",3816,3428,388,06,73906,10.167714884696016
"Alpine CDP, California",5601,5426,175,06,01192,3.1244420639171575
"Camp Pendleton North CDP, California",1764,1670,94,06,10559,5.328798185941043
"Dorris city, California",411,351,60,06,19584,14.5985401459854
"Cambria CDP, California",4196,2758,1438,06,10074,34.27073403241182
"Pismo Beach city, California",5806,4245,1561,06,57414,26.885980020668278
"Tulelake city, California",475,282,193,06,80686,40.63157894736842
"Palo Alto city, California",27753,26212,1541,06,55282,5.552552877166432
"Biggs city, California",695,680,15,06,06560,2.158273381294964
"Oroville city, California",7069,6204,865,06,54386,12.23652567548451
"Palermo CDP, California",2191,1987,204,06,55086,9.310816978548608
"Charter Oak CDP, California",2999,2881,118,06,12734,3.934644881627209
"Cudahy city, California",5775,5601,174,06,17498,3.012987012987013
"Florence-Graham CDP, California",15277,14735,542,06,24477,3.5478169797735157
"Gardena city, California",21441,20619,822,06,28168,3.8337764096823843
"Hawthorne city, California",30656,29281,1375,06,32548,4.485255741127349
"Hermosa Beach city, California",10049,8979,1070,06,33364,10.647825654293959
"Patterson city, California",6197,5824,373,06,56112,6.019041471679845
"Tehachapi city, California",3632,3319,313,06,78092,8.61784140969163
"Riverbank city, California",7473,7158,315,06,61068,4.2151746286631875
"Orangevale CDP, California",13718,13086,632,06,54092,4.607085580988482
"McFarland city, California",3285,3228,57,06,44826,1.7351598173515983
"Wofford Heights CDP, California",1888,1139,749,06,86174,39.67161016949153
"East Hemet CDP, California",6269,5766,503,06,20697,8.023608230977826
"Homeland CDP, California",2326,2100,226,06,34316,9.716251074806536
"Valle Vista CDP, California",6287,5628,659,06,81708,10.481946874502942
"Bay Point CDP, California",7226,6899,327,06,04415,4.525325214503183
"Crockett CDP, California",1550,1404,146,06,17274,9.419354838709678
"El Cerrito city, California",10603,9987,616,06,21796,5.809676506649061
"Belmont city, California",10963,10328,635,06,05108,5.792210161452157
"Brisbane city, California",1932,1836,96,06,08310,4.968944099378882
"Menlo Park city, California",12869,11936,933,06,46870,7.249980573471132
"Millbrae city, California",8588,8044,544,06,47486,6.334420121099209
"Foster City city, California",13343,12600,743,06,25338,5.568462864423293
"Highlands-Baywood Park CDP, California",1557,1541,16,06,33633,1.0276172125883107
"Hillsborough town, California",4188,3664,524,06,33798,12.51193887297039
"North Fair Oaks CDP, California",4286,4147,139,06,51840,3.243117125524965
"Johannesburg CDP, California",163,80,83,06,37400,50.920245398773
"Mojave CDP, California",1897,1568,329,06,48452,17.343173431734318
"Oildale CDP, California",14158,12661,1497,06,53448,10.573527334369262
"Rosedale CDP, California",5559,5394,165,06,62854,2.9681597409606044
"Coachella city, California",15405,14674,731,06,14260,4.745212593313859
"Linden CDP, California",653,627,26,06,41670,3.9816232771822357
"Cherry Valley CDP, California",2946,2836,110,06,12916,3.73387644263408
"Lakeland Village CDP, California",3814,3558,256,06,39598,6.712113266911379
"Lakeview CDP, California",590,549,41,06,39836,6.9491525423728815
"Mecca CDP, California",2191,1955,236,06,46660,10.771337288909173
"Moreno Valley city, California",53885,50620,3265,06,49270,6.059200148464322
"Nuevo CDP, California",1954,1852,102,06,52624,5.220061412487206
"Wallace CDP, California",414,414,0,06,83304,0.0
"Adelanto city, California",8626,7805,821,06,00296,9.517737073962438
"Bloomington CDP, California",6275,5715,560,06,07064,8.924302788844622
"Needles city, California",2930,2050,880,06,50734,30.034129692832767
"Redlands city, California",26327,24280,2047,06,59962,7.775287727428115
"Searles Valley CDP, California",977,729,248,06,70728,25.383828045035823
"Nevada City city, California",1585,1469,116,06,50874,7.318611987381704
"Kelseyville CDP, California",1450,1366,84,06,38044,5.793103448275862
"Alta Sierra CDP, California",2991,2856,135,06,01360,4.513540621865597
"Lake Wildwood CDP, California",2733,2192,541,06,39885,19.795096963044273
"McKinleyville CDP, California",6710,6399,311,06,44910,4.634873323397914
"Lake of the Woods CDP, California",436,354,82,06,39696,18.807339449541285
"Lebec CDP, California",827,701,126,06,40956,15.235792019347038
"Mettler CDP, California",45,45,0,06,47164,0.0
"Mountain Mesa CDP, California",433,390,43,06,49600,9.930715935334874
"Onyx CDP, California",396,255,141,06,53910,35.60606060606061
"Randsburg CDP, California",102,56,46,06,59668,45.09803921568628
"Rosamond CDP, California",7507,6765,742,06,62826,9.884108165712002
"Stallion Springs CDP, California",1323,1218,105,06,73868,7.936507936507936
"Wasco city, California",6319,5925,394,06,83542,6.235163791739199
"Camarillo city, California",25601,24797,804,06,10046,3.140502324127964
"Casa Conejo CDP, California",1103,1070,33,06,11656,2.9918404351767904
"Moorpark city, California",11796,11282,514,06,49138,4.357409291285181
"Simi Valley city, California",43272,42029,1243,06,72016,2.8725272693658717
"Thousand Oaks city, California",47749,45777,1972,06,78582,4.129929422605709
"Reedley city, California",7520,7201,319,06,60242,4.242021276595745
"Lake Elsinore city, California",18059,16956,1103,06,39486,6.107757904645883
"La Quinta city, California",25143,15505,9638,06,40354,38.332736745813946
"Palm Springs city, California",37434,23719,13715,06,55254,36.637815889298494
"West Menlo Park CDP, California",1375,1336,39,06,84536,2.8363636363636364
"Bear Valley Springs CDP, California",2946,2346,600,06,04734,20.366598778004075
"Montecito CDP, California",4262,3159,1103,06,48844,25.879868606288127
"Toro Canyon CDP, California",952,664,288,06,79529,30.252100840336134
"Big Pine CDP, California",812,701,111,06,06616,13.669950738916256
"Round Valley CDP, California",188,179,9,06,63148,4.787234042553192
"West Bishop CDP, California",1164,1022,142,06,84120,12.199312714776632
"Wilkerson CDP, California",199,184,15,06,85551,7.537688442211055
"Almanor CDP, California",50,0,50,06,01094,100.0
"Lake Almanor Country Club CDP, California",1411,173,1238,06,39411,87.73919206236711
"Madera city, California",19091,18037,1054,06,45022,5.520926090828139
"Muir Beach CDP, California",183,132,51,06,49950,27.86885245901639
"Novato city, California",22848,22077,771,06,52582,3.374474789915966
"Mariposa CDP, California",900,818,82,06,45932,9.11111111111111
"Cameron Park CDP, California",7752,7320,432,06,10256,5.572755417956656
"Susanville city, California",3529,3029,500,06,77364,14.168319637291019
"Country Club CDP, California",3875,3511,364,06,16651,9.393548387096775
"Kennedy CDP, California",938,892,46,06,38065,4.904051172707889
"Merced city, California",27321,25827,1494,06,46898,5.468321071703086
"Portola Valley town, California",1898,1744,154,06,58380,8.113804004214963
"Tracy city, California",26280,25472,808,06,80238,3.0745814307458144
"Meadow Valley CDP, California",290,200,90,06,46618,31.03448275862069
"Chilcoot-Vinton CDP, California",201,131,70,06,13077,34.82587064676617
"Iron Horse CDP, California",153,60,93,06,36735,60.78431372549019
"Pinole city, California",7089,6669,420,06,57288,5.924672027084215
"Rollingwood CDP, California",805,754,51,06,62700,6.3354037267080745
"Ojai city, California",3414,3073,341,06,53476,9.988283538371412
"Port Hueneme city, California",7754,6593,1161,06,58296,14.97291720402373
"Santa Paula city, California",9374,8979,395,06,70042,4.21378280349904
"Inverness CDP, California",1069,632,437,06,36616,40.879326473339574
"Point Reyes Station CDP, California",333,222,111,06,57960,33.33333333333333
"Lake Almanor West CDP, California",541,64,477,06,39425,88.17005545286506
"Portola city, California",1231,822,409,06,58352,33.22502030869212
"Storrie CDP, California",0,0,0,06,75168,
"Twain CDP, California",111,33,78,06,80952,70.27027027027027
"Livingston city, California",3756,3650,106,06,42006,2.8221512247071354
"East Palo Alto city, California",7929,7478,451,06,20956,5.687980829865053
"Redwood City city, California",31288,30157,1131,06,60102,3.6148043978522115
"San Bruno city, California",15241,14810,431,06,65028,2.8278984318614264
"Lafayette city, California",10007,9407,600,06,39122,5.99580293794344
"Martinez city, California",15229,14668,561,06,46114,3.683761244993105
"Mountain View CDP, California",832,813,19,06,49651,2.283653846153846
"Pittsburg city, California",22053,20958,1095,06,57456,4.965310842062305
"Walnut Creek city, California",32650,31105,1545,06,83346,4.732006125574273
"China Lake Acres CDP, California",1094,794,300,06,13157,27.422303473491773
"Half Moon Bay city, California",5141,4715,426,06,31708,8.286325617584128
"Los Banos city, California",11117,10568,549,06,44028,4.9383826571916885
"Atherton town, California",2448,2221,227,06,03092,9.272875816993464
"Daly City city, California",32765,31620,1145,06,17918,3.494582633908134
"South Oroville CDP, California",1123,896,227,06,73178,20.21371326803206
"Thermalito CDP, California",2549,2243,306,06,78470,12.004707728520989
"Borrego Springs CDP, California",2823,1075,1748,06,07596,61.91994332270634
"Castroville CDP, California",1601,1524,77,06,11978,4.80949406620862
"Bostonia CDP, California",5891,5664,227,06,07624,3.853335596672891
"Del Mar city, California",2695,2140,555,06,18506,20.59369202226345
"El Cajon city, California",33920,32844,1076,06,21712,3.172169811320755
"Del Rey Oaks city, California",741,642,99,06,18688,13.360323886639677
"Elkhorn CDP, California",459,415,44,06,22034,9.586056644880173
"Sand City city, California",167,148,19,06,65112,11.377245508982035
"Benicia city, California",11649,11130,519,06,05290,4.455318053051764
"Dixon city, California",6304,6015,289,06,19402,4.584390862944162
"Arroyo Grande city, California",7685,6999,686,06,02868,8.92648015614834
"Atascadero city, California",12029,11580,449,06,03064,3.7326461052456565
"Oceano CDP, California",3281,2596,685,06,53294,20.87778116427918
"Shandon CDP, California",472,416,56,06,71134,11.864406779661017
"Carrick CDP, California",26,26,0,06,11481,0.0
"Rainbow CDP, California",708,664,44,06,59248,6.214689265536723
"Victorville city, California",35599,32917,2682,06,82590,7.533919492120565
"Keeler CDP, California",34,15,19,06,37918,55.88235294117647
"Blairsden CDP, California",35,16,19,06,06994,54.285714285714285
"Point Arena city, California",249,182,67,06,57876,26.907630522088354
"Crest CDP, California",1061,1003,58,06,17106,5.466540999057493
"Rancho San Diego CDP, California",7941,7488,453,06,59550,5.704571212693615
"San Diego Country Estates CDP, California",3746,3522,224,06,66004,5.97971169247197
"Anaheim city, California",105286,100615,4671,06,02000,4.436487282259749
"Fullerton city, California",48095,45782,2313,06,28000,4.809231728869944
"Brea city, California",15558,14992,566,06,08100,3.637999742897545
"Cypress city, California",16328,15824,504,06,17750,3.0867221950024497
"Dana Point city, California",17317,14561,2756,06,17946,15.914996823930242
"Huntington Beach city, California",81396,76821,4575,06,36000,5.620669320359723
"Rossmoor CDP, California",3968,3911,57,06,63050,1.436491935483871
"Tustin city, California",27489,26132,1357,06,80854,4.936520062570483
"Beale AFB CDP, California",351,338,13,06,04576,3.7037037037037033
"Ashland CDP, California",7979,7723,256,06,02980,3.208422108033588
"Diablo CDP, California",202,202,0,06,19150,0.0
"Alamo CDP, California",5670,5223,447,06,00618,7.883597883597885
"Byron CDP, California",432,427,5,06,09346,1.1574074074074074
"Richmond city, California",39904,37209,2695,06,60620,6.753708901363272
"Vine Hill CDP, California",1372,1296,76,06,82842,5.539358600583091
"Hilmar-Irwin CDP, California",2040,1992,48,06,33861,2.3529411764705883
"Paxton CDP, California",0,0,0,06,56182,
"Valley Ranch CDP, California",66,5,61,06,81869,92.42424242424242
"Oakhurst CDP, California",1356,1188,168,06,52764,12.389380530973451
"Bertsch-Oceanview CDP, California",1044,873,171,06,06150,16.379310344827587
"Crescent City city, California",1899,1735,164,06,17022,8.636124275934701
"Klamath CDP, California",377,250,127,06,38702,33.687002652519894
"Clearlake city, California",8042,5979,2063,06,13945,25.65282268092514
"Middletown CDP, California",489,303,186,06,47332,38.036809815950924
"Arcata city, California",8140,7311,829,06,02476,10.184275184275185
"Humboldt Hill CDP, California",1580,1545,35,06,34928,2.2151898734177213
"Temple City city, California",12049,11319,730,06,78148,6.058594074197029
"Vernon city, California",38,38,0,06,82422,0.0
"View Park-Windsor Hills CDP, California",5127,4693,434,06,82667,8.464989272479032
"West Athens CDP, California",2943,2873,70,06,84116,2.378525314305131
"Angwin CDP, California",914,798,116,06,02168,12.691466083150985
"Calistoga city, California",2407,2082,325,06,09892,13.502285002077274
"Columbia CDP, California",1183,1059,124,06,14904,10.48182586644125
"Jamestown CDP, California",1531,1364,167,06,37106,10.907903331156108
"Hercules city, California",8351,8098,253,06,33308,3.0295772961322
"Tuolumne City CDP, California",829,689,140,06,80763,16.887816646562122
"Millville CDP, California",292,266,26,06,47724,8.904109589041095
"Round Mountain CDP, California",70,57,13,06,63134,18.571428571428573
"Oakley city, California",12090,11812,278,06,53070,2.2994210090984284
"Rodeo CDP, California",3395,3329,66,06,62490,1.9440353460972017
"Coalinga city, California",4560,4146,414,06,14274,9.078947368421053
"Fresno city, California",178081,166758,11323,06,27000,6.35834255198477
"West Sacramento city, California",19215,18174,1041,06,84816,5.4176424668227945
"Interlaken CDP, California",1994,1862,132,06,36613,6.619859578736209
"Live Oak CDP, California",6671,6340,331,06,41922,4.961774846349873
"Rio del Mar CDP, California",5123,4102,1021,06,60928,19.929728674604725
"Nipomo CDP, California",5988,5664,324,06,51476,5.410821643286573
"Oceanside city, California",66475,61656,4819,06,53322,7.249341857841293
"Markleeville CDP, California",245,54,191,06,45988,77.9591836734694
"Morro Bay city, California",6246,4792,1454,06,49362,23.278898495036824
"Fort Jones city, California",397,314,83,06,25128,20.906801007556673
"Grenada CDP, California",187,160,27,06,31246,14.43850267379679
"Norwalk city, California",28475,27180,1295,06,52526,4.5478489903424055
"Lamont CDP, California",3918,3658,260,06,40088,6.636038795303727
"Pine Mountain Club CDP, California",2080,775,1305,06,57240,62.74038461538461
"Shafter city, California",5122,4804,318,06,71106,6.208512299882858
"Valley Acres CDP, California",222,208,14,06,81722,6.306306306306306
"Pearsonville CDP, California",27,13,14,06,56294,51.85185185185185
"Tecopa CDP, California",173,87,86,06,78050,49.71098265895954
"Cromberg CDP, California",240,133,107,06,17288,44.583333333333336
"Graeagle CDP, California",1002,291,711,06,30560,70.95808383233533
"Indian Falls CDP, California",43,30,13,06,36364,30.23255813953488
"Plumas Eureka CDP, California",507,184,323,06,57828,63.70808678500987
"Prattville CDP, California",107,14,93,06,58618,86.91588785046729
"Quincy CDP, California",843,703,140,06,59080,16.6073546856465
"South Dos Palos CDP, California",617,449,168,06,72954,27.22852512155591
"Bethel Island CDP, California",1421,885,536,06,06210,37.71991555242787
"Pleasanton city, California",29701,28498,1203,06,57792,4.050368674455405
"Covelo CDP, California",572,440,132,06,16728,23.076923076923077
"Ukiah city, California",6389,5923,466,06,81134,7.293786195022696
"Atwater city, California",9465,8984,481,06,03162,5.081880612783941
"Oakland city, California",171829,161483,10346,06,53000,6.021102375035646
"Piedmont city, California",4013,3948,65,06,56938,1.619735858460005
"Del Rey CDP, California",411,395,16,06,18674,3.8929440389294405
"Fowler city, California",1987,1925,62,06,25436,3.120281831907398
"Kingsburg city, California",4089,3961,128,06,38562,3.1303497187576426
"Orange Cove city, California",2539,2383,156,06,54008,6.1441512406459236
"Burbank city, California",43595,41505,2090,06,08954,4.794127766945751
"Desert View Highlands CDP, California",941,849,92,06,19052,9.77683315621679
"East Los Angeles CDP, California",33290,31544,1746,06,20802,5.244818263742865
"East Pasadena CDP, California",2197,1889,308,06,20984,14.01911697769686
"Hacienda Heights CDP, California",17065,16232,833,06,31596,4.881336067975388
"Lakeside CDP, California",8006,7554,452,06,39766,5.645765675743193
"National City city, California",17539,16478,1061,06,50398,6.049375677062546
"Rancho Santa Fe CDP, California",1268,935,333,06,59584,26.261829652996845
"San Marcos city, California",30639,29171,1468,06,68196,4.791279088743105
"Las Flores CDP (Tehama County), California",101,59,42,06,40536,41.584158415841586
"La Vina CDP, California",83,53,30,06,40872,36.144578313253014
"Lee Vining CDP, California",78,55,23,06,40998,29.48717948717949
"Leggett CDP, California",92,40,52,06,41026,56.52173913043478
"Lindcove CDP, California",155,123,32,06,41656,20.64516129032258
"Lemon Hill CDP, California",4579,4209,370,06,41142,8.080366892334572
"Leona Valley CDP, California",659,607,52,06,41208,7.890743550834597
"Likely CDP, California",31,0,31,06,41390,100.0
"Linnell Camp CDP, California",177,155,22,06,41740,12.429378531073446
"Litchfield CDP, California",92,68,24,06,41782,26.08695652173913
"Little River CDP, California",136,127,9,06,41866,6.61764705882353
"Lockwood CDP, California",231,193,38,06,42146,16.450216450216452
"Lodoga CDP, California",150,64,86,06,42230,57.333333333333336
"Loleta CDP, California",329,289,40,06,42328,12.158054711246201
"Loma Mar CDP, California",36,36,0,06,42384,0.0
"Lompico CDP, California",524,418,106,06,42510,20.229007633587788
"Long Barn CDP, California",477,65,412,06,42622,86.37316561844864
"Lookout CDP, California",28,21,7,06,43126,25.0
"Los Berros CDP, California",205,168,37,06,44042,18.048780487804876
"Los Olivos CDP, California",435,369,66,06,44168,15.172413793103448
"Los Osos CDP, California",6829,6482,347,06,44182,5.081271049934104
"Los Ranchos CDP, California",640,626,14,06,44242,2.1875
"Lucerne Valley CDP, California",2776,1956,820,06,44420,29.53890489913545
"Lytle Creek CDP, California",494,393,101,06,44644,20.445344129554655
"Mabie CDP, California",43,43,0,06,44672,0.0
"McClellan Park CDP, California",273,273,0,06,44760,0.0
"McClenney Tract CDP, California",49,22,27,06,44770,55.10204081632652
"McGee Creek CDP, California",0,0,0,06,44830,
"McSwain CDP, California",1523,1449,74,06,45006,4.858831254103743
"Madison CDP, California",137,137,0,06,45064,0.0
"Mad River CDP, California",352,173,179,06,45092,50.85227272727273
"Manchester CDP, California",116,75,41,06,45386,35.3448275862069
"Manila CDP, California",420,359,61,06,45414,14.523809523809526
"March ARB CDP, California",755,492,263,06,45680,34.83443708609272
"Marin City CDP, California",1427,1356,71,06,45820,4.9754730203223545
"Martell CDP, California",83,83,0,06,46100,0.0
"Matheny CDP, California",323,298,25,06,46223,7.739938080495357
"Mather CDP, California",1444,1419,25,06,46226,1.7313019390581719
"Maxwell CDP, California",436,346,90,06,46338,20.642201834862387
"Mayfair CDP, California",1594,1463,131,06,46400,8.21831869510665
"Meadowbrook CDP, California",995,888,107,06,46520,10.753768844221105
"Mead Valley CDP, California",4717,4382,335,06,46646,7.101971592113632
"Meridian CDP, California",191,158,33,06,46926,17.277486910994764
"Mesa Verde CDP, California",247,155,92,06,47066,37.24696356275304
"Mexican Colony CDP, California",103,91,12,06,47192,11.650485436893204
"Midpines CDP, California",781,586,195,06,47374,24.96798975672215
"Midway City CDP, California",2607,2506,101,06,47430,3.874184886843115
"Milford CDP, California",104,66,38,06,47472,36.53846153846153
"Minkler CDP, California",512,499,13,06,47822,2.5390625
"Miranda CDP, California",340,279,61,06,48060,17.941176470588236
"Monmouth CDP, California",51,41,10,06,48592,19.607843137254903
"Mono City CDP, California",87,52,35,06,48602,40.229885057471265
"Monson CDP, California",74,63,11,06,48676,14.864864864864865
"Montalvin Manor CDP, California",837,801,36,06,48718,4.301075268817205
"Monterey Park Tract CDP, California",63,63,0,06,48916,0.0
"Monument Hills CDP, California",724,543,181,06,49045,25.0
"Moskowite Corner CDP, California",83,70,13,06,49432,15.66265060240964
"Mountain Center CDP, California",37,0,37,06,49544,100.0
"Mountain Gate CDP, California",399,370,29,06,49558,7.268170426065162
"Mountain House CDP, California",4238,4238,0,06,49582,0.0
"Newcastle CDP, California",626,581,45,06,51000,7.188498402555911
"Mount Hermon CDP, California",401,277,124,06,49796,30.92269326683292
"Mount Laguna CDP, California",168,0,168,06,49810,100.0
"Myers Flat CDP, California",54,0,54,06,50146,100.0
"New Cuyama CDP, California",243,227,16,06,51028,6.584362139917696
"Newell CDP, California",236,92,144,06,51042,61.016949152542374
"New Pine Creek CDP, California",103,39,64,06,51168,62.13592233009708
"Nicasio CDP, California",36,30,6,06,51280,16.666666666666664
"Nicolaus CDP, California",89,89,0,06,51336,0.0
"Nipinnawasee CDP, California",137,119,18,06,51470,13.138686131386862
"Nord CDP, California",108,108,0,06,51574,0.0
"Norris Canyon CDP, California",291,282,9,06,51622,3.0927835051546393
"North Gate CDP, California",212,212,0,06,51890,0.0
"North Richmond CDP, California",1222,1064,158,06,52162,12.92962356792144
"North San Juan CDP, California",164,149,15,06,52246,9.146341463414634
"North Shore CDP, California",915,915,0,06,52302,0.0
"Nubieber CDP, California",15,15,0,06,52610,0.0
"Oak Glen CDP, California",154,154,0,06,52715,0.0
"Oak Hills CDP, California",3157,2856,301,06,52760,9.534368070953436
"Oak Shores CDP, California",752,127,625,06,53160,83.11170212765957
"Oakville CDP, California",76,42,34,06,53196,44.73684210526316
"Oasis CDP, California",1340,1028,312,06,53224,23.283582089552237
"Old Fig Garden CDP, California",2372,2175,197,06,53505,8.30522765598651
"Old Station CDP, California",83,17,66,06,53602,79.51807228915662
"Orick CDP, California",203,130,73,06,54218,35.960591133004925
"Pajaro Dunes CDP, California",596,152,444,06,55048,74.49664429530202
"Panorama Heights CDP, California",164,31,133,06,55506,81.09756097560977
"Paradise CDP, California",103,79,24,06,55528,23.300970873786408
"Paradise Park CDP, California",498,269,229,06,55604,45.98393574297189
"Parklawn CDP, California",298,264,34,06,55728,11.409395973154362
"Parkway CDP, California",5252,4790,462,06,55800,8.796648895658796
"Pasatiempo CDP, California",404,387,17,06,56028,4.207920792079208
"Paskenta CDP, California",66,45,21,06,56042,31.818181818181817
"Patterson Tract CDP, California",724,637,87,06,56120,12.01657458563536
"Patton Village CDP, California",409,289,120,06,56140,29.3398533007335
"Paynes Creek CDP, California",35,35,0,06,56196,0.0
"Penngrove CDP, California",1299,1142,157,06,56476,12.086220169361047
"Penryn CDP, California",434,347,87,06,56546,20.046082949308754
"Pescadero CDP, California",102,79,23,06,56756,22.54901960784314
"Peters CDP, California",209,209,0,06,56798,0.0
"Phelan CDP, California",5027,4531,496,06,56826,9.866719713546846
"Phillipsville CDP, California",71,50,21,06,56854,29.577464788732392
"Philo CDP, California",113,97,16,06,56868,14.15929203539823
"Phoenix Lake CDP, California",1895,1670,225,06,56870,11.87335092348285
"Pierpoint CDP, California",130,0,130,06,57011,100.0
"Pike CDP, California",49,28,21,06,57036,42.857142857142854
"Pine Canyon CDP, California",704,696,8,06,57070,1.1363636363636365
"Pine Flat CDP, California",241,71,170,06,57134,70.53941908713693
"Pine Grove CDP, California",956,812,144,06,57148,15.062761506276152
"Pine Mountain Lake CDP, California",3200,1311,1889,06,57244,59.03125
"Pi�on Hills CDP, California",3046,2582,464,06,57302,15.233092580433356
"Pioneer CDP, California",649,571,78,06,57330,12.01848998459168
"Plainview CDP, California",270,252,18,06,57568,6.666666666666667
"Indian Hills CDP, Colorado",567,552,15,08,38810,2.6455026455026456
"Kittredge CDP, Colorado",353,353,0,08,41065,0.0
"Morrison town, Colorado",107,102,5,08,52075,4.672897196261682
"Avon town, Colorado",3806,2107,1699,08,04110,44.640042038885966
"Dove Creek town, Colorado",383,275,108,08,21265,28.198433420365536
"Sheridan Lake town, Colorado",39,29,10,08,69700,25.64102564102564
"Bayfield town, Colorado",1041,924,117,08,05265,11.239193083573488
"Edwards CDP, Colorado",5561,3263,2298,08,23300,41.32350296709225
"Rockvale town, Colorado",264,245,19,08,64970,7.196969696969697
"Kremmling town, Colorado",742,626,116,08,41560,15.633423180592992
"Mount Crested Butte town, Colorado",1776,446,1330,08,52570,74.88738738738738
"Mancos town, Colorado",732,659,73,08,48115,9.972677595628415
"El Jebel CDP, Colorado",1277,1236,41,08,23795,3.2106499608457324
"Genoa town, Colorado",93,55,38,08,29680,40.86021505376344
"Granby town, Colorado",1599,740,859,08,31605,53.721075672295186
"Lafayette city, Colorado",11934,11418,516,08,41835,4.323780794369029
"Westminster city, Colorado",45713,43828,1885,08,83835,4.123553474941483
"Ramah town, Colorado",69,57,12,08,62660,17.391304347826086
"Wheat Ridge city, Colorado",14832,14203,629,08,84440,4.2408306364617046
"Rico town, Colorado",261,86,175,08,64090,67.04980842911877
"Leadville North CDP, Colorado",1064,950,114,08,44375,10.714285714285714
"Lake City town, Colorado",425,189,236,08,42330,55.529411764705884
"Timnath town, Colorado",975,881,94,08,77510,9.64102564102564
"Wellington town, Colorado",2820,2820,0,08,83230,0.0
"Flagler town, Colorado",264,221,43,08,26765,16.28787878787879
"Kim town, Colorado",46,40,6,08,40570,13.043478260869565
"Grand Junction city, Colorado",27211,25668,1543,08,31660,5.670500900371174
"Redlands CDP, Colorado",4160,3732,428,08,63375,10.288461538461538
"Carbondale town, Colorado",2519,2285,234,08,12045,9.289400555776101
"Larkspur town, Colorado",121,120,1,08,43550,0.8264462809917356
"Louviers CDP, Colorado",130,130,0,08,46410,0.0
"Parker town, Colorado",18393,17893,500,08,57630,2.7184254879573753
"Monte Vista city, Colorado",2020,1644,376,08,51635,18.613861386138613
"Oak Creek town, Colorado",538,402,136,08,55155,25.27881040892193
"Blue River town, Colorado",751,249,502,08,07410,66.84420772303595
"Westcliffe town, Colorado",327,227,100,08,83450,30.58103975535168
"Akron town, Colorado",906,804,102,08,00925,11.258278145695364
"Ordway town, Colorado",540,405,135,08,56145,25.0
"Eagle town, Colorado",2101,1857,244,08,22200,11.613517372679677
"Minturn town, Colorado",560,378,182,08,50920,32.5
"Florence city, Colorado",1850,1750,100,08,27040,5.405405405405405
"Hot Sulphur Springs town, Colorado",298,212,86,08,37600,28.859060402684566
"Manitou Springs city, Colorado",2841,2467,374,08,48445,13.164378739880323
"Coal Creek CDP, Colorado",1321,1068,253,08,15302,19.15215745647237
"Mountain View town, Colorado",348,311,37,08,52350,10.632183908045976
"Superior town, Colorado",4764,4523,241,08,75640,5.058774139378673
"Atwood CDP, Colorado",46,46,0,08,03840,0.0
"Paonia town, Colorado",720,611,109,08,57300,15.138888888888888
"Bennett town, Colorado",830,814,16,08,06090,1.9277108433734942
"Commerce City city, Colorado",16245,15774,471,08,16495,2.899353647276085
"Federal Heights city, Colorado",4683,4342,341,08,26270,7.2816570574418105
"Stonegate CDP, Colorado",3257,3167,90,08,74080,2.7632790911882097
"Rangely town, Colorado",1057,813,244,08,62880,23.084200567644274
"Eldorado Springs CDP, Colorado",304,257,47,08,23630,15.460526315789474
"Cascade-Chipita Park CDP, Colorado",790,592,198,08,12325,25.063291139240505
"Ken Caryl CDP, Colorado",13481,13161,320,08,40377,2.373711149024553
"Aurora city, Colorado",133940,128182,5758,08,04000,4.298939823801702
"Sherrelwood CDP, Colorado",6536,6268,268,08,69810,4.100367197062424
"New Castle town, Colorado",1749,1552,197,08,53395,11.26357918810749
"Nucla town, Colorado",350,260,90,08,54935,25.71428571428571
"Berkley CDP, Colorado",4156,3914,242,08,06172,5.822906641000962
"Ignacio town, Colorado",469,443,26,08,38535,5.543710021321962
"Orchard City town, Colorado",1395,1269,126,08,55980,9.032258064516128
"De Beque town, Colorado",217,190,27,08,19355,12.442396313364055
"Strasburg CDP, Colorado",945,908,37,08,74375,3.9153439153439153
"Glenwood Springs city, Colorado",4423,4004,419,08,30780,9.473208229708343
"Starkville town, Colorado",33,33,0,08,73715,0.0
"The Pinery CDP, Colorado",4281,4132,149,08,77235,3.480495211399206
"Westcreek CDP, Colorado",130,76,54,08,83500,41.53846153846154
"Clifton CDP, Colorado",8463,8048,415,08,15165,4.903698452085549
"Battlement Mesa CDP, Colorado",2192,1785,407,08,05120,18.567518248175183
"Highlands Ranch CDP, Colorado",38404,37340,1064,08,36410,2.7705447349234453
"Roxborough Park CDP, Colorado",3403,3314,89,08,66197,2.615339406406112
"Applewood CDP, Colorado",3350,3324,26,08,02575,0.7761194029850746
"Lakeside town, Colorado",15,8,7,08,42495,46.666666666666664
"Littleton city, Colorado",20938,20043,895,08,45255,4.2745247874677625
"Sterling city, Colorado",5668,5205,463,08,73935,8.168666196189132
"Mountain Village town, Colorado",2016,770,1246,08,52550,61.80555555555556
"Ophir town, Colorado",68,68,0,08,55870,0.0
"Woodland Park city, Colorado",3379,3083,296,08,86090,8.759988162178159
"Walden town, Colorado",384,272,112,08,82130,29.166666666666668
"North Washington CDP, Colorado",214,214,0,08,54750,0.0
"Acres Green CDP, Colorado",1091,1066,25,08,00320,2.2914757103574703
"Perry Park CDP, Colorado",855,845,10,08,58592,1.1695906432748537
"Cedaredge town, Colorado",1195,979,216,08,12635,18.075313807531384
"Delta city, Colorado",3887,3379,508,08,19850,13.06920504244919
"Hotchkiss town, Colorado",440,382,58,08,37545,13.18181818181818
"Burlington city, Colorado",1510,1339,171,08,10600,11.324503311258278
"Seibert town, Colorado",102,77,25,08,69040,24.509803921568626
"Cokedale town, Colorado",92,54,38,08,15550,41.30434782608695
"Palisade town, Colorado",1212,1103,109,08,56970,8.993399339933994
"Durango city, Colorado",8262,7167,1095,08,22035,13.253449527959333
"Orchard Mesa CDP, Colorado",2897,2738,159,08,56035,5.488436313427684
"Stratton town, Colorado",340,265,75,08,74485,22.058823529411764
"Vona town, Colorado",79,37,42,08,81690,53.16455696202531
"Aguilar town, Colorado",321,226,95,08,00760,29.595015576323984
"Trinidad city, Colorado",4572,3878,694,08,78610,15.179352580927382
"Alma town, Colorado",217,159,58,08,01530,26.72811059907834
"Sheridan city, Colorado",2850,2733,117,08,69645,4.105263157894737
"Rocky Ford city, Colorado",1859,1543,316,08,65190,16.99838622915546
"Loghill Village CDP, Colorado",365,275,90,08,45680,24.65753424657534
"Holly town, Colorado",379,341,38,08,37215,10.026385224274406
"Boone town, Colorado",151,99,52,08,07795,34.437086092715234
"Pueblo West CDP, Colorado",11831,11365,466,08,62220,3.938804834756149
"Hayden town, Colorado",832,707,125,08,35070,15.024038461538462
"Bonanza town, Colorado",48,2,46,08,07571,95.83333333333334
"Silverton town, Colorado",510,233,277,08,70580,54.31372549019608
"Silver Cliff town, Colorado",413,283,130,08,70250,31.476997578692494
"St. Mary's CDP, Colorado",246,229,17,08,67142,6.910569105691057
"Pritchett town, Colorado",59,46,13,08,61315,22.033898305084744
"Derby CDP, Colorado",2466,2369,97,08,20275,3.933495539334955
"Todd Creek CDP, Colorado",1340,1340,0,08,77757,0.0
"Welby CDP, Colorado",5507,5303,204,08,83120,3.7043762484111133
"Parachute town, Colorado",641,460,181,08,57400,28.23712948517941
"Silt town, Colorado",1160,1116,44,08,70195,3.793103448275862
"Castle Rock town, Colorado",21040,20511,529,08,12415,2.51425855513308
"Berthoud town, Colorado",2652,2576,76,08,06255,2.865761689291101
"Cherry Hills Village city, Colorado",2328,2159,169,08,13845,7.259450171821307
"Broomfield city, Colorado",27647,26721,926,08,09280,3.349368828444316
"Kersey town, Colorado",606,577,29,08,40515,4.785478547854786
"Northglenn city, Colorado",14083,13494,589,08,54330,4.182347511183697
"Wiggins town, Colorado",396,391,5,08,84770,1.2626262626262625
"Wiley town, Colorado",213,167,46,08,85045,21.5962441314554
"Silver Plume town, Colorado",145,84,61,08,70360,42.06896551724138
"Moffat town, Colorado",72,59,13,08,51250,18.055555555555554
"Saguache town, Colorado",367,236,131,08,67005,35.694822888283376
"Breckenridge town, Colorado",7232,1525,5707,08,08400,78.91316371681415
"Wray city, Colorado",1032,958,74,08,86310,7.170542635658915
"Olney Springs town, Colorado",147,101,46,08,55705,31.292517006802722
"La Jara town, Colorado",387,329,58,08,42055,14.987080103359174
"Gypsum town, Colorado",2299,2077,222,08,33695,9.656372335798173
"Grand Lake town, Colorado",956,143,813,08,31715,85.0418410041841
"Ault town, Colorado",783,734,49,08,03950,6.257982120051085
"Brighton city, Colorado",12566,12244,322,08,08675,2.5624701575680406
"Fort Lupton city, Colorado",2694,2593,101,08,27700,3.749072011878248
"Windsor town, Colorado",9207,8952,255,08,85485,2.7696318018898665
"Grover town, Colorado",88,71,17,08,33310,19.318181818181817
"Longmont city, Colorado",37291,35622,1669,08,45970,4.47561073717519
"Mead town, Colorado",1548,1447,101,08,49600,6.524547803617571
"Salida city, Colorado",3051,2553,498,08,67280,16.32251720747296
"Arboles CDP, Colorado",235,154,81,08,02905,34.46808510638298
"Columbine Valley town, Colorado",489,473,16,08,16385,3.2719836400818
"Green Mountain Falls town, Colorado",548,321,227,08,32650,41.42335766423358
"Antonito town, Colorado",418,313,105,08,02355,25.11961722488038
"Norwood town, Colorado",282,229,53,08,54880,18.79432624113475
"Cripple Creek city, Colorado",730,508,222,08,18530,30.41095890410959
"Meeker town, Colorado",1347,1020,327,08,49875,24.276169265033406
"Red Cliff town, Colorado",138,116,22,08,63265,15.942028985507244
"Black Hawk city, Colorado",73,64,9,08,07025,12.32876712328767
"Limon town, Colorado",770,600,170,08,44980,22.07792207792208
"Laporte CDP, Colorado",1149,1056,93,08,43220,8.093994778067886
"Fruita city, Colorado",5544,5228,316,08,28745,5.6998556998557
"Dolores town, Colorado",522,384,138,08,20770,26.436781609195403
"Olathe town, Colorado",707,638,69,08,55540,9.759547383309759
"Colorado Springs city, Colorado",189012,178623,10389,08,16000,5.496476414195924
"Genesee CDP, Colorado",1673,1614,59,08,29625,3.5265989240884634
"Hooper town, Colorado",47,31,16,08,37380,34.04255319148936
"Pueblo city, Colorado",48702,43870,4832,08,62000,9.921563796148002
"Rye town, Colorado",114,82,32,08,66895,28.07017543859649
"Las Animas city, Colorado",1155,874,281,08,43660,24.329004329004327
"Firestone town, Colorado",4383,4239,144,08,26600,3.285420944558522
"Johnstown town, Colorado",5063,4982,81,08,39855,1.5998419909144777
"Lochbuie town, Colorado",1919,1874,45,08,45530,2.344971339239187
"Nunn town, Colorado",253,237,16,08,55045,6.324110671936759
"Greenwood Village city, Colorado",6953,6273,680,08,33035,9.7799511002445
"Kit Carson town, Colorado",131,90,41,08,41010,31.297709923664126
"Georgetown town, Colorado",827,605,222,08,29735,26.844014510278114
"Center town, Colorado",922,757,165,08,12855,17.895878524945772
"Elizabeth town, Colorado",488,436,52,08,23740,10.655737704918032
"Fraser town, Colorado",1135,488,647,08,28305,57.004405286343605
"Two Buttes town, Colorado",40,28,12,08,79270,30.0
"Lamar city, Colorado",3826,3189,637,08,43110,16.649242028227913
"Colorado City CDP, Colorado",972,803,169,08,15935,17.386831275720166
"Frisco town, Colorado",3690,1272,2418,08,28690,65.52845528455285
"Lyons town, Colorado",878,806,72,08,47070,8.200455580865604
"Montezuma town, Colorado",46,26,20,08,51690,43.47826086956522
"Sanford town, Colorado",362,310,52,08,67830,14.3646408839779
"Gold Hill CDP, Colorado",58,58,0,08,30945,0.0
"Calhan town, Colorado",401,330,71,08,11260,17.70573566084788
"Erie town, Colorado",7896,7772,124,08,24950,1.5704154002026343
"Greeley city, Colorado",37823,35972,1851,08,32155,4.893847658831928
"Keenesburg town, Colorado",448,427,21,08,40185,4.6875
"Thornton city, Colorado",46489,44745,1744,08,77290,3.7514250682957258
"Alamosa city, Colorado",4313,3859,454,08,01090,10.526315789473683
"Alamosa East CDP, Colorado",555,511,44,08,01145,7.927927927927928
"Log Lane Village town, Colorado",470,426,44,08,45695,9.361702127659575
"Ridgway town, Colorado",632,534,98,08,64200,15.50632911392405
"Paoli town, Colorado",31,31,0,08,57245,0.0
"Aspen city, Colorado",6213,3079,3134,08,03620,50.44262031224851
"Basalt town, Colorado",2375,1810,565,08,04935,23.789473684210527
"South Fork town, Colorado",598,157,441,08,72395,73.7458193979933
"Yampa town, Colorado",235,168,67,08,86475,28.510638297872344
"Dillon town, Colorado",1426,423,1003,08,20440,70.33660589060308
"Eckley town, Colorado",116,104,12,08,23025,10.344827586206897
"Yuma city, Colorado",1584,1536,48,08,86750,3.0303030303030303
"Cheyenne Wells town, Colorado",440,383,57,08,14175,12.954545454545455
"Downieville-Lawson-Dumont CDP, Colorado",309,261,48,08,21390,15.53398058252427
"Empire town, Colorado",185,144,41,08,24620,22.162162162162165
"Aristocrat Ranchettes CDP, Colorado",427,422,5,08,03015,1.1709601873536302
"Frederick town, Colorado",4067,3974,93,08,28360,2.2866978116547823
"Gilcrest town, Colorado",348,326,22,08,29955,6.321839080459771
"Hudson town, Colorado",607,582,25,08,37820,4.118616144975288
"Milliken town, Colorado",2440,2430,10,08,50480,0.4098360655737705
"Platteville town, Colorado",951,903,48,08,60160,5.047318611987381
"Poncha Springs town, Colorado",354,331,23,08,60600,6.497175141242938
"Englewood city, Colorado",16280,15258,1022,08,24785,6.277641277641277
"Fort Garland CDP, Colorado",286,225,61,08,27535,21.328671328671327
"Blanca town, Colorado",186,146,40,08,07190,21.50537634408602
"San Luis town, Colorado",430,356,74,08,68105,17.209302325581397
"Cheraw town, Colorado",98,84,14,08,13460,14.285714285714285
"Fowler town, Colorado",587,539,48,08,27975,8.17717206132879
"Haxtun town, Colorado",430,343,87,08,34960,20.232558139534884
"Holyoke city, Colorado",987,903,84,08,37270,8.51063829787234
"Hartman town, Colorado",52,36,16,08,34520,30.76923076923077
"Beulah Valley CDP, Colorado",430,256,174,08,06602,40.46511627906977
"Crestone town, Colorado",112,57,55,08,18420,49.107142857142854
"Franktown CDP, Colorado",40,40,0,08,28250,0.0
"Crawford town, Colorado",178,120,58,08,17925,32.58426966292135
"Denver city, Colorado",314045,294358,19687,08,20000,6.268846821315417
"Branson town, Colorado",62,40,22,08,08345,35.483870967741936
"Tabernash CDP, Colorado",216,131,85,08,76190,39.351851851851855
"Gunnison city, Colorado",2641,2425,216,08,33640,8.178720181749338
"Red Feather Lakes CDP, Colorado",1028,240,788,08,63320,76.65369649805449
"Victor city, Colorado",382,232,150,08,80865,39.26701570680628
"Eads town, Colorado",393,305,88,08,22145,22.391857506361323
"Fruitvale CDP, Colorado",3421,3222,199,08,28800,5.817012569424145
"Cortez city, Colorado",3997,3636,361,08,17375,9.03177383037278
"Montrose city, Colorado",8762,8201,561,08,51745,6.402647797306551
"Arvada city, Colorado",48353,47032,1321,08,03455,2.731991810228941
"Rifle city, Colorado",3581,3372,209,08,64255,5.836358559061715
"Sedalia CDP, Colorado",64,57,7,08,68875,10.9375
"East Pleasant View CDP, Colorado",73,73,0,08,22575,0.0
"Peetz town, Colorado",89,80,9,08,58235,10.112359550561797
"Monument town, Colorado",2445,2358,87,08,51800,3.5582822085889574
"Palmer Lake town, Colorado",1197,1101,96,08,57025,8.020050125313283
"Evergreen CDP, Colorado",3935,3663,272,08,25390,6.912325285895807
"Woodmoor CDP, Colorado",3118,3014,104,08,86117,3.3354714560615775
"Padroni CDP, Colorado",81,55,26,08,56695,32.098765432098766
"Meridian CDP, Colorado",1903,1777,126,08,50012,6.621124540199684
"Cimarron Hills CDP, Colorado",6837,6347,490,08,14587,7.166886061137926
"Lone Tree city, Colorado",6156,5809,347,08,45955,5.636777128005198
"Centennial city, Colorado",40690,39701,989,08,12815,2.430572622265913
"Ca�on City city, Colorado",8112,7476,636,08,11810,7.840236686390532
"Aetna Estates CDP, Colorado",371,371,0,08,00620,0.0
"Alpine CDP, Colorado",297,166,131,08,01640,44.107744107744104
"Altona CDP, Colorado",250,233,17,08,01740,6.800000000000001
"Amherst CDP, Colorado",53,53,0,08,01915,0.0
"Bark Ranch CDP, Colorado",61,61,0,08,04620,0.0
"Blende CDP, Colorado",378,357,21,08,07245,5.555555555555555
"Blue Sky CDP, Colorado",10,10,0,08,07420,0.0
"Bonanza Mountain Estates CDP, Colorado",119,119,0,08,07580,0.0
"Brandon CDP, Colorado",13,13,0,08,08290,0.0
"Brick Center CDP, Colorado",50,50,0,08,08530,0.0
"Capulin CDP, Colorado",98,64,34,08,11975,34.69387755102041
"Cathedral CDP, Colorado",26,13,13,08,12450,50.0
"Catherine CDP, Colorado",136,110,26,08,12460,19.11764705882353
"Cattle Creek CDP, Colorado",319,247,72,08,12470,22.570532915360502
"Chacra CDP, Colorado",169,169,0,08,12945,0.0
"Cherry Creek CDP, Colorado",4620,4508,112,08,13590,2.4242424242424243
"City of Creede town, Colorado",287,157,130,08,14765,45.29616724738676
"Coaldale CDP, Colorado",194,168,26,08,15440,13.402061855670103
"Colona CDP, Colorado",16,16,0,08,15825,0.0
"Comanche Creek CDP, Colorado",94,94,0,08,16465,0.0
"Conejos CDP, Colorado",55,27,28,08,16715,50.90909090909091
"Copper Mountain CDP, Colorado",1719,175,1544,08,17150,89.8196625945317
"Cotopaxi CDP, Colorado",0,0,0,08,17485,
"Crisman CDP, Colorado",101,69,32,08,18585,31.683168316831683
"Dakota Ridge CDP, Colorado",12817,12581,236,08,19150,1.841304517437778
"Divide CDP, Colorado",46,46,0,08,20605,0.0
"Dotsero CDP, Colorado",288,281,7,08,21155,2.430555555555556
"Dove Valley CDP, Colorado",2445,2268,177,08,21330,7.2392638036809815
"Elbert CDP, Colorado",74,69,5,08,23520,6.756756756756757
"Ellicott CDP, Colorado",335,275,60,08,24235,17.91044776119403
"El Moro CDP, Colorado",157,113,44,08,24290,28.02547770700637
"Fairmount CDP, Colorado",3313,3215,98,08,25550,2.9580440688198006
"Florissant CDP, Colorado",82,82,0,08,27095,0.0
"Floyd Hill CDP, Colorado",548,548,0,08,27175,0.0
"Fulford CDP, Colorado",91,0,91,08,28830,100.0
"Garfield CDP, Colorado",6,6,0,08,29295,0.0
"Gerrard CDP, Colorado",283,39,244,08,29845,86.21908127208481
"Glendale CDP, Colorado",168,92,76,08,30350,45.23809523809524
"Goldfield CDP, Colorado",54,21,33,08,30890,61.111111111111114
"Guffey CDP, Colorado",38,9,29,08,33420,76.31578947368422
"Hasty CDP, Colorado",99,67,32,08,34685,32.323232323232325
"Heeney CDP, Colorado",38,25,13,08,35400,34.21052631578947
"Hidden Lake CDP, Colorado",0,0,0,08,35860,
"Hoehne CDP, Colorado",41,41,0,08,36940,0.0
"Holly Hills CDP, Colorado",1072,1072,0,08,37220,0.0
"Inverness CDP, Colorado",915,778,137,08,38910,14.972677595628415
"Howard CDP, Colorado",627,383,244,08,37655,38.91547049441787
"Idalia CDP, Colorado",27,14,13,08,38425,48.148148148148145
"Idledale CDP, Colorado",88,88,0,08,38480,0.0
"Jackson Lake CDP, Colorado",249,80,169,08,39160,67.8714859437751
"Jansen CDP, Colorado",94,58,36,08,39250,38.297872340425535
"Joes CDP, Colorado",50,37,13,08,39745,26.0
"Johnson Village CDP, Colorado",185,185,0,08,39800,0.0
"Kirk CDP, Colorado",49,44,5,08,40900,10.204081632653061
"Laird CDP, Colorado",25,25,0,08,42000,0.0
"La Junta Gardens CDP, Colorado",32,32,0,08,42165,0.0
"Lazy Acres CDP, Colorado",369,369,0,08,44270,0.0
"Lewis CDP, Colorado",128,99,29,08,44595,22.65625
"Leyner CDP, Colorado",0,0,0,08,44695,
"Loma CDP, Colorado",542,470,72,08,45750,13.284132841328415
"Lynn CDP, Colorado",14,14,0,08,47015,0.0
"McCoy CDP, Colorado",19,19,0,08,47345,0.0
"Maybell CDP, Colorado",29,29,0,08,49325,0.0
"Maysville CDP, Colorado",119,81,38,08,49490,31.932773109243694
"Midland CDP, Colorado",147,138,9,08,50380,6.122448979591836
"Morgan Heights CDP, Colorado",121,121,0,08,51975,0.0
"Mountain Meadows CDP, Colorado",56,56,0,08,52210,0.0
"Mulford CDP, Colorado",202,158,44,08,52820,21.782178217821784
"No Name CDP, Colorado",28,28,0,08,53875,0.0
"Norrie CDP, Colorado",18,0,18,08,53945,100.0
"North La Junta CDP, Colorado",186,161,25,08,54495,13.440860215053762
"Orchard CDP, Colorado",41,41,0,08,55925,0.0
"Paragon Estates CDP, Colorado",376,376,0,08,57445,0.0
"Parshall CDP, Colorado",44,29,15,08,57850,34.090909090909086
"Peoria CDP, Colorado",67,67,0,08,58510,0.0
"Peyton CDP, Colorado",86,86,0,08,58675,0.0
"Piedra CDP, Colorado",72,15,57,08,58960,79.16666666666666
"Pine Brook Hill CDP, Colorado",463,444,19,08,59240,4.103671706263499
"Portland CDP, Colorado",61,42,19,08,60765,31.147540983606557
"Raymer (New Raymer) town, Colorado",58,32,26,08,63045,44.827586206896555
"Redstone CDP, Colorado",133,55,78,08,63650,58.64661654135338
"Redvale CDP, Colorado",149,123,26,08,63705,17.449664429530202
"Rock Creek Park CDP, Colorado",36,36,0,08,64870,0.0
"Rollinsville CDP, Colorado",161,114,47,08,65685,29.19254658385093
"Saddle Ridge CDP, Colorado",28,28,0,08,66995,0.0
"St. Ann Highlands CDP, Colorado",164,164,0,08,67040,0.0
"San Acacio CDP, Colorado",49,43,6,08,67500,12.244897959183673
"Segundo CDP, Colorado",94,63,31,08,68985,32.97872340425532
"Seven Hills CDP, Colorado",59,59,0,08,69110,0.0
"Shaw Heights CDP, Colorado",1740,1700,40,08,69480,2.2988505747126435
"Smeltertown CDP, Colorado",20,20,0,08,71625,0.0
"Snyder CDP, Colorado",47,47,0,08,71790,0.0
"Southern Ute CDP, Colorado",75,67,8,08,72320,10.666666666666668
"Stonewall Gap CDP, Colorado",106,24,82,08,74275,77.35849056603774
"Sugarloaf CDP, Colorado",179,179,0,08,74980,0.0
"Sunshine CDP, Colorado",92,77,15,08,75585,16.304347826086957
"Tall Timber CDP, Colorado",100,84,16,08,76325,16.0
"Towner CDP, Colorado",16,10,6,08,78335,37.5
"Trail Side CDP, Colorado",55,55,0,08,78345,0.0
"Twin Lakes CDP (Adams County), Colorado",2448,2419,29,08,79100,1.184640522875817
"Twin Lakes CDP (Lake County), Colorado",259,103,156,08,79105,60.231660231660236
"Upper Bear Creek CDP, Colorado",433,417,16,08,79785,3.695150115473441
"Vineland CDP, Colorado",107,107,0,08,81305,0.0
"Valdez CDP, Colorado",32,8,24,08,80095,75.0
"Valmont CDP, Colorado",38,24,14,08,80370,36.84210526315789
"Vernon CDP, Colorado",0,0,0,08,80755,
"Weldona CDP, Colorado",64,64,0,08,83175,0.0
"Winchester CDP, California",721,689,32,06,85894,4.438280166435506
"Heber CDP, California",1317,1129,188,06,33084,14.274867122247532
"Salton City CDP, California",2833,1876,957,06,64294,33.78044475820685
"Cartago CDP, California",92,7,85,06,11600,92.3913043478261
"Furnace Creek CDP, California",132,109,23,06,28021,17.424242424242426
"Oak Park CDP, California",5486,5306,180,06,53116,3.281079110462997
"San Buenaventura (Ventura) city, California",43463,41096,2367,06,65042,5.4460115500540685
"Clearlake Riviera CDP, California",1648,1268,380,06,13985,23.058252427184467
"Cleone CDP, California",423,321,102,06,14008,24.113475177304963
"Clipper Mills CDP, California",126,126,0,06,14148,0.0
"Coarsegold CDP, California",844,708,136,06,14288,16.113744075829384
"Coffee Creek CDP, California",171,91,80,06,14406,46.783625730994146
"Cohasset CDP, California",570,376,194,06,14442,34.03508771929825
"Cold Springs CDP (El Dorado County), California",214,214,0,06,14450,0.0
"Cold Springs CDP (Tuolumne County), California",270,44,226,06,14454,83.7037037037037
"Coleville CDP, California",266,166,100,06,14484,37.59398496240601
"College City CDP, California",82,82,0,06,14554,0.0
"Collierville CDP, California",777,718,59,06,14708,7.5933075933075935
"Coloma CDP, California",316,287,29,06,14764,9.177215189873419
"Comptche CDP, California",43,31,12,06,15030,27.906976744186046
"Coronita CDP, California",769,738,31,06,16420,4.031209362808843
"Courtland CDP, California",147,124,23,06,16714,15.646258503401361
"Cowan CDP, California",138,138,0,06,16762,0.0
"Cressey CDP, California",140,120,20,06,17078,14.285714285714285
"Creston CDP, California",7,7,0,06,17232,0.0
"Crowley Lake CDP, California",494,286,208,06,17372,42.10526315789473
"Crows Landing CDP, California",118,105,13,06,17428,11.016949152542372
"Cuyama CDP, California",8,8,0,06,17727,0.0
"Daphnedale Park CDP, California",58,35,23,06,17995,39.6551724137931
"Davenport CDP, California",141,121,20,06,18086,14.184397163120568
"Delft Colony CDP, California",139,139,0,06,18450,0.0
"Descanso CDP, California",709,583,126,06,18940,17.77150916784203
"Desert Center CDP, California",239,95,144,06,18982,60.25104602510461
"Desert Edge CDP, California",3610,1795,1815,06,18986,50.27700831024931
"Desert Palms CDP, California",5191,4010,1181,06,19022,22.750915045270663
"Diablo Grande CDP, California",365,314,51,06,19155,13.972602739726028
"Dobbins CDP, California",340,211,129,06,19416,37.94117647058823
"Dogtown CDP, California",969,926,43,06,19440,4.437564499484004
"Dos Palos Y CDP, California",122,112,10,06,19654,8.19672131147541
"Douglas City CDP, California",489,313,176,06,19724,35.991820040899796
"Downieville CDP, California",158,86,72,06,19794,45.56962025316456
"Doyle CDP, California",517,319,198,06,19878,38.297872340425535
"Drytown CDP, California",20,20,0,06,19976,0.0
"Dunnigan CDP, California",503,473,30,06,20228,5.964214711729622
"Dutch Flat CDP, California",160,112,48,06,20298,30.0
"Eagleville CDP, California",58,32,26,06,20424,44.827586206896555
"East Nicolaus CDP, California",116,101,15,06,20900,12.931034482758621
"East Rancho Dominguez CDP, California",3670,3524,146,06,21034,3.978201634877384
"East Tulare Villa CDP, California",266,250,16,06,21210,6.015037593984962
"Edmundson Acres CDP, California",103,103,0,06,21558,0.0
"Edna CDP, California",84,69,15,06,21565,17.857142857142858
"El Portal CDP, California",199,127,72,06,22328,36.18090452261307
"Elizabeth Lake CDP, California",763,721,42,06,21964,5.5045871559633035
"Elk Creek CDP, California",80,77,3,06,22006,3.75
"El Nido CDP, California",100,95,5,06,22286,5.0
"El Rancho CDP, California",7,7,0,06,22360,0.0
"El Sobrante CDP (Contra Costa County), California",5245,4885,360,06,22454,6.863679694947569
"El Sobrante CDP (Riverside County), California",4055,4055,0,06,22457,0.0
"Elverta CDP, California",1873,1840,33,06,22524,1.7618793379604911
"Eucalyptus Hills CDP, California",1984,1789,195,06,23000,9.828629032258064
"Fairmead CDP, California",344,333,11,06,23210,3.1976744186046515
"Fiddletown CDP, California",157,105,52,06,23980,33.12101910828025
"Fieldbrook CDP, California",391,349,42,06,24008,10.741687979539643
"Fields Landing CDP, California",217,189,28,06,24022,12.903225806451612
"Fish Camp CDP, California",251,44,207,06,24218,82.47011952191235
"Floriston CDP, California",79,20,59,06,24526,74.68354430379746
"Flournoy CDP, California",55,55,0,06,24568,0.0
"Forbestown CDP, California",147,147,0,06,24750,0.0
"Forest Ranch CDP, California",348,249,99,06,24918,28.448275862068968
"Fort Bidwell CDP, California",150,71,79,06,25030,52.666666666666664
"Fort Irwin CDP, California",2808,2500,308,06,25114,10.968660968660968
"Fort Washington CDP, California",214,214,0,06,25300,0.0
"Franklin CDP (Merced County), California",2071,2017,54,06,25488,2.6074360212457752
"Franklin CDP (Sacramento County), California",74,49,25,06,25506,33.78378378378378
"Freeport CDP, California",57,57,0,06,25590,0.0
"French Valley CDP, California",8808,8539,269,06,26067,3.0540417801998183
"Fruitridge Pocket CDP, California",1978,1798,180,06,27130,9.100101112234581
"Fuller Acres CDP, California",233,194,39,06,27190,16.738197424892704
"Fulton CDP, California",167,167,0,06,28014,0.0
"Garberville CDP, California",626,549,77,06,28154,12.300319488817891
"Garden Farms CDP, California",134,134,0,06,28210,0.0
"Garey CDP, California",33,26,7,06,29070,21.21212121212121
"Garnet CDP, California",2358,1705,653,06,29112,27.692960135708226
"Gasquet CDP, California",322,254,68,06,29154,21.11801242236025
"Gerber CDP, California",514,451,63,06,29392,12.2568093385214
"Geyserville CDP, California",360,309,51,06,29420,14.166666666666666
"Gold Mountain CDP, California",66,0,66,06,30339,100.0
"Good Hope CDP, California",2341,1977,364,06,30410,15.54891072191371
"Goodyears Bar CDP, California",74,20,54,06,30420,72.97297297297297
"Grangeville CDP, California",184,184,0,06,30686,0.0
"Graniteville CDP, California",47,0,47,06,30714,100.0
"Greeley Hill CDP, California",615,388,227,06,30900,36.91056910569105
"Greenacres CDP, California",2125,1975,150,06,30938,7.0588235294117645
"Green Acres CDP, California",728,666,62,06,30944,8.516483516483516
"Greenfield CDP, California",1093,1042,51,06,30987,4.6660567246111615
"Green Valley CDP (Los Angeles County), California",492,402,90,06,31092,18.29268292682927
"Green Valley CDP (Solano County), California",689,689,0,06,31099,0.0
"Grimes CDP, California",107,90,17,06,31288,15.887850467289718
"Grizzly Flats CDP, California",726,451,275,06,31302,37.878787878787875
"Groveland CDP, California",232,177,55,06,31372,23.70689655172414
"Guinda CDP, California",71,57,14,06,31540,19.718309859154928
"Happy Camp CDP, California",559,397,162,06,32030,28.980322003577818
"Hardwick CDP, California",16,16,0,06,32156,0.0
"Hartland CDP, California",48,0,48,06,32324,100.0
"Hartley CDP, California",1146,990,156,06,32340,13.612565445026178
"Hasley Canyon CDP, California",354,335,19,06,32385,5.367231638418079
"Hiouchi CDP, California",285,189,96,06,33935,33.68421052631579
"Hat Creek CDP, California",202,96,106,06,32408,52.475247524752476
"Herald CDP, California",351,332,19,06,33294,5.413105413105413
"Herlong CDP, California",138,101,37,06,33336,26.811594202898554
"Homestead Valley CDP, California",2274,1402,872,06,34392,38.34652594547054
"Homewood Canyon CDP, California",45,29,16,06,34405,35.55555555555556
"Honcut CDP, California",184,60,124,06,34428,67.3913043478261
"Hood CDP, California",100,100,0,06,34484,0.0
"Hopland CDP, California",278,246,32,06,34652,11.510791366906476
"Hornitos CDP, California",80,43,37,06,34708,46.25
"Hyampom CDP, California",167,79,88,06,36098,52.69461077844312
"Idlewild CDP, California",21,0,21,06,36168,100.0
"Indianola CDP, California",348,348,0,06,36420,0.0
"Indio Hills CDP, California",331,230,101,06,36452,30.513595166163142
"Jacumba CDP, California",134,134,0,06,37022,0.0
"Banning city, California",11815,10885,930,06,03820,7.871349978840457
"Calimesa city, California",3724,3325,399,06,09864,10.714285714285714
"Home Gardens CDP, California",3108,3059,49,06,34302,1.5765765765765765
"Brawley city, California",8472,6707,1765,06,08058,20.833333333333336
"El Centro city, California",13769,11569,2200,06,21782,15.97792141767739
"Holtville city, California",2126,1591,535,06,34246,25.164628410159924
"Imperial city, California",5502,4309,1193,06,36280,21.68302435478008
"Lucerne CDP, California",1720,1189,531,06,44406,30.872093023255815
"North Lakeport CDP, California",1651,1424,227,06,51990,13.74924288310115
"Lake of the Pines CDP, California",1854,1676,178,06,39690,9.60086299892125
"Truckee town, California",13568,6028,7540,06,80588,55.571933962264154
"Dillon Beach CDP, California",525,76,449,06,19262,85.52380952380952
"Romoland CDP, California",543,520,23,06,62756,4.23572744014733
"Indio city, California",37734,31468,6266,06,36448,16.605713679970318
"Murrieta city, California",33890,32212,1678,06,50076,4.951313071702567
"Thousand Palms CDP, California",3813,2728,1085,06,78596,28.455284552845526
"Calexico city, California",11155,8787,2368,06,09710,21.22814881219184
"Desert Shores CDP, California",475,323,152,06,19024,32.0
"Ocotillo CDP, California",289,35,254,06,53378,87.88927335640139
"Bolinas CDP, California",851,555,296,06,07316,34.78260869565217
"Corte Madera town, California",4053,3893,160,06,16462,3.9476930668640513
"Bodfish CDP, California",1029,727,302,06,07274,29.348882410106903
"Delano city, California",12175,11339,836,06,18394,6.86652977412731
"Channel Islands Beach CDP, California",1919,1138,781,06,12669,40.698280354351226
"Torrance city, California",58283,54360,3923,06,80000,6.730950706037782
"Valinda CDP, California",5395,5229,166,06,81638,3.076923076923077
"La Mirada city, California",14692,14331,361,06,40032,2.457119520827661
"La Verne city, California",11785,11367,418,06,40830,3.546881629189648
"Lawndale city, California",10372,9822,550,06,40886,5.302738141149248
"Littlerock CDP, California",391,391,0,06,41880,0.0
"Marina del Rey CDP, California",6132,5477,655,06,45806,10.68166992824527
"San Dimas city, California",12184,11479,705,06,66070,5.786277084701248
"Janesville CDP, California",556,524,32,06,37134,5.755395683453238
"Jenner CDP, California",117,32,85,06,37274,72.64957264957265
"Johnstonville CDP, California",514,431,83,06,37484,16.147859922178988
"Junction City CDP, California",372,295,77,06,37596,20.698924731182796
"June Lake CDP, California",761,200,561,06,37624,73.71879106438897
"Kelly Ridge CDP, California",1526,1276,250,06,38024,16.382699868938403
"Kennedy Meadows CDP, California",40,20,20,06,38076,50.0
"Contra Costa Centre CDP, California",3704,3671,33,06,16090,0.8909287257019439
"Eastvale city, California",15310,14705,605,06,21230,3.95166557805356
"Whitewater CDP, California",388,283,105,06,85208,27.061855670103093
"Pleasure Point CDP, California",3047,2535,512,06,57825,16.803413193304888
"Temescal Valley CDP, California",8551,8084,467,06,78138,5.4613495497602615
"Vincent CDP, California",4301,4135,166,06,82815,3.8595675424319924
"East Whittier CDP, California",3471,3412,59,06,21292,1.6997983290118122
"Jurupa Valley city, California",26083,24859,1224,06,37692,4.6927117279454045
"Avila Beach CDP, California",1074,738,336,06,03330,31.28491620111732
"Coulterville CDP, California",89,31,58,06,16644,65.1685393258427
"University of California-Davis CDP, California",1167,1003,164,06,81302,14.05312767780634
"University of California-Merced CDP, California",0,0,0,06,81312,
"Fairhaven CDP, California",76,63,13,06,23196,17.105263157894736
"Fort Dick CDP, California",552,478,74,06,25086,13.405797101449277
"Hoopa CDP, California",1376,1119,257,06,34540,18.677325581395348
"Little Valley CDP, California",52,13,39,06,41908,75.0
"Pala CDP, California",381,313,68,06,55058,17.84776902887139
"Westside CDP, California",47,43,4,06,84863,8.51063829787234
"Bodega Bay CDP, California",935,438,497,06,07260,53.15508021390374
"Boyes Hot Springs CDP, California",2982,2707,275,06,07848,9.221998658618377
"Santa Rosa city, California",69922,66629,3293,06,70098,4.709533480163611
"Temelec CDP, California",1164,1082,82,06,78126,7.0446735395189
"Fountain Valley city, California",19019,18597,422,06,25380,2.218833797781166
"Avenal city, California",2415,2299,116,06,03302,4.803312629399586
"Kettleman City CDP, California",322,302,20,06,38394,6.211180124223603
"Irvine city, California",101434,95371,6063,06,36770,5.977285722735966
"Los Alamitos city, California",4326,4184,142,06,43224,3.282478039759593
"Newark city, California",14158,13677,481,06,50916,3.3973725102415595
"Easton CDP, California",678,616,62,06,20928,9.144542772861357
"Kerman city, California",3930,3855,75,06,38226,1.9083969465648856
"Raisin City CDP, California",104,97,7,06,59290,6.730769230769231
"San Jose city, California",334350,321835,12515,06,68000,3.7430835950351424
"San Martin CDP, California",2094,1981,113,06,68238,5.396370582617001
"San Francisco city, California",393975,359673,34302,06,67000,8.706643822577574
"Santa Clara city, California",46485,44079,2406,06,69084,5.175863181671507
"Bonita CDP, California",4562,4165,397,06,07414,8.702323542306006
"Harbison Canyon CDP, California",1503,1428,75,06,32044,4.990019960079841
"Julian CDP, California",745,468,277,06,37582,37.18120805369127
"Pine Valley CDP, California",711,596,115,06,57260,16.17440225035162
"Ramona CDP, California",7204,6562,642,06,59346,8.911715713492505
"Santee city, California",20506,19650,856,06,70224,4.174387984004682
"Vista city, California",31478,30275,1203,06,82996,3.821716754558739
"Winter Gardens CDP, California",8026,7805,221,06,85992,2.7535509593820082
"El Verano CDP, California",1527,1321,206,06,22510,13.490504256712507
"Kentfield CDP, California",2778,2630,148,06,38114,5.327573794096472
"San Rafael city, California",23929,22982,947,06,68364,3.9575410589661084
"Santa Venetia CDP, California",1760,1716,44,06,70154,2.5
"Sausalito city, California",4497,4065,432,06,70364,9.606404269513009
"Stinson Beach CDP, California",779,299,480,06,74172,61.61745827984596
"Bootjack CDP, California",318,285,33,06,07525,10.377358490566039
"Hayfork CDP, California",1260,1048,212,06,32562,16.825396825396826
"Lewiston CDP, California",735,548,187,06,41278,25.442176870748302
"Beaumont city, California",14394,13592,802,06,04758,5.571766013616785
"Bermuda Dunes CDP, California",3746,2818,928,06,06028,24.773091297383875
"Rocklin city, California",22409,21574,835,06,62364,3.726181444955152
"Grayson CDP, California",273,253,20,06,30882,7.326007326007327
"Keyes CDP, California",1853,1731,122,06,38422,6.583917970858068
"Foresthill CDP, California",788,645,143,06,24834,18.14720812182741
"Del Rio CDP, California",484,484,0,06,18695,0.0
"Granite Bay CDP, California",8254,8066,188,06,30693,2.277683547370972
"Loomis town, California",2895,2605,290,06,43140,10.01727115716753
"Day Valley CDP, California",1243,1164,79,06,18153,6.355591311343524
"Empire CDP, California",1349,1296,53,06,22622,3.9288361749444034
"Three Rivers CDP, California",1339,1058,281,06,78638,20.985810306198655
"West Modesto CDP, California",1659,1546,113,06,84578,6.811332127787824
"Dinuba city, California",6193,6073,120,06,19318,1.9376715646697886
"Lemon Cove CDP, California",139,102,37,06,41110,26.618705035971225
"Traver CDP, California",193,184,9,06,80280,4.66321243523316
"Woodlake city, California",2288,2135,153,06,86300,6.6870629370629375
"American Canyon city, California",5639,5442,197,06,01640,3.4935272211385
"Folsom city, California",28098,27285,813,06,24638,2.8934443732650013
"Sacramento city, California",195749,183106,12643,06,64000,6.458781398627835
"Walnut Grove CDP, California",589,460,129,06,83374,21.901528013582343
"Avery CDP, California",358,218,140,06,03316,39.10614525139665
"Valley Springs CDP, California",1443,1288,155,06,81890,10.741510741510742
"Watsonville city, California",14934,14455,479,06,83668,3.2074460961564215
"Earlimart CDP, California",2149,2100,49,06,20438,2.2801302931596092
"East Orosi CDP, California",219,195,24,06,20942,10.95890410958904
"Lindsay city, California",3946,3669,277,06,41712,7.01976685250887
"Pixley CDP, California",1015,954,61,06,57512,6.009852216748769
"Terra Bella CDP, California",928,835,93,06,78288,10.02155172413793
"Tulare city, California",19572,18408,1164,06,80644,5.947271612507664
"Arbuckle CDP, California",1034,990,44,06,02420,4.25531914893617
"Lenwood CDP, California",1321,1080,241,06,41194,18.243754731264193
"Montclair city, California",10693,10429,264,06,48788,2.4689048910502196
"Mountain View Acres CDP, California",1165,1098,67,06,49684,5.75107296137339
"San Antonio Heights CDP, California",1294,1155,139,06,64462,10.741885625965997
"Twentynine Palms city, California",10102,8363,1739,06,80994,17.214412987527222
"Lompoc city, California",14127,13468,659,06,42524,4.6648262192963825
"Solvang city, California",2557,2364,193,06,72576,7.547907704341025
"Vandenberg Village CDP, California",2826,2778,48,06,82086,1.6985138004246285
"Foothill Farms CDP, California",12520,11765,755,06,24722,6.0303514376996805
"North Highlands CDP, California",16092,15457,635,06,51924,3.9460601541138454
"La Crescenta-Montrose CDP, California",7435,6744,691,06,39045,9.29388029589778
"La Habra Heights city, California",2079,1943,136,06,39304,6.541606541606542
"Lakewood city, California",27177,25931,1246,06,39892,4.584759171358134
"Malibu city, California",7771,5769,2002,06,45246,25.76245013511775
"Rancho Palos Verdes city, California",16777,15573,1204,06,59514,7.17649162543959
"Soquel CDP, California",4169,3920,249,06,72688,5.972655313024706
"East Oakdale CDP, California",1254,1231,23,06,20907,1.8341307814992027
"Aliso Viejo city, California",19783,18667,1116,06,00947,5.641207097002477
"Elk Grove city, California",53728,52025,1703,06,22020,3.1696694460988684
"Goleta city, California",11836,10964,872,06,30378,7.367353835755323
"Yountville city, California",1728,1368,360,06,86930,20.833333333333336
"Moraga town, California",6009,5909,100,06,49187,1.6641704110500914
"Rancho Cordova city, California",26323,25170,1153,06,59444,4.380199825247882
"Menifee city, California",30533,28586,1947,06,46842,6.376707169292241
"Wildomar city, California",10583,10109,474,06,85446,4.478881224605499
"North Tustin CDP, California",8960,8660,300,06,52379,3.3482142857142856
"Orosi CDP, California",2123,2026,97,06,54372,4.569006123410269
"Angels city, California",2186,1869,317,06,02112,14.501372369624885
"Malaga CDP, California",356,308,48,06,45232,13.48314606741573
"La Cañada Flintridge city, California",7016,6583,433,06,39003,6.171607753705816
"Kenwood CDP, California",555,427,128,06,38156,23.063063063063062
"Ladera CDP, California",531,499,32,06,39094,6.0263653483992465
"Keswick CDP, California",211,169,42,06,38352,19.90521327014218
"Kingvale CDP, California",262,32,230,06,38604,87.78625954198473
"Knights Landing CDP, California",305,289,16,06,38800,5.245901639344262
"Ladera Ranch CDP, California",9551,9243,308,06,39114,3.224793215370118
"La Honda CDP, California",348,348,0,06,39318,0.0
"Lake California CDP, California",1265,1194,71,06,39460,5.612648221343874
"Lake City CDP, California",61,42,19,06,39472,31.147540983606557
"Lake Don Pedro CDP, California",565,439,126,06,39484,22.300884955752213
"Lakehead CDP, California",320,250,70,06,39514,21.875
"Lake Hughes CDP, California",311,259,52,06,39556,16.720257234726688
"Lake Mathews CDP, California",1977,1895,82,06,39645,4.147698533131006
"Lake Riverside CDP, California",397,317,80,06,39715,20.151133501259448
"Lake Sherwood CDP, California",746,685,61,06,39735,8.176943699731904
"La Selva Beach CDP, California",1415,1127,288,06,40508,20.353356890459366
"Las Flores CDP (Orange County), California",1937,1877,60,06,40526,3.0975735673722253
"Yosemite Valley CDP, California",196,151,45,06,86912,22.95918367346939
"Port Costa CDP, California",147,98,49,06,58226,33.33333333333333
"San Pablo city, California",9644,9136,508,06,68294,5.2675238490253005
"Taft city, California",2906,2686,220,06,77574,7.570543702684102
"Santa Clarita city, California",69272,67583,1689,06,69088,2.438214574431228
"Las Lomas CDP, California",670,661,9,06,40592,1.3432835820895521
"Culver City city, California",17371,16502,869,06,17568,5.00259052443728
"Mayflower Village CDP, California",1888,1765,123,06,46436,6.514830508474577
"Montebello city, California",20444,19254,1190,06,48816,5.820778712580708
"Pico Rivera city, California",17244,16681,563,06,56924,3.2649037346323357
"Signal Hill city, California",4759,4590,169,06,71876,3.5511662113889475
"South Whittier CDP, California",15825,15362,463,06,73430,2.925750394944708
"Walnut Park CDP, California",3840,3737,103,06,83402,2.6822916666666665
"Westlake Village city, California",3518,3370,148,06,84438,4.206935758953951
"Willow Creek CDP, California",1099,654,445,06,85642,40.49135577797998
"Nice CDP, California",1650,1035,615,06,51294,37.27272727272727
"Upper Lake CDP, California",402,379,23,06,81358,5.721393034825871
"Fortuna city, California",5088,4679,409,06,25296,8.038522012578616
"Trinidad city, California",214,126,88,06,80448,41.1214953271028
"Westhaven-Moonstone CDP, California",589,443,146,06,84385,24.78777589134126
"Bombay Beach CDP, California",467,161,306,06,07372,65.52462526766595
"Niland CDP, California",357,200,157,06,51392,43.977591036414566
"El Dorado Hills CDP, California",15581,15180,401,06,21880,2.573647391053206
"West Point CDP, California",376,253,123,06,84732,32.71276595744681
"Mountain View city, California",35903,33707,2196,06,49670,6.116480516948444
"Bonsall CDP, California",1706,1594,112,06,07498,6.565064478311841
"Lake Forest city, California",29995,28713,1282,06,39496,4.274045674279046
"Santa Ana city, California",78597,76521,2076,06,69000,2.641322187869766
"Lemoore city, California",8966,8525,441,06,41152,4.918581307160384
"Poplar-Cotton Center CDP, California",751,660,91,06,58191,12.117177097203728
"La Presa CDP, California",11093,10752,341,06,40326,3.074010637338862
"Los Molinos CDP, California",879,746,133,06,44140,15.130830489192265
"Agoura Hills city, California",7787,7407,380,06,00394,4.879928085270322
"Mendocino CDP, California",548,419,129,06,46814,23.54014598540146
"Eldridge CDP, California",513,455,58,06,21894,11.306042884990253
"Duarte city, California",7326,7070,256,06,19990,3.4944034944034947
"Fort Bragg city, California",3178,2775,403,06,25058,12.680931403398363
"Solana Beach city, California",6631,5604,1027,06,72506,15.48786005127432
"Rolling Hills city, California",712,591,121,06,62602,16.99438202247191
"Westmorland city, California",783,628,155,06,84606,19.79565772669221
"Whittier city, California",28628,27605,1023,06,85292,3.573424619253877
"North El Monte CDP, California",1369,1286,83,06,51820,6.06281957633309
"Cherryland CDP, California",5050,4944,106,06,12902,2.099009900990099
"Clayton city, California",4340,4200,140,06,13882,3.225806451612903
"Concord city, California",48206,46475,1731,06,16000,3.59083931460814
"Danville town, California",16589,15956,633,06,17988,3.815781541985653
"Discovery Bay CDP, California",5938,5418,520,06,19339,8.757157292017514
"Pacheco CDP, California",1709,1709,0,06,54764,0.0
"San Ramon city, California",26133,25150,983,06,68378,3.761527570504726
"Amador City city, California",111,76,35,06,01514,31.53153153153153
"Sutter Creek city, California",1336,1174,162,06,77392,12.125748502994012
"Clio CDP, California",46,26,20,06,14106,43.47826086956522
"C-Road CDP, California",91,43,48,06,17267,52.74725274725275
"East Shore CDP, California",283,74,209,06,21138,73.85159010600707
"Greenhorn CDP, California",144,109,35,06,31029,24.305555555555554
"Anderson city, California",4181,3964,217,06,02042,5.1901458981105
"Redding city, California",39206,36347,2859,06,59920,7.292251186042953
"Diamond Springs CDP, California",5050,4755,295,06,19220,5.841584158415842
"Placerville city, California",4384,3988,396,06,57540,9.032846715328468
"Pollock Pines CDP, California",3246,2640,606,06,58030,18.66913123844732
"Jackson city, California",2360,2046,314,06,36980,13.305084745762713
"Plymouth city, California",425,294,131,06,57834,30.823529411764707
"Bishop city, California",2080,1935,145,06,06798,6.971153846153847
"Darwin CDP, California",43,43,0,06,18030,0.0
"Lone Pine CDP, California",947,788,159,06,42580,16.78986272439282
"Mesa CDP, California",145,145,0,06,47013,0.0
"Caribou CDP, California",0,0,0,06,11166,
"Chester CDP, California",1264,955,309,06,12930,24.446202531645568
"Hamilton Branch CDP, California",488,280,208,06,31883,42.62295081967213
"Lake Davis CDP, California",120,41,79,06,39483,65.83333333333333
"Spring Garden CDP, California",13,13,0,06,73654,0.0
"Whitehawk CDP, California",186,35,151,06,85086,81.18279569892472
"Manteca city, California",25543,24468,1075,06,45484,4.208589437419254
"Ripon city, California",5265,5039,226,06,61026,4.2924976258309595
"Taft Mosswood CDP, California",383,338,45,06,77595,11.74934725848564
"Big Bend CDP, California",83,45,38,06,06475,45.78313253012048
"Palo Cedro CDP, California",419,388,31,06,55296,7.398568019093078
"Cobb CDP, California",779,392,387,06,14302,49.6790757381258
"Myrtletown CDP, California",2236,2016,220,06,50188,9.838998211091235
"Pine Hills CDP, California",1184,1092,92,06,57204,7.77027027027027
"Weaverville CDP, California",1686,1491,195,06,83794,11.565836298932384
"Desert Hot Springs city, California",12110,9693,2417,06,18996,19.95871180842279
"Friant CDP, California",268,241,27,06,27014,10.074626865671641
"Sunol CDP, California",404,343,61,06,77042,15.099009900990099
"Union City city, California",22455,21484,971,06,81204,4.324203963482521
"Caruthers CDP, California",767,767,0,06,11614,0.0
"Riverdale CDP, California",947,921,26,06,61096,2.7455121436114043
"Selma city, California",7183,6756,427,06,70882,5.944591396352499
"Davis city, California",25732,24597,1135,06,18100,4.410850303124515
"Esparto CDP, California",1215,1079,136,06,22846,11.193415637860083
"Aptos Hills-Larkin Valley CDP, California",858,758,100,06,02382,11.655011655011654
"Ben Lomond CDP, California",2729,2473,256,06,05332,9.380725540491023
"Capitola city, California",5278,4508,770,06,11040,14.588859416445624
"Lanare CDP, California",65,65,0,06,40116,0.0
"Laton CDP, California",659,597,62,06,40746,9.408194233687405
"Beverly Hills city, California",17744,15000,2744,06,06308,15.464382326420198
"Mendota city, California",2836,2740,96,06,46828,3.385049365303244
"Tranquillity CDP, California",251,251,0,06,80266,0.0
"Bell Gardens city, California",9877,9663,214,06,04996,2.166649792447099
"Covina city, California",15897,15259,638,06,16742,4.013335849531359
"Del Aire CDP, California",3343,3196,147,06,18352,4.397247980855519
"Downey city, California",34473,33187,1286,06,19766,3.730455718968468
"Glendale city, California",77781,73871,3910,06,30000,5.02693459842378
"Manhattan Beach city, California",15363,13520,1843,06,45400,11.99635487860444
"Maywood city, California",6874,6696,178,06,46492,2.589467558917661
"Monrovia city, California",13788,12993,795,06,48648,5.765883376849434
"Palmdale city, California",47320,43890,3430,06,55156,7.2485207100591715
"Quartz Hill CDP, California",3804,3532,272,06,59052,7.150368033648791
"Redondo Beach city, California",29979,27621,2358,06,60018,7.865505854097868
"San Marino city, California",5051,4566,485,06,68224,9.602058998218174
"Santa Fe Springs city, California",5383,5213,170,06,69154,3.158090284228125
"Sierra Madre city, California",5075,4603,472,06,71806,9.300492610837438
"San Gabriel city, California",13234,12063,1171,06,67042,8.848420734471816
"Alameda city, California",32151,30365,1786,06,00562,5.5550371683617925
"Albany city, California",7841,7391,450,06,00674,5.7390638949113635
"Lynwood city, California",15871,15571,300,06,44574,1.890240060487682
"Fairview CDP, California",3848,3748,100,06,23350,2.598752598752599
"San Lorenzo CDP, California",7752,7547,205,06,68112,2.644478844169247
"Denair CDP, California",1557,1557,0,06,18856,0.0
"Oakdale city, California",8327,7794,533,06,52694,6.400864657139425
"Los Angeles city, California",1474043,1373864,100179,06,44000,6.796206080826679
"Palos Verdes Estates city, California",5442,4806,636,06,55380,11.686879823594266
"Rolling Hills Estates city, California",3134,2918,216,06,62644,6.892150606253988
"Stanton city, California",11259,10910,349,06,73962,3.099742428279599
"Richgrove CDP, California",717,702,15,06,60606,2.092050209205021
"Laguna Beach city, California",13487,10542,2945,06,39178,21.835841921850673
"Placentia city, California",17063,16577,486,06,57526,2.848268182617359
"Dublin city, California",20312,19637,675,06,20018,3.32315872390705
"Emeryville city, California",6873,6456,417,06,22594,6.067219554779572
"Costa Mesa city, California",43100,41019,2081,06,16532,4.82830626450116
"Orange city, California",44575,42969,1606,06,53980,3.6029164329781267
"Alondra Park CDP, California",2784,2640,144,06,01150,5.172413793103448
"Altadena CDP, California",16589,15472,1117,06,01290,6.7333775393332935
"Claremont city, California",12568,11711,857,06,13756,6.818905155951622
"El Monte city, California",31157,29566,1591,06,22230,5.1063966363898965
"Glendora city, California",17687,16984,703,06,30014,3.9746706620681858
"Huntington Park city, California",14976,14577,399,06,36056,2.6642628205128203
"Lake Los Angeles CDP, California",3701,3350,351,06,39612,9.483923263982707
"Delhi CDP, California",3004,2949,55,06,18464,1.8308921438082555
"Dos Palos city, California",1546,1514,32,06,19612,2.069857697283312
"Hanford city, California",19397,18295,1102,06,31960,5.681290921276486
"San Juan Bautista city, California",742,707,35,06,68014,4.716981132075472
"Monte Rio CDP, California",1014,566,448,06,48928,44.18145956607495
"Sonoma city, California",5703,5006,697,06,72646,12.221637734525688
"Windsor town, California",9593,9295,298,06,85922,3.106431773167935
"Soulsbyville CDP, California",1067,927,140,06,72772,13.120899718837864
"Burney CDP, California",1542,1324,218,06,09122,14.137483787289234
"McArthur CDP, California",203,151,52,06,44700,25.615763546798032
"Alturas city, California",1427,1215,212,06,01444,14.856341976173793
"Westwood CDP, California",1176,774,402,06,84928,34.183673469387756
"Highland city, California",16891,15932,959,06,33588,5.677579776212184
"Yucca Valley town, California",9964,8895,1069,06,87056,10.728623042954636
"Joshua Tree CDP, California",3846,2919,927,06,37554,24.102964118564742
"Morongo Valley CDP, California",1996,1542,454,06,49348,22.74549098196393
"Ontario city, California",52063,49624,2439,06,53896,4.684708910358603
"Los Alamos CDP, California",485,485,0,06,43252,0.0
"Mission Canyon CDP, California",1189,1074,115,06,48147,9.671993271656856
"Hemet city, California",33113,29193,3920,06,33182,11.838250838039441
"Indian Wells city, California",5694,2759,2935,06,36434,51.54548647699333
"Perris city, California",17661,16744,917,06,56700,5.192231470471661
"Bystrom CDP, California",1155,1095,60,06,09353,5.194805194805195
"Waterford city, California",2625,2451,174,06,83612,6.628571428571428
"East Porterville CDP, California",1902,1650,252,06,21012,13.249211356466878
"Ivanhoe CDP, California",1245,1245,0,06,36910,0.0
"San Juan Capistrano city, California",13116,12396,720,06,68028,5.489478499542543
"Tipton CDP, California",783,783,0,06,78750,0.0
"Woodville CDP, California",504,484,20,06,86482,3.968253968253968
"Rancho Santa Margarita city, California",17628,17290,338,06,59587,1.9174041297935103
"Olivehurst CDP, California",4679,4382,297,06,53714,6.347510151741825
"Big Bear Lake city, California",9778,2211,7567,06,06434,77.3880139087748
"Arden-Arcade CDP, California",44609,41631,2978,06,02553,6.675782913761797
"Citrus Heights city, California",35262,33749,1513,06,13588,4.290737904826726
"Gold River CDP, California",3544,3255,289,06,30345,8.154627539503386
"Wilton CDP, California",2085,1926,159,06,85880,7.625899280575539
"Willows city, California",2432,2281,151,06,85684,6.208881578947369
"Rosemead city, California",15532,14712,820,06,62896,5.279423126448622
"South San Gabriel CDP, California",2439,2222,217,06,73276,8.897088970889708
"Aptos CDP, California",2603,2455,148,06,02378,5.685747214752209
"Boulder Creek CDP, California",2212,2112,100,06,07652,4.520795660036167
"Auburn city, California",6421,6089,332,06,03204,5.170534184706432
"Dollar Point CDP, California",1903,440,1463,06,19455,76.878612716763
"Ducor CDP, California",190,178,12,06,20032,6.315789473684211
"Exeter city, California",3620,3389,231,06,23126,6.3812154696132595
"Palm Desert city, California",39800,24114,15686,06,55184,39.41206030150754
"Calipatria city, California",1400,987,413,06,09878,29.5
"Palo Verde CDP, California",182,73,109,06,55422,59.89010989010989
"Seeley CDP, California",595,456,139,06,70798,23.361344537815125
"Bonadelle Ranchos-Madera Ranchos CDP, California",2912,2775,137,06,07379,4.704670329670329
"Ione city, California",2056,1758,298,06,36672,14.494163424124515
"Independence CDP, California",363,267,96,06,36350,26.446280991735538
"Olancha CDP, California",105,71,34,06,53490,32.38095238095238
"South Miami Heights CDP, Florida",11300,10593,707,12,67575,6.2566371681415935
"Wahneta CDP, Florida",1699,1327,372,12,74775,21.895232489699822
"Jan Phyl Village CDP, Florida",2271,1948,323,12,35300,14.222809335094672
"Kathleen CDP, Florida",2340,2033,307,12,35950,13.119658119658121
"Loughman CDP, Florida",2096,1454,642,12,41400,30.62977099236641
"Caryville town, Florida",102,84,18,12,10975,17.647058823529413
"East Lake-Orient Park CDP, Florida",11166,10264,902,12,19212,8.078094214579975
"Keystone CDP, Florida",9295,8503,792,12,36462,8.520710059171597
"Lutz CDP, Florida",8508,7981,527,12,41775,6.1941701927597554
"Palm River-Clair Mel CDP, Florida",8576,8009,567,12,54387,6.611473880597014
"Plant City city, Florida",14747,13315,1432,12,57550,9.710449582966026
"Riverview CDP, Florida",33134,30618,2516,12,60950,7.593408583328304
"Westchase CDP, Florida",10114,9248,866,12,76062,8.562388768044295
"Boynton Beach city, Florida",35638,28698,6940,12,07875,19.47359560020203
"Briny Breezes town, Florida",834,505,329,12,08575,39.4484412470024
"Wekiwa Springs CDP, Florida",9188,8713,475,12,75725,5.1697866782760125
"Silver Springs Shores CDP, Florida",3796,3352,444,12,66175,11.696522655426765
"Glen St. Mary town, Florida",220,208,12,12,26075,5.454545454545454
"Nassau Village-Ratliff CDP, Florida",1980,1791,189,12,47787,9.545454545454547
"The Villages CDP, Florida",52881,42963,9918,12,71625,18.755318545413285
"Indian Harbour Beach city, Florida",4843,3781,1062,12,33450,21.92855667974396
"Jacob City city, Florida",126,117,9,12,35200,7.142857142857142
"Warrington CDP, Florida",7769,6589,1180,12,75200,15.188569957523491
"Bascom town, Florida",48,31,17,12,03725,35.41666666666667
"Grand Ridge town, Florida",342,311,31,12,27175,9.064327485380117
"Eglin AFB CDP, Florida",884,614,270,12,20050,30.542986425339368
"Wright CDP, Florida",11120,10168,952,12,78800,8.56115107913669
"Sanford city, Florida",24996,20874,4122,12,63650,16.490638502160344
"Moore Haven city, Florida",889,691,198,12,46550,22.272215973003377
"Cloud Lake town, Florida",83,77,6,12,13050,7.228915662650602
"Golf village, Florida",133,104,29,12,26550,21.804511278195488
"Worthington Springs town, Florida",227,151,76,12,78775,33.480176211453745
"Green Cove Springs city, Florida",3098,2689,409,12,27400,13.202065848934797
"Penney Farms town, Florida",425,350,75,12,55875,17.647058823529413
"Highland Park village, Florida",147,91,56,12,30325,38.095238095238095
"Lake Alfred city, Florida",2350,2053,297,12,37525,12.638297872340425
"Medulla CDP, Florida",3964,3454,510,12,43925,12.865792129162463
"St. Augustine Beach city, Florida",4434,2582,1852,12,62525,41.768155164636894
"Memphis CDP, Florida",3483,2830,653,12,44175,18.748205569910997
"South Bradenton CDP, Florida",13706,10576,3130,12,67258,22.836713847949802
"St. Augustine Shores CDP, Florida",4626,4021,605,12,62550,13.078253350626893
"Villano Beach CDP, Florida",1517,1143,374,12,74498,24.653922214897825
"Golden Glades CDP, Florida",10071,9175,896,12,26375,8.896832489325787
"Hialeah city, Florida",75635,72703,2932,12,30000,3.8765121967343164
"Homestead city, Florida",20939,18719,2220,12,32275,10.60222551220211
"Homestead Base CDP, Florida",152,152,0,12,32325,0.0
"Kendale Lakes CDP, Florida",18506,17686,820,12,36062,4.430995352858532
"Miami city, Florida",202289,171036,31253,12,45000,15.449678430364477
"Surfside town, Florida",4075,2337,1738,12,70075,42.650306748466264
"Virginia Gardens village, Florida",912,835,77,12,74575,8.442982456140351
"Westchester CDP, Florida",9320,8932,388,12,76075,4.163090128755364
"Weeki Wachee Gardens CDP, Florida",948,781,167,12,75641,17.616033755274263
"Sopchoppy city, Florida",238,188,50,12,66925,21.008403361344538
"Bradenton Beach city, Florida",1855,507,1348,12,07975,72.66846361185983
"Cortez CDP, Florida",3584,2070,1514,12,14700,42.24330357142857
"Southeast Arcadia CDP, Florida",2923,2571,352,12,67355,12.042422169004448
"Sebring city, Florida",5306,4184,1122,12,64875,21.14587259705993
"Bronson town, Florida",498,362,136,12,08700,27.309236947791167
"Pine Ridge CDP (Citrus County), Florida",5386,4828,558,12,57058,10.360193093204604
"Macclenny city, Florida",2377,2055,322,12,41950,13.546487168700041
"Shady Hills CDP, Florida",4788,4225,563,12,65385,11.758563074352548
"Lake Worth city, Florida",15683,13144,2539,12,39075,16.189504559076706
"Jennings town, Florida",301,247,54,12,35525,17.940199335548172
"Cedar Key city, Florida",742,326,416,12,11225,56.06469002695418
"Gulfport city, Florida",7717,6176,1541,12,28175,19.968899831540753
"Kenneth City town, Florida",2188,1709,479,12,36175,21.892138939670932
"Oldsmar city, Florida",6093,5372,721,12,51350,11.83325127195142
"St. Petersburg city, Florida",132622,107173,25449,12,63000,19.18912397641417
"South Pasadena city, Florida",4354,3177,1177,12,67675,27.03261368856224
"Chattahoochee city, Florida",1114,855,259,12,11800,23.24955116696589
"Havana town, Florida",953,816,137,12,29150,14.375655823714586
"Apopka city, Florida",18753,17003,1750,12,01700,9.33184023889511
"Windermere town, Florida",1447,1293,154,12,78050,10.642709053213546
"Azalea Park CDP, Florida",5071,4655,416,12,02850,8.203510155787813
"Pine Hills CDP, Florida",23628,22192,1436,12,56825,6.077535127814458
"Orlovista CDP, Florida",2428,2314,114,12,53100,4.695222405271829
"Oak Ridge CDP, Florida",8564,7316,1248,12,50638,14.572629612330687
"Woodville CDP, Florida",1262,1019,243,12,78700,19.25515055467512
"Ponce de Leon town, Florida",255,202,53,12,58175,20.784313725490197
"Gifford CDP, Florida",5478,3683,1795,12,25925,32.767433369843005
"Roseland CDP, Florida",976,680,296,12,61875,30.327868852459016
"Fort Lauderdale city, Florida",96444,74160,22284,12,24000,23.10563643150429
"Hawthorne city, Florida",628,564,64,12,29275,10.191082802547772
"Waldo city, Florida",492,324,168,12,74925,34.146341463414636
"Casselberry city, Florida",12829,11145,1684,12,11050,13.126510250214357
"Alford town, Florida",289,244,45,12,00625,15.570934256055363
"Marianna city, Florida",3767,3142,625,12,43175,16.59145208388638
"Boulevard Gardens CDP, Florida",505,454,51,12,07687,10.099009900990099
"Rio CDP, Florida",461,428,33,12,60550,7.158351409978309
"Fort Walton Beach city, Florida",10454,9321,1133,12,24475,10.837956762961545
"Altamonte Springs city, Florida",22477,18862,3615,12,00950,16.083107176224583
"Chuluota CDP, Florida",884,846,38,12,12275,4.298642533936651
"Oviedo city, Florida",13226,12282,944,12,53575,7.1374565250264626
"Coconut Creek city, Florida",27294,23526,3768,12,13275,13.8052319191031
"Hillsboro Beach town, Florida",2370,999,1371,12,30850,57.848101265822784
"Lauderdale-by-the-Sea town, Florida",7389,3982,3407,12,39475,46.10908106645013
"Minneola city, Florida",3630,3421,209,12,45900,5.757575757575758
"Canal Point CDP, Florida",208,144,64,12,10100,30.76923076923077
"Eustis city, Florida",9057,7855,1202,12,21350,13.271502705089985
"Orange Park town, Florida",3841,3504,337,12,52125,8.773756834157771
"Fussels Corner CDP, Florida",2589,1937,652,12,25125,25.18346852066435
"Lake Wales city, Florida",6808,5818,990,12,38950,14.54171562867215
"Waverly CDP, Florida",319,284,35,12,75475,10.9717868338558
"Chipley city, Florida",1476,1144,332,12,11975,22.493224932249323
"Vernon city, Florida",395,293,102,12,74125,25.82278481012658
"Cheval CDP, Florida",4682,4456,226,12,11912,4.826997009824861
"Egypt Lake-Leto CDP, Florida",15024,14010,1014,12,20108,6.7492012779552715
"Cypress Quarters CDP, Florida",534,428,106,12,16100,19.850187265917604
"High Point CDP, Florida",2417,1921,496,12,30494,20.521307405875053
"Holley CDP, Florida",744,579,165,12,31275,22.177419354838708
"Homeland CDP, Florida",58,58,0,12,32250,0.0
"Horizon West CDP, Florida",11354,10290,1064,12,32610,9.3711467324291
"Hosford CDP, Florida",426,309,117,12,32675,27.464788732394368
"Island Walk CDP, Florida",2009,1642,367,12,34185,18.267794922847187
"Jupiter Farms CDP, Florida",4311,4104,207,12,35890,4.801670146137787
"St. Pete Beach city, Florida",8041,4994,3047,12,62885,37.893296853625166
"Belle Isle city, Florida",2952,2610,342,12,05300,11.585365853658537
"Paradise Heights CDP, Florida",269,229,40,12,54912,14.869888475836431
"Southchase CDP, Florida",4901,4285,616,12,67270,12.568863497245461
"Fort Myers Beach town, Florida",10382,3609,6773,12,24150,65.2379117703718
"Harlem Heights CDP, Florida",751,542,209,12,28937,27.82956058588549
"Matlacha CDP, Florida",575,379,196,12,43475,34.08695652173913
"Pine Manor CDP, Florida",1678,1437,241,12,57025,14.36233611442193
"San Carlos Park CDP, Florida",6761,5718,1043,12,63425,15.426712024848396
"Three Oaks CDP, Florida",1503,1324,179,12,71758,11.909514304723885
"Jasmine Estates CDP, Florida",9591,8459,1132,12,35350,11.80273172766135
"Trinity CDP, Florida",4879,4167,712,12,72442,14.593154334904693
"Zephyrhills North CDP, Florida",2062,1329,733,12,79231,35.548011639185255
"Callaway city, Florida",6613,5500,1113,12,09725,16.83048540753062
"Istachatta CDP, Florida",106,81,25,12,34275,23.58490566037736
"Mexico Beach city, Florida",2051,738,1313,12,44300,64.01755241345684
"Immokalee CDP, Florida",6755,5855,900,12,33250,13.323464100666174
"Lely Resort CDP, Florida",5359,2793,2566,12,40037,47.88206754991603
"Masaryktown CDP, Florida",400,337,63,12,43400,15.75
"North Weeki Wachee CDP, Florida",4255,3463,792,12,49905,18.613396004700352
"East Lake CDP, Florida",15331,13245,2086,12,19206,13.606418368012523
"Indian Rocks Beach city, Florida",3664,2286,1378,12,33625,37.609170305676855
"Madeira Beach city, Florida",4280,2150,2130,12,42400,49.76635514018692
"Seminole city, Florida",11212,8779,2433,12,64975,21.699964323938637
"Greensboro town, Florida",285,239,46,12,27550,16.140350877192983
"Mayo town, Florida",453,322,131,12,43575,28.918322295805737
"Holden Heights CDP, Florida",1474,1316,158,12,31025,10.719131614654003
"Lake Buena Vista city, Florida",3,3,0,12,37625,0.0
"Lawtey city, Florida",360,308,52,12,39700,14.444444444444443
"Alva CDP, Florida",1257,1030,227,12,01125,18.05887032617343
"Matlacha Isles-Matlacha Shores CDP, Florida",182,125,57,12,43484,31.318681318681318
"North Fort Myers CDP, Florida",26897,19222,7675,12,49350,28.5347808305759
"Land O' Lakes CDP, Florida",14478,13284,1194,12,39200,8.246995441359303
"Odessa CDP, Florida",3314,2913,401,12,51100,12.100181050090525
"St. Leo town, Florida",21,11,10,12,62775,47.61904761904761
"Williston Highlands CDP, Florida",881,799,82,12,77837,9.307604994324631
"Bay Lake city, Florida",30,29,1,12,04150,3.3333333333333335
"Hunters Creek CDP, Florida",9474,7684,1790,12,32967,18.893814650622755
"Lake Hart CDP, Florida",303,217,86,12,38012,28.38283828382838
"Zellwood CDP, Florida",1757,1428,329,12,79200,18.725099601593627
"Fanning Springs city, Florida",559,440,119,12,21850,21.288014311270125
"Maitland city, Florida",8493,7330,1163,12,42575,13.693630048275049
"Meadow Woods CDP, Florida",11854,10045,1809,12,43800,15.26067150329003
"Belleair town, Florida",2290,1693,597,12,05075,26.06986899563319
"Belleair Shore town, Florida",53,33,20,12,05150,37.735849056603776
"South Highpoint CDP, Florida",1890,1677,213,12,67462,11.26984126984127
"Vineyards CDP, Florida",2970,1857,1113,12,74562,37.474747474747474
"Brookridge CDP, Florida",2908,2242,666,12,08762,22.902338376891336
"Lake Lindsey CDP, Florida",17,17,0,12,38275,0.0
"Pine Island CDP, Florida",13,13,0,12,56840,0.0
"Spring Hill CDP, Florida",46398,41071,5327,12,68350,11.481098323203586
"Charleston Park CDP, Florida",80,21,59,12,11597,73.75
"Cypress Lake CDP, Florida",8955,6580,2375,12,16062,26.521496370742604
"Fort Myers Shores CDP, Florida",2582,2286,296,12,24175,11.463981409759876
"McGregor CDP, Florida",4695,3472,1223,12,42090,26.04898828541001
"Page Park CDP, Florida",240,217,23,12,53775,9.583333333333334
"Palmona Park CDP, Florida",551,420,131,12,54357,23.77495462794918
"Pineland CDP, Florida",315,169,146,12,56875,46.34920634920635
"Sanibel city, Florida",8929,3678,5251,12,63700,58.8083771978945
"Bayonet Point CDP, Florida",13226,11102,2124,12,04162,16.059277181309543
"Holiday CDP, Florida",12580,9277,3303,12,31075,26.255961844197138
"New Port Richey city, Florida",9214,7113,2101,12,48500,22.802257434339047
"Fort Myers city, Florida",38855,29111,9744,12,24125,25.07785355810063
"El Portal village, Florida",959,772,187,12,20650,19.499478623566215
"Indian Creek village, Florida",26,14,12,12,33425,46.15384615384615
"The Hammocks CDP, Florida",18075,16588,1487,12,71569,8.226832641770402
"Desoto Lakes CDP, Florida",1565,1310,255,12,17300,16.293929712460063
"Ridge Wood Heights CDP, Florida",2314,2020,294,12,60475,12.705272255834055
"Siesta Key CDP, Florida",8205,2855,5350,12,66000,65.20414381474711
"Palm Beach town, Florida",9860,4796,5064,12,54025,51.35902636916836
"Cross City town, Florida",1019,797,222,12,15575,21.786064769381746
"Horseshoe Beach town, Florida",346,52,294,12,32650,84.97109826589595
"Inglis town, Florida",850,682,168,12,33800,19.76470588235294
"Otter Creek town, Florida",34,23,11,12,53500,32.35294117647059
"Wausau town, Florida",192,153,39,12,75450,20.3125
"Apollo Beach CDP, Florida",8451,7690,761,12,01675,9.004851496864276
"Citrus Park CDP, Florida",10724,10162,562,12,12425,5.2405818724356585
"Temple Terrace city, Florida",10723,9785,938,12,71400,8.747551991047281
"Town 'n' Country CDP, Florida",34904,31534,3370,12,72145,9.655053862021546
"Wimauma CDP, Florida",2052,1808,244,12,78025,11.890838206627679
"Bithlo CDP, Florida",3349,3033,316,12,06625,9.435652433562257
"Christmas CDP, Florida",862,785,77,12,12250,8.932714617169374
"Doctor Phillips CDP, Florida",5085,4244,841,12,17725,16.538839724680432
"Edgewood city, Florida",1154,1047,107,12,19900,9.272097053726169
"Gotha CDP, Florida",643,643,0,12,26900,0.0
"Tangelo Park CDP, Florida",859,789,70,12,71075,8.149010477299184
"Tangerine CDP, Florida",1180,997,183,12,71100,15.508474576271187
"Boca Raton city, Florida",52354,40434,11920,12,07300,22.768078847843526
"Limestone Creek CDP, Florida",387,374,13,12,40562,3.359173126614987
"Pahokee city, Florida",2138,1836,302,12,53800,14.125350795135642
"Captiva CDP, Florida",1511,36,1475,12,10425,97.61747187293184
"Frostproof city, Florida",1534,1136,398,12,24900,25.945241199478485
"Inwood CDP, Florida",3107,2501,606,12,34000,19.50434502735758
"Lakeland city, Florida",49322,40938,8384,12,38250,16.998499655326224
"Polk City town, Florida",927,834,93,12,57950,10.032362459546926
"Bloomingdale CDP, Florida",8551,8055,496,12,06875,5.800491170623319
"Dover CDP, Florida",980,890,90,12,18075,9.183673469387756
"Fish Hawk CDP, Florida",6647,6256,391,12,22387,5.88235294117647
"Gibsonton CDP, Florida",6129,5495,634,12,25900,10.344264969815631
"Lake Magdalene CDP, Florida",13260,12136,1124,12,38350,8.476621417797888
"Mango CDP, Florida",4759,4060,699,12,42850,14.687959655389788
"Progress Village CDP, Florida",3576,3435,141,12,59050,3.942953020134228
"Midway city, Florida",1402,1277,125,12,45425,8.91583452211127
"Fairview Shores CDP, Florida",4679,4228,451,12,21750,9.638811711904253
"Lockhart CDP, Florida",5598,5131,467,12,41025,8.342265094676671
"Orlando city, Florida",130664,111674,18990,12,53000,14.53345986652789
"Pine Castle CDP, Florida",4535,3936,599,12,56500,13.20837927232635
"South Apopka CDP, Florida",2027,1818,209,12,67163,10.310804144055254
"Yankeetown town, Florida",505,284,221,12,78925,43.76237623762376
"Cypress Gardens CDP, Florida",4448,3831,617,12,16050,13.871402877697841
"Hillcrest Heights town, Florida",127,91,36,12,30700,28.346456692913385
"Seffner CDP, Florida",2920,2812,108,12,64925,3.6986301369863015
"Taylor Creek CDP, Florida",2755,1943,812,12,71300,29.47368421052631
"Port St. Joe city, Florida",1928,1388,540,12,58675,28.008298755186722
"Wewahitchka city, Florida",1179,827,352,12,77100,29.855810008481765
"Gun Club Estates CDP, Florida",285,285,0,12,28305,0.0
"Highland Beach town, Florida",3831,2041,1790,12,30200,46.72409292612895
"Lake Clarke Shores town, Florida",1623,1414,209,12,37800,12.87738755391251
"Lake Park town, Florida",3280,2607,673,12,38600,20.518292682926827
"Jasper city, Florida",963,742,221,12,35375,22.949117341640708
"White Springs town, Florida",449,364,85,12,77400,18.93095768374165
"Andrews CDP, Florida",527,336,191,12,01353,36.24288425047438
"East Bronson CDP, Florida",926,679,247,12,19025,26.673866090712746
"Gretna city, Florida",595,471,124,12,27650,20.840336134453782
"Quincy city, Florida",3329,2810,519,12,59325,15.590267347551817
"Fruitland Park city, Florida",2983,2684,299,12,24975,10.023466309084814
"Palm Shores town, Florida",510,491,19,12,54425,3.7254901960784315
"Bell town, Florida",249,190,59,12,04975,23.694779116465863
"Pittman CDP, Florida",76,76,0,12,57380,0.0
"Trenton city, Florida",796,689,107,12,72350,13.442211055276381
"Ferndale CDP, Florida",213,213,0,12,22225,0.0
"Mount Dora city, Florida",7352,6095,1257,12,47050,17.09738846572361
"Tavares city, Florida",8645,6903,1742,12,71225,20.150375939849624
"Yalaha CDP, Florida",699,479,220,12,78900,31.47353361945637
"Tampa city, Florida",167950,149279,18671,12,71000,11.116999106877048
"Thonotosassa CDP, Florida",5403,4824,579,12,71725,10.716268739589117
"Beacon Square CDP, Florida",4119,2902,1217,12,04650,29.546006312211702
"Iona CDP, Florida",14047,7481,6566,12,34012,46.743076813554495
"Olga CDP, Florida",894,756,138,12,51400,15.436241610738255
"Suncoast Estates CDP, Florida",1844,1509,335,12,69275,18.16702819956616
"Lacoochee CDP, Florida",633,507,126,12,37275,19.90521327014218
"Goodland CDP, Florida",438,144,294,12,26775,67.12328767123287
"Naples Manor CDP, Florida",1348,1348,0,12,47650,0.0
"Orangetree CDP, Florida",1895,1269,626,12,52162,33.034300791556724
"Hernando Beach CDP, Florida",1509,1182,327,12,29437,21.669980119284293
"Ridge Manor CDP, Florida",2437,1897,540,12,60325,22.15839146491588
"Grove City CDP, Florida",1536,873,663,12,27775,43.1640625
"Dundee town, Florida",1610,1256,354,12,18550,21.987577639751553
"Highland City CDP, Florida",4059,3656,403,12,30225,9.928553830992854
"Winter Haven city, Florida",17580,14631,2949,12,78275,16.774744027303754
"Monticello city, Florida",1380,1092,288,12,46500,20.869565217391305
"Live Oak city, Florida",3019,2354,665,12,40875,22.027161311692613
"Pebble Creek CDP, Florida",2984,2798,186,12,55540,6.233243967828418
"Vamo CDP, Florida",3333,2566,767,12,73725,23.01230123012301
"Plantation Mobile Home Park CDP, Florida",448,448,0,12,57518,0.0
"Wellington village, Florida",24452,20559,3893,12,75812,15.920988058236546
"Three Lakes CDP, Florida",5168,4805,363,12,71741,7.0239938080495365
"Layton city, Florida",181,75,106,12,39725,58.5635359116022
"Englewood CDP, Florida",11210,7547,3663,12,20825,32.676181980374665
"Gulf Gate Estates CDP, Florida",6937,5305,1632,12,28050,23.526019893325646
"Plantation CDP, Florida",4046,2785,1261,12,57450,31.166584280771133
"Eastpoint CDP, Florida",1126,830,296,12,19400,26.287744227353464
"South Sarasota CDP, Florida",2804,2462,342,12,67887,12.196861626248216
"South Venice CDP, Florida",8053,6438,1615,12,68100,20.05463802309698
"Venice Gardens CDP, Florida",4359,3623,736,12,73950,16.884606561137876
"Atlantic Beach city, Florida",7004,6066,938,12,02400,13.392347230154197
"Jacksonville Beach city, Florida",13180,10970,2210,12,35050,16.76783004552352
"Deltona city, Florida",33395,30295,3100,12,17200,9.282826770474623
"New Smyrna Beach city, Florida",18152,12243,5909,12,48625,32.55288673424416
"Neptune Beach city, Florida",3401,2924,477,12,48100,14.025286680388122
"West Perrine CDP, Florida",3277,2880,397,12,76700,12.114739090631675
"Big Pine Key CDP, Florida",2887,2010,877,12,06425,30.37755455490128
"Longboat Key town, Florida",9319,3835,5484,12,41150,58.847515827878524
"Hobe Sound CDP, Florida",7317,6082,1235,12,30975,16.878502118354515
"Jensen Beach CDP, Florida",7116,5775,1341,12,35550,18.84485666104553
"Port Salerno CDP, Florida",5504,4454,1050,12,58727,19.07703488372093
"Fort Pierce South CDP, Florida",1761,1515,246,12,24387,13.969335604770016
"White City CDP, Florida",1825,1555,270,12,77275,14.794520547945206
"Palm Springs village, Florida",9625,8236,1389,12,54450,14.431168831168831
"Royal Palm Beach village, Florida",13120,11696,1424,12,62100,10.853658536585366
"Gateway CDP, Florida",4266,3312,954,12,25655,22.362869198312236
"Lehigh Acres CDP, Florida",38342,33477,4865,12,39925,12.688435658025144
"Lochmoor Waterway Estates CDP, Florida",2367,1832,535,12,40985,22.60245035910435
"Pine Island Center CDP, Florida",1111,776,335,12,56850,30.15301530153015
"Tice CDP, Florida",1770,1340,430,12,71800,24.293785310734464
"Everglades city, Florida",351,97,254,12,21425,72.36467236467237
"Crystal Springs CDP, Florida",421,313,108,12,15800,25.653206650831358
"Dade City city, Florida",3085,2431,654,12,16125,21.19935170178282
"San Antonio city, Florida",554,468,86,12,63375,15.523465703971121
"Naples Park CDP, Florida",3175,2508,667,12,47675,21.007874015748033
"Pine Ridge CDP (Collier County), Florida",1036,722,314,12,57066,30.30888030888031
"Hill 'n Dale CDP, Florida",839,698,141,12,30800,16.805721096543504
"Nobleton CDP, Florida",69,42,27,12,48825,39.130434782608695
"Palatka city, Florida",4618,3982,636,12,53875,13.772195755738414
"Lower Grand Lagoon CDP, Florida",6610,1992,4618,12,41562,69.86384266263238
"Parker city, Florida",2040,1797,243,12,55075,11.911764705882351
"Tyndall AFB CDP, Florida",1003,810,193,12,72875,19.242273180458625
"Richmond West CDP, Florida",9890,9662,228,12,60230,2.3053589484327603
"Sunset CDP, Florida",5351,4923,428,12,69812,7.998504952345356
"West Little River CDP, Florida",10437,9550,887,12,76487,8.498610711890391
"Sarasota Springs CDP, Florida",6967,6040,927,12,64325,13.305583464905984
"Daytona Beach city, Florida",36402,28817,7585,12,16525,20.836767210592825
"Indian River Estates CDP, Florida",3214,2932,282,12,33585,8.774113254511512
"Schall Circle CDP, Florida",484,437,47,12,64547,9.710743801652892
"Seminole Manor CDP, Florida",962,875,87,12,65100,9.043659043659044
"Daytona Beach Shores city, Florida",6244,2555,3689,12,16550,59.08071748878923
"De Leon Springs CDP, Florida",870,781,89,12,16975,10.229885057471265
"Lake Helen city, Florida",1292,1143,149,12,38025,11.53250773993808
"Oak Hill city, Florida",1086,820,266,12,50450,24.49355432780847
"Baldwin town, Florida",675,561,114,12,03250,16.88888888888889
"St. Augustine South CDP, Florida",2404,2145,259,12,62562,10.773710482529118
"Palm City CDP, Florida",11703,10115,1588,12,54175,13.569170298214134
"Lakewood Park CDP, Florida",6172,5036,1136,12,39062,18.405703175631885
"Apalachicola city, Florida",1447,1078,369,12,01625,25.501036627505187
"Carrabelle city, Florida",931,552,379,12,10725,40.70891514500537
"Riviera Beach city, Florida",16116,11452,4664,12,60975,28.940183668404067
"Royal Palm Estates CDP, Florida",997,874,123,12,62118,12.337011033099298
"Holly Hill city, Florida",6533,4895,1638,12,31350,25.072707791213837
"Pierson town, Florida",562,428,134,12,56425,23.843416370106763
"Kenwood Estates CDP, Florida",387,368,19,12,36220,4.909560723514212
"Key Vista CDP, Florida",790,639,151,12,36535,19.11392405063291
"Lake Mary Jane CDP, Florida",878,738,140,12,38430,15.945330296127564
"Lake Mystic CDP, Florida",316,176,140,12,38519,44.303797468354425
"Lamont CDP, Florida",47,27,20,12,39100,42.5531914893617
"Lealman CDP, Florida",10718,8746,1972,12,39775,18.398955028923307
"Lemon Grove CDP, Florida",310,219,91,12,40100,29.354838709677416
"Limestone CDP, Florida",36,36,0,12,40525,0.0
"Lloyd CDP, Florida",153,98,55,12,40950,35.947712418300654
"Meadow Oaks CDP, Florida",1333,1098,235,12,43785,17.62940735183796
"Midway CDP (Santa Rosa County), Florida",7766,6934,832,12,45465,10.713365954159155
"Midway CDP (Seminole County), Florida",708,583,125,12,45475,17.65536723163842
"Montura CDP, Florida",1469,1235,234,12,46520,15.929203539823009
"Moon Lake CDP, Florida",2175,1644,531,12,46540,24.413793103448274
"Morriston CDP, Florida",43,43,0,12,46725,0.0
"Mount Carmel CDP, Florida",156,103,53,12,47000,33.97435897435898
"Mulat CDP, Florida",52,52,0,12,47175,0.0
"Munson CDP, Florida",108,88,20,12,47300,18.51851851851852
"Navarre CDP, Florida",14358,12839,1519,12,48050,10.57946789246413
"Navarre Beach CDP, Florida",2194,601,1593,12,48055,72.60711030082042
"Nocatee CDP, Florida",4941,4374,567,12,48850,11.475409836065573
"Northdale CDP, Florida",9109,8454,655,12,49260,7.190690525853552
"Oriole Beach CDP, Florida",678,593,85,12,52250,12.536873156342182
"North DeLand CDP, Florida",637,534,103,12,49275,16.16954474097331
"Oakland town, Florida",980,860,120,12,50525,12.244897959183673
"Oakleaf Plantation CDP, Florida",8552,8060,492,12,50630,5.7530402245088865
"Panacea CDP, Florida",440,398,42,12,54625,9.545454545454547
"Pasadena Hills CDP, Florida",4342,3725,617,12,55305,14.210041455550437
"Patrick AFB CDP, Florida",492,440,52,12,55375,10.569105691056912
"Pea Ridge CDP, Florida",1870,1646,224,12,55532,11.97860962566845
"Pine Air CDP, Florida",741,712,29,12,56475,3.913630229419703
"Pine Level CDP, Florida",75,75,0,12,56955,0.0
"Pioneer CDP, Florida",534,299,235,12,57320,44.00749063670412
"Point Baker CDP, Florida",1289,1151,138,12,57908,10.705973622963539
"Port LaBelle CDP, Florida",1661,1250,411,12,58420,24.744130042143286
"Quail Ridge CDP, Florida",827,734,93,12,59311,11.24546553808948
"Raleigh CDP, Florida",232,167,65,12,59475,28.01724137931034
"Rio Pinar CDP, Florida",2007,1910,97,12,60562,4.833084205281515
"River Park CDP, Florida",2956,2557,399,12,60785,13.497970230040595
"River Ridge CDP, Florida",2127,2010,117,12,60835,5.500705218617771
"Roeville CDP, Florida",270,226,44,12,61615,16.296296296296298
"San Castle CDP, Florida",1131,1052,79,12,63435,6.984969053934571
"Seville CDP, Florida",249,183,66,12,65200,26.506024096385545
"Springhill CDP, Florida",48,48,0,12,68365,0.0
"Spring Ridge CDP, Florida",179,172,7,12,68435,3.910614525139665
"Steinhatchee CDP, Florida",1544,438,1106,12,68625,71.6321243523316
"Sumatra CDP, Florida",163,101,62,12,69025,38.036809815950924
"Sun City Center CDP, Florida",15891,13454,2437,12,69250,15.335724624001006
"The Acreage CDP, Florida",12845,11788,1057,12,71564,8.228882833787466
"Tiger Point CDP, Florida",1324,1225,99,12,71842,7.477341389728097
"Trilby CDP, Florida",167,167,0,12,72425,0.0
"University CDP (Hillsborough County), Florida",22055,18800,3255,12,73163,14.758558150079349
"University CDP (Orange County), Florida",8208,6843,1365,12,73172,16.630116959064328
"Verona Walk CDP, Florida",1922,1133,789,12,74235,41.05098855359001
"Viera East CDP, Florida",5181,4707,474,12,74368,9.14881297046902
"Viera West CDP, Florida",4490,4131,359,12,74370,7.99554565701559
"Wacissa CDP, Florida",160,132,28,12,74700,17.5
"Wallace CDP, Florida",859,742,117,12,74975,13.62048894062864
"Watergate CDP, Florida",1021,815,206,12,75275,20.176297747306563
"Waukeenah CDP, Florida",80,80,0,12,75425,0.0
"West DeLand CDP, Florida",1717,1515,202,12,76087,11.76470588235294
"Westgate CDP, Florida",2570,2380,190,12,76290,7.392996108949417
"West Lealman CDP, Florida",9667,7087,2580,12,76481,26.688734871211338
"Whitfield CDP (Manatee County), Florida",1598,1353,245,12,77467,15.331664580725906
"Whitfield CDP (Santa Rosa County), Florida",151,97,54,12,77470,35.76158940397351
"Windsor CDP, Florida",322,115,207,12,78110,64.28571428571429
"Wiscon CDP, Florida",407,322,85,12,78340,20.884520884520885
"Woodlawn Beach CDP, Florida",1122,1018,104,12,78500,9.269162210338681
"World Golf Village CDP, Florida",6735,5727,1008,12,78740,14.966592427616925
"Westlake city, Florida",2,2,0,12,76417,0.0
"Indiantown village, Florida",2063,1676,387,12,33700,18.7590887057683
"Ocean Breeze town, Florida",213,100,113,12,50875,53.051643192488264
"DeFuniak Springs city, Florida",3265,2623,642,12,16800,19.66309341500766
"Ona CDP, Florida",154,154,0,12,51500,0.0
"St. George Island CDP, Florida",1873,384,1489,12,62650,79.4981313400961
"Estero village, Florida",23423,14716,8707,12,21150,37.17286427870042
"Stacey Street CDP, Florida",256,188,68,12,68487,26.5625
"Tequesta village, Florida",3442,2813,629,12,71525,18.274259151656015
"Edgewater city, Florida",9716,8544,1172,12,19825,12.06257719226019
"Palm Beach Shores town, Florida",1196,628,568,12,54150,47.491638795986624
"Samsula-Spruce Creek CDP, Florida",2703,2083,620,12,63362,22.93747687754347
"Haines City city, Florida",9348,6989,2359,12,28400,25.235344458707743
"West Palm Beach city, Florida",52800,41691,11109,12,76600,21.039772727272727
"South Bay city, Florida",768,528,240,12,67175,31.25
"Zephyrhills West CDP, Florida",4252,2768,1484,12,79243,34.901222953904046
"Greenville town, Florida",487,320,167,12,27575,34.29158110882957
"Golden Gate CDP, Florida",7973,7546,427,12,26300,5.355575065847234
"Lely CDP, Florida",2808,1760,1048,12,39987,37.32193732193732
"Naples city, Florida",19801,10854,8947,12,47625,45.184586637038535
"Pelican Bay CDP, Florida",6717,3338,3379,12,55650,50.30519577192199
"Interlachen town, Florida",718,566,152,12,33900,21.16991643454039
"Blountstown city, Florida",1181,926,255,12,06925,21.591871295512277
"Bal Harbour village, Florida",3569,1487,2082,12,03275,58.335668254413
"Gladeview CDP, Florida",4563,3963,600,12,25987,13.149243918474687
"Bradenton city, Florida",27434,21528,5906,12,07950,21.528030910548953
"Ellenton CDP, Florida",1981,1582,399,12,20375,20.141342756183743
"Fruit Cove CDP, Florida",11495,10878,617,12,24925,5.367551109177903
"Palm Valley CDP, Florida",9916,8716,1200,12,54525,12.10165389269867
"Goulds CDP, Florida",3488,3206,282,12,26950,8.0848623853211
"Medley town, Florida",397,380,17,12,43900,4.282115869017632
"Naranja CDP, Florida",3203,2963,240,12,47700,7.4929753356228534
"Olympia Heights CDP, Florida",4109,4025,84,12,51475,2.0442930153321974
"Five Points CDP, Florida",358,358,0,12,22475,0.0
"Burnt Store Marina CDP, Florida",2030,1035,995,12,09612,49.01477832512315
"Ponce Inlet town, Florida",2841,1442,1399,12,58200,49.24322421682506
"Archer city, Florida",500,449,51,12,01775,10.2
"Micanopy town, Florida",310,244,66,12,45225,21.29032258064516
"Myrtle Grove CDP, Florida",7197,6145,1052,12,47550,14.617201611782688
"Pensacola city, Florida",24949,21873,3076,12,55925,12.329151468996754
"West Pensacola CDP, Florida",10490,8740,1750,12,76675,16.682554814108673
"Beverly Beach town, Florida",343,252,91,12,06100,26.53061224489796
"Cinco Bayou town, Florida",284,225,59,12,12325,20.774647887323944
"Destin city, Florida",13696,5724,7972,12,17325,58.20677570093458
"Mary Esther city, Florida",1944,1706,238,12,43375,12.242798353909464
"Forest City CDP, Florida",5709,5097,612,12,23375,10.719915922228061
"Goldenrod CDP, Florida",5708,5049,659,12,26475,11.545199719691661
"Bellair-Meadowbrook Terrace CDP, Florida",6044,5723,321,12,05025,5.311052283256122
"Bay Hill CDP, Florida",2121,1814,307,12,04070,14.474304573314475
"Silver Lake CDP, Florida",858,800,58,12,66062,6.75990675990676
"St. Cloud city, Florida",18415,14636,3779,12,62625,20.52131414607657
"Yeehaw Junction CDP, Florida",212,109,103,12,78975,48.58490566037736
"Asbury Lake CDP, Florida",3310,3247,63,12,02187,1.9033232628398793
"Babson Park CDP, Florida",445,351,94,12,02900,21.123595505617978
"Union Park CDP, Florida",4547,4090,457,12,73075,10.050582801847371
"Winter Garden city, Florida",15809,14622,1187,12,78250,7.508381301790119
"Sunrise city, Florida",37394,31909,5485,12,69700,14.668128576777024
"Parkland city, Florida",10155,9420,735,12,55125,7.23781388478582
"Pembroke Park town, Florida",3647,2285,1362,12,55750,37.34576364134906
"Black Diamond CDP, Florida",594,337,257,12,06667,43.26599326599327
"Sorrento CDP, Florida",219,149,70,12,66975,31.963470319634702
"Middleburg CDP, Florida",5112,4587,525,12,45350,10.269953051643192
"Crooked Lake Park CDP, Florida",733,665,68,12,15515,9.27694406548431
"Lakeland Highlands CDP, Florida",4719,4288,431,12,38262,9.13329095147277
"Willow Oak CDP, Florida",2427,2134,293,12,77862,12.072517511330862
"Lauderdale Lakes city, Florida",14197,11160,3037,12,39525,21.391843347186025
"Charlotte Park CDP, Florida",1676,1061,615,12,11650,36.6945107398568
"Glen Ridge town, Florida",98,82,16,12,26050,16.3265306122449
"Citrus Hills CDP, Florida",4381,3458,923,12,12412,21.068249258160236
"Floral City CDP, Florida",2927,2403,524,12,22775,17.902289033139734
"Indialantic town, Florida",1497,1162,335,12,33375,22.37808951235805
"Buckhead Ridge CDP, Florida",1254,763,491,12,09315,39.15470494417863
"Atlantis city, Florida",1210,912,298,12,02500,24.628099173553718
"Hypoluxo town, Florida",2313,1404,909,12,33150,39.29961089494164
"Juno Beach town, Florida",3473,2101,1372,12,35850,39.50475093579038
"Juno Ridge CDP, Florida",489,410,79,12,35862,16.155419222903884
"Jupiter Inlet Colony town, Florida",227,184,43,12,35900,18.94273127753304
"North Palm Beach village, Florida",8288,6255,2033,12,49600,24.529440154440156
"Conway CDP, Florida",5536,5180,356,12,14050,6.430635838150289
"Eatonville town, Florida",826,698,128,12,19650,15.49636803874092
"Southgate CDP, Florida",4032,3137,895,12,67425,22.197420634920633
"North River Shores CDP, Florida",2020,1499,521,12,49750,25.792079207920793
"Hutchinson Island South CDP, Florida",7884,3100,4784,12,32993,60.67985794013191
"Port St. Lucie city, Florida",72423,63807,8616,12,58715,11.896773124559877
"Palm Beach Gardens city, Florida",30049,24090,5959,12,54075,19.830942793437387
"Ormond Beach city, Florida",20765,17932,2833,12,53150,13.643149530459908
"Port Orange city, Florida",29239,25746,3493,12,58575,11.946372994972467
"Weston CDP, Colorado",40,17,23,08,84000,57.49999999999999
"Wolcott CDP, Colorado",31,0,31,08,85760,100.0
"Woody Creek CDP, Colorado",156,105,51,08,86200,32.69230769230769
"Castle Pines Village CDP, Colorado",1788,1656,132,08,12393,7.38255033557047
"Phippsburg CDP, Colorado",125,114,11,08,58785,8.799999999999999
"Watkins CDP, Colorado",225,225,0,08,82900,0.0
"Castle Pines city, Colorado",3776,3529,247,08,12387,6.541313559322035
"Eldora CDP, Colorado",309,25,284,08,23575,91.9093851132686
"Bow Mar town, Colorado",294,294,0,08,08070,0.0
"Hugo town, Colorado",325,267,58,08,37875,17.846153846153847
"Sawpit town, Colorado",25,22,3,08,68655,12.0
"Boulder city, Colorado",45538,42643,2895,08,07850,6.357327945891343
"Air Force Academy CDP, Colorado",598,558,40,08,00870,6.688963210702341
"Niwot CDP, Colorado",1674,1605,69,08,53780,4.121863799283155
"Fort Carson CDP, Colorado",3019,2757,262,08,27370,8.678370321298443
"Security-Widefield CDP, Colorado",12935,12307,628,08,68847,4.855044453034403
"Aspen Park CDP, Colorado",431,405,26,08,03730,6.0324825986078885
"Golden city, Colorado",8017,7623,394,08,30835,4.9145565672944995
"Fleming town, Colorado",209,205,4,08,26875,1.9138755980861244
"Iliff town, Colorado",134,117,17,08,38590,12.686567164179104
"Vilas town, Colorado",46,38,8,08,81030,17.391304347826086
"Nederland town, Colorado",709,613,96,08,53175,13.540197461212976
"Gleneagle CDP, Colorado",2546,2441,105,08,30420,4.124116260801257
"Deer Trail town, Colorado",252,196,56,08,19630,22.22222222222222
"Foxfield town, Colorado",276,246,30,08,28105,10.869565217391305
"Glendale city, Colorado",3271,3014,257,08,30340,7.856924487924183
"Walsh town, Colorado",403,311,92,08,82460,22.8287841191067
"Ouray city, Colorado",822,425,397,08,56420,48.29683698296837
"Snowmass Village town, Colorado",3112,1255,1857,08,71755,59.67223650385605
"La Veta town, Colorado",536,393,143,08,44100,26.679104477611943
"Walsenburg city, Colorado",1876,1492,384,08,82350,20.46908315565032
"Hillrose town, Colorado",161,136,25,08,36610,15.527950310559005
"Manzanola town, Colorado",232,196,36,08,48500,15.517241379310345
"Swink town, Colorado",327,269,58,08,75970,17.737003058103976
"Granada town, Colorado",277,217,60,08,31550,21.660649819494584
"Avondale CDP, Colorado",237,237,0,08,04165,0.0
"Idaho Springs city, Colorado",1039,983,56,08,38370,5.389797882579403
"Crowley town, Colorado",106,95,11,08,18750,10.377358490566039
"Campo town, Colorado",79,38,41,08,11645,51.89873417721519
"Springfield town, Colorado",810,639,171,08,73330,21.11111111111111
"Keystone CDP, Colorado",4082,416,3666,08,40550,89.80891719745223
"Sugar City town, Colorado",165,127,38,08,74815,23.03030303030303
"Romeo town, Colorado",163,117,46,08,65740,28.22085889570552
"Eaton town, Colorado",1832,1794,38,08,22860,2.074235807860262
"Evans city, Colorado",6860,6710,150,08,25280,2.186588921282799
"La Salle town, Colorado",829,811,18,08,43605,2.1712907117008444
"Pierce town, Colorado",418,404,14,08,59005,3.349282296650718
"Buena Vista town, Colorado",1426,1130,296,08,10105,20.75736325385694
"Brush city, Colorado",2320,2181,139,08,09555,5.991379310344827
"Fort Morgan city, Colorado",4279,4028,251,08,27810,5.8658565085300305
"Towaoc CDP, Colorado",447,385,62,08,78280,13.870246085011187
"Del Norte town, Colorado",911,667,244,08,19795,26.783754116355652
"Steamboat Springs city, Colorado",9837,4815,5022,08,73825,51.05215004574566
"Julesburg town, Colorado",676,563,113,08,39965,16.715976331360945
"Ovid town, Colorado",144,111,33,08,56475,22.916666666666664
"Sedgwick town, Colorado",121,66,55,08,68930,45.45454545454545
"Silverthorne town, Colorado",2327,1482,845,08,70525,36.312849162011176
"Kiowa town, Colorado",363,325,38,08,40790,10.46831955922865
"Ponderosa Park CDP, Colorado",1282,1265,17,08,60655,1.326053042121685
"Lakewood city, Colorado",68099,65737,2362,08,43000,3.468479713358493
"West Pleasant View CDP, Colorado",1706,1662,44,08,84042,2.5791324736225087
"Crook town, Colorado",68,57,11,08,18640,16.176470588235293
"Simla town, Colorado",298,266,32,08,70635,10.738255033557047
"Coal Creek town, Colorado",180,153,27,08,15330,15.0
"Lincoln Park CDP, Colorado",1676,1583,93,08,45145,5.548926014319809
"Williamsburg town, Colorado",249,234,15,08,85155,6.024096385542169
"Central City city, Colorado",527,435,92,08,12910,17.4573055028463
"Winter Park town, Colorado",2575,297,2278,08,85705,88.46601941747572
"Marble town, Colorado",82,47,35,08,48555,42.68292682926829
"Pitkin town, Colorado",233,31,202,08,59830,86.69527896995707
"Fort Collins city, Colorado",65874,62796,3078,08,27425,4.672556699152929
"Telluride town, Colorado",2020,794,1226,08,76795,60.69306930693069
"Leadville city, Colorado",1614,1155,459,08,44320,28.438661710037177
"Allenspark CDP, Colorado",783,190,593,08,01420,75.73435504469987
"Louisville city, Colorado",8509,8202,307,08,46355,3.6079445293218946
"Ward town, Colorado",125,82,43,08,82735,34.4
"Fountain city, Colorado",10249,9793,456,08,27865,4.449214557517807
"Crested Butte town, Colorado",1071,607,464,08,18310,43.32399626517274
"Estes Park town, Colorado",4653,3210,1443,08,25115,31.012250161186333
"Loveland city, Colorado",32735,31285,1450,08,46465,4.4295096990988245
"Dinosaur town, Colorado",187,112,75,08,20495,40.106951871657756
"Black Forest CDP, Colorado",5270,5033,237,08,06970,4.497153700189753
"Otis town, Colorado",300,241,59,08,56365,19.666666666666664
"Naturita town, Colorado",320,232,88,08,53120,27.500000000000004
"Grand View Estates CDP, Colorado",239,239,0,08,31935,0.0
"Garden City town, Colorado",113,105,8,08,29185,7.079646017699115
"Fairplay town, Colorado",399,323,76,08,25610,19.047619047619047
"Brookside town, Colorado",98,91,7,08,09115,7.142857142857142
"Dacono city, Colorado",1881,1849,32,08,19080,1.701222753854333
"Severance town, Colorado",1532,1423,109,08,69150,7.114882506527414
"Haswell town, Colorado",49,30,19,08,34740,38.775510204081634
"Bethune town, Colorado",77,68,9,08,06530,11.688311688311687
"Edgewater city, Colorado",2613,2471,142,08,23135,5.434366628396479
"Merino town, Colorado",108,92,16,08,50040,14.814814814814813
"Pagosa Springs town, Colorado",1111,892,219,08,56860,19.711971197119713
"Penrose CDP, Colorado",1469,1300,169,08,58400,11.504424778761061
"Jamestown town, Colorado",140,97,43,08,39195,30.714285714285715
"Arriba town, Colorado",124,81,43,08,03235,34.67741935483871
"Byers CDP, Colorado",524,468,56,08,10985,10.687022900763358
"La Junta city, Colorado",3464,3003,461,08,42110,13.308314087759815
"Salt Creek CDP, Colorado",280,229,51,08,67445,18.21428571428571
"Vail town, Colorado",7346,2237,5109,08,80040,69.54805336237409
"Craig city, Colorado",4202,3682,520,08,17760,12.375059495478343
"Collbran town, Colorado",177,144,33,08,15605,18.64406779661017
"Stratmoor CDP, Colorado",2245,2182,63,08,74430,2.8062360801781736
"Gunbarrel CDP, Colorado",4458,4397,61,08,33502,1.3683266038582325
"Columbine CDP, Colorado",9788,9521,267,08,16110,2.727829995913363
"Manassa town, Colorado",439,365,74,08,48060,16.856492027334852
"Long Hill CDP, Connecticut",2450,2291,159,09,43790,6.4897959183673475
"Sherwood Manor CDP, Connecticut",2275,2155,120,09,68450,5.274725274725275
"Southwood Acres CDP, Connecticut",3021,2965,56,09,71460,1.8536908308507116
"Weatogue CDP, Connecticut",1016,981,35,09,80770,3.4448818897637796
"New London city, Connecticut",12645,10975,1670,09,52280,13.206801107156979
"Niantic CDP, Connecticut",1900,1448,452,09,53120,23.789473684210527
"Pawcatuck CDP, Connecticut",2649,2391,258,09,59140,9.739524348810873
"Bridgeport city, Connecticut",58370,50547,7823,09,08000,13.402432756553024
"Georgetown CDP, Connecticut",755,732,23,09,30540,3.0463576158940397
"Essex Village CDP, Connecticut",1424,1206,218,09,26370,15.308988764044946
"Fenwick borough, Connecticut",97,39,58,09,27810,59.79381443298969
"Westbrook Center CDP, Connecticut",1744,1099,645,09,81750,36.98394495412844
"Crystal Lake CDP, Connecticut",880,799,81,09,18220,9.204545454545453
"Willimantic CDP, Connecticut",6294,5491,803,09,85810,12.758182395932636
"East Haven CDP, Connecticut",12175,11113,1062,09,22980,8.722792607802875
"Woodmont borough, Connecticut",874,766,108,09,88050,12.356979405034325
"East Hartford CDP, Connecticut",21300,19060,2240,09,22700,10.516431924882628
"Salmon Brook CDP, Connecticut",1114,1045,69,09,66455,6.193895870736086
"West Simsbury CDP, Connecticut",928,836,92,09,83990,9.913793103448276
"Litchfield borough, Connecticut",667,520,147,09,43300,22.038980509745127
"Northwest Harwinton CDP, Connecticut",1361,1168,193,09,55725,14.180749448934607
"Groton Long Point borough, Connecticut",593,251,342,09,34460,57.67284991568297
"Mansfield Center CDP, Connecticut",372,325,47,09,45120,12.634408602150538
"Rockville CDP, Connecticut",3918,3310,608,09,65230,15.518121490556405
"Shelton city, Connecticut",17415,16351,1064,09,68100,6.109675567039908
"Danbury city, Connecticut",32493,29736,2757,09,18430,8.484904440956512
"Poquonock Bridge CDP, Connecticut",784,689,95,09,61730,12.11734693877551
"New Haven city, Connecticut",56102,49770,6332,09,52000,11.286585148479556
"Orange CDP, Connecticut",5120,4939,181,09,57670,3.5351562500000004
"Newtown borough, Connecticut",750,683,67,09,52910,8.933333333333334
"South Woodstock CDP, Connecticut",576,546,30,09,71530,5.208333333333334
"Noank CDP, Connecticut",864,710,154,09,53260,17.824074074074073
"Winsted CDP, Connecticut",3589,3029,560,09,87350,15.603232098077461
"Groton city, Connecticut",4709,4136,573,09,34180,12.168188575069017
"Mystic CDP, Connecticut",2243,2005,238,09,49810,10.610789121711992
"Old Mystic CDP, Connecticut",1567,1438,129,09,57180,8.232291001914486
"Middletown city, Connecticut",20985,19054,1931,09,47290,9.201810817250417
"South Coventry CDP, Connecticut",579,528,51,09,69990,8.808290155440414
"Bethel CDP, Connecticut",4360,4069,291,09,04790,6.674311926605505
"Stamford city, Connecticut",53660,49510,4150,09,73000,7.733879985091316
"Westport CDP, Connecticut",10830,9896,934,09,83570,8.624192059095106
"Plainfield Village CDP, Connecticut",985,886,99,09,60090,10.050761421319796
"Simsbury Center CDP, Connecticut",2572,2469,103,09,69010,4.004665629860031
"South Windham CDP, Connecticut",719,641,78,09,71250,10.848400556328233
"Blue Hills CDP, Connecticut",1088,982,106,09,06050,9.742647058823529
"Glastonbury Center CDP, Connecticut",3466,3376,90,09,31270,2.5966532025389495
"Suffield Depot CDP, Connecticut",630,538,92,09,74655,14.603174603174605
"Glenville CDP, Connecticut",1004,978,26,09,31520,2.589641434262948
"Greenwich CDP, Connecticut",6123,5571,552,09,33690,9.015188633023028
"Lakeville CDP, Connecticut",698,490,208,09,41830,29.799426934097422
"Manchester CDP, Connecticut",13464,12658,806,09,44690,5.986333927510398
"Norfolk CDP, Connecticut",342,257,85,09,53400,24.853801169590643
"Old Greenwich CDP, Connecticut",2320,2186,134,09,56900,5.775862068965517
"Pemberwick CDP, Connecticut",1571,1403,168,09,59210,10.693825588796944
"Putnam CDP, Connecticut",3308,2925,383,09,62640,11.577992744860943
"Riverside CDP, Connecticut",2965,2750,215,09,64530,7.251264755480608
"Sharon CDP, Connecticut",363,231,132,09,67890,36.36363636363637
"Somers CDP, Connecticut",733,733,0,09,69150,0.0
"Southport CDP, Connecticut",846,758,88,09,71040,10.401891252955082
"Thomaston CDP, Connecticut",942,927,15,09,75660,1.5923566878980893
"Waterford CDP, Connecticut",1392,1271,121,09,80210,8.692528735632184
"Watertown CDP, Connecticut",1595,1510,85,09,80420,5.329153605015674
"Mashantucket CDP, Connecticut",70,62,8,09,45995,11.428571428571429
"Plantsville CDP, Connecticut",1081,933,148,09,60260,13.691026827012026
"Windsor Locks CDP, Connecticut",5552,5253,299,09,87140,5.3854466858789625
"New Milford CDP, Connecticut",3386,3011,375,09,52560,11.075014766686357
"Torrington city, Connecticut",16762,14429,2333,09,76500,13.918386827347573
"Norwich city, Connecticut",19076,16271,2805,09,56200,14.704340532606416
"Stonington borough, Connecticut",745,528,217,09,73700,29.12751677852349
"Lake Pocotopaug CDP, Connecticut",1849,1532,317,09,41410,17.144402379664683
"Old Saybrook Center CDP, Connecticut",1148,976,172,09,57390,14.982578397212542
"Trumbull CDP, Connecticut",12856,12427,429,09,77270,3.336963285625389
"Branford Center CDP, Connecticut",3400,3096,304,09,07345,8.941176470588236
"Derby city, Connecticut",5627,5011,616,09,19480,10.947218766660743
"Canton Valley CDP, Connecticut",734,691,43,09,12370,5.858310626702997
"Newington CDP, Connecticut",12786,12394,392,09,52210,3.0658532770217426
"New Hartford Center CDP, Connecticut",592,541,51,09,51420,8.614864864864865
"Oakville CDP, Connecticut",3748,3565,183,09,56690,4.882604055496264
"Terryville CDP, Connecticut",2423,2222,201,09,75240,8.2955014444903
"Moodus CDP, Connecticut",750,662,88,09,49110,11.733333333333333
"Chester Center CDP, Connecticut",727,657,70,09,14370,9.628610729023384
"Durham CDP, Connecticut",1145,1064,81,09,20740,7.074235807860261
"Higganum CDP, Connecticut",676,636,40,09,38050,5.9171597633136095
"Saybrook Manor CDP, Connecticut",981,495,486,09,67050,49.54128440366973
"Bristol city, Connecticut",26465,24460,2005,09,08420,7.576043831475533
"Broad Brook CDP, Connecticut",1851,1677,174,09,08770,9.40032414910859
"New Britain city, Connecticut",31953,28383,3570,09,50370,11.17265984414609
"Heritage Village CDP, Connecticut",3162,2761,401,09,37930,12.681846932321317
"North Grosvenor Dale CDP, Connecticut",643,528,115,09,54730,17.884914463452567
"Cheshire Village CDP, Connecticut",2608,2379,229,09,14200,8.780674846625768
"West Haven city, Connecticut",22170,19576,2594,09,82800,11.700496165990076
"Collinsville CDP, Connecticut",1523,1453,70,09,16120,4.596191726854892
"Hartford city, Connecticut",53864,45879,7985,09,37000,14.824372493687807
"Tariffville CDP, Connecticut",599,599,0,09,75100,0.0
"Oxoboxo River CDP, Connecticut",1453,1204,249,09,58520,17.136958017894013
"Coventry Lake CDP, Connecticut",1402,1227,175,09,17835,12.482168330955776
"Storrs CDP, Connecticut",2105,1824,281,09,73980,13.349168646080761
"Kensington CDP, Connecticut",3749,3460,289,09,40150,7.7087223259535875
"Ansonia city, Connecticut",8351,7452,899,09,01150,10.765177823015208
"Naugatuck borough, Connecticut",12376,11659,717,09,49880,5.793471234647705
"North Haven CDP, Connecticut",9167,8785,382,09,54940,4.1671211955928875
"Woodbury Center CDP, Connecticut",745,692,53,09,87980,7.114093959731544
"Darien CDP, Connecticut",7195,6858,337,09,18920,4.683808200138985
"Clinton CDP, Connecticut",1762,1537,225,09,15420,12.769580022701476
"East Hampton CDP, Connecticut",1059,959,100,09,22420,9.442870632672333
"Norwalk city, Connecticut",36051,33923,2128,09,55990,5.902748883526115
"East Brooklyn CDP, Connecticut",757,655,102,09,21160,13.474240422721268
"Moosup CDP, Connecticut",1532,1359,173,09,49180,11.29242819843342
"Quinebaug CDP, Connecticut",527,500,27,09,63270,5.1233396584440225
"Wauregan CDP, Connecticut",493,419,74,09,80630,15.010141987829615
"Madison Center CDP, Connecticut",1589,1220,369,09,44630,23.222152297042165
"Waterbury city, Connecticut",47364,40579,6785,09,80000,14.32522590997382
"Hazardville CDP, Connecticut",1996,1867,129,09,37770,6.462925851703407
"North Granby CDP, Connecticut",654,539,115,09,54660,17.584097859327215
"Terramuggus CDP, Connecticut",438,438,0,09,75200,0.0
"West Hartford CDP, Connecticut",26149,24491,1658,09,82660,6.340586638112356
"Bethlehem Village CDP, Connecticut",1009,793,216,09,04945,21.407333994053516
"New Preston CDP, Connecticut",617,438,179,09,52770,29.01134521880065
"Jewett City borough, Connecticut",1645,1286,359,09,39940,21.82370820668693
"Wallingford Center CDP, Connecticut",8623,7764,859,09,78880,9.961730256291315
"Wethersfield CDP, Connecticut",11398,10843,555,09,84970,4.86927531145815
"Danielson borough, Connecticut",2216,1822,394,09,18780,17.779783393501805
"Stratford CDP, Connecticut",21734,20084,1650,09,74260,7.591791662832429
"Meriden city, Connecticut",29883,26218,3665,09,46450,12.264498209684437
"Guilford Center CDP, Connecticut",1316,1249,67,09,35020,5.091185410334346
"Thompsonville CDP, Connecticut",3875,3401,474,09,75940,12.23225806451613
"Bantam borough, Connecticut",430,362,68,09,02690,15.813953488372093
"Ridgefield CDP, Connecticut",3453,3141,312,09,63900,9.035621198957429
"Portland CDP, Connecticut",2793,2445,348,09,61870,12.459720730397422
"Milford city (balance), Connecticut",23179,21299,1880,09,47515,8.110789939169075
"Canaan CDP, Connecticut",599,526,73,09,10870,12.186978297161936
"Deep River Center CDP, Connecticut",1171,1064,107,09,19200,9.137489325362939
"Colchester CDP, Connecticut",2316,2137,179,09,15840,7.728842832469776
"Stafford Springs CDP, Connecticut",2295,1975,320,09,72300,13.943355119825709
"Wilton Center CDP, Connecticut",440,385,55,09,86380,12.5
"Baltic CDP, Connecticut",592,496,96,09,02550,16.216216216216218
"Brooklyn CDP, Connecticut",184,184,0,09,09120,0.0
"Byram CDP, Connecticut",1633,1560,73,09,10660,4.470300061236987
"Cannondale CDP, Connecticut",49,10,39,09,11990,79.59183673469387
"Conning Towers Nautilus Park CDP, Connecticut",2657,2459,198,09,16960,7.452013549115543
"Cos Cob CDP, Connecticut",2556,2477,79,09,17520,3.0907668231611893
"Falls Village CDP, Connecticut",231,201,30,09,27390,12.987012987012985
"Gales Ferry CDP, Connecticut",405,385,20,09,30190,4.938271604938271
"Leipsic town, Delaware",85,68,17,10,41700,20.0
"Fenwick Island town, Delaware",781,239,542,10,26880,69.39820742637644
"Georgetown town, Delaware",2706,2528,178,10,29090,6.577974870657798
"Lewes city, Delaware",2744,1629,1115,10,41830,40.63411078717201
"Dover city, Delaware",14953,13639,1314,10,21200,8.787534274058718
"Glasgow CDP, Delaware",5182,5015,167,10,29350,3.222693940563489
"New Castle city, Delaware",2740,2477,263,10,50800,9.598540145985401
"Odessa town, Delaware",252,221,31,10,54050,12.3015873015873
"Bethel town, Delaware",107,82,25,10,05820,23.364485981308412
"Cheswold town, Delaware",633,554,79,10,14660,12.480252764612953
"Delmar town, Delaware",719,627,92,10,20380,12.795549374130738
"Milford city, Delaware",4543,4157,386,10,47420,8.496588157605107
"Ocean View town, Delaware",2271,1047,1224,10,53920,53.89696169088507
"Felton town, Delaware",560,537,23,10,26620,4.107142857142857
"Woodside town, Delaware",101,83,18,10,80830,17.82178217821782
"Woodside East CDP, Delaware",964,864,100,10,80895,10.37344398340249
"Bellefonte town, Delaware",481,466,15,10,04650,3.118503118503119
"Clayton town, Delaware",1070,994,76,10,15440,7.102803738317758
"Frankford town, Delaware",328,272,56,10,28310,17.073170731707318
"Bowers town, Delaware",254,146,108,10,07250,42.51968503937008
"Dover Base Housing CDP, Delaware",1289,1234,55,10,21387,4.266873545384018
"Rodney Village CDP, Delaware",570,510,60,10,61720,10.526315789473683
"Wyoming town, Delaware",688,600,88,10,81350,12.790697674418606
"Brookside CDP, Delaware",5343,4857,486,10,09850,9.09601347557552
"Elsmere town, Delaware",2725,2280,445,10,24540,16.3302752293578
"Wilmington Manor CDP, Delaware",2927,2757,170,10,77840,5.807994533652203
"Bethany Beach town, Delaware",2749,509,2240,10,05690,81.48417606402329
"Dewey Beach town, Delaware",1563,163,1400,10,20900,89.57133717210493
"Ellendale town, Delaware",172,143,29,10,24020,16.86046511627907
"Magnolia town, Delaware",125,102,23,10,44430,18.4
"Henlopen Acres town, Delaware",211,89,122,10,33900,57.81990521327014
"Seaford city, Delaware",3328,3037,291,10,64320,8.743990384615383
"Kenton town, Delaware",88,83,5,10,39100,5.681818181818182
"Viola town, Delaware",62,56,6,10,74330,9.67741935483871
"Arden village, Delaware",218,188,30,10,01400,13.761467889908257
"Hockessin CDP, Delaware",4885,4798,87,10,35850,1.7809621289662232
"Smyrna town, Delaware",4628,4211,417,10,67310,9.010371650821089
"Wilmington city, Delaware",34156,28526,5630,10,77580,16.483194753484014
"Laurel town, Delaware",1645,1348,297,10,41310,18.054711246200608
"Milton town, Delaware",1459,1294,165,10,48330,11.309115832762167
"Ardentown village, Delaware",147,126,21,10,01660,14.285714285714285
"Middletown town, Delaware",7723,7104,619,10,47030,8.015020069921015
"Newport town, Delaware",604,556,48,10,51190,7.9470198675496695
"Pike Creek CDP, Delaware",3267,3254,13,10,56490,0.39791857973676154
"Millsboro town, Delaware",1876,1640,236,10,47940,12.57995735607676
"Selbyville town, Delaware",1042,822,220,10,64840,21.113243761996163
"Slaughter Beach town, Delaware",230,116,114,10,67050,49.56521739130435
"South Bethany town, Delaware",1300,248,1052,10,67700,80.92307692307692
"Camden town, Delaware",1457,1365,92,10,10760,6.314344543582704
"Dagsboro town, Delaware",384,324,60,10,18950,15.625
"Highland Acres CDP, Delaware",1561,1432,129,10,34810,8.263933376040999
"Riverview CDP, Delaware",864,829,35,10,61480,4.050925925925926
"Blades town, Delaware",507,461,46,10,06730,9.072978303747535
"Greenwood town, Delaware",450,393,57,10,31560,12.666666666666668
"Bear CDP, Delaware",8232,7367,865,10,04130,10.507774538386784
"Claymont CDP, Delaware",3889,3478,411,10,15310,10.568269478014914
"Rehoboth Beach city, Delaware",3347,729,2618,10,60290,78.21930086644755
"North Star CDP, Delaware",2890,2752,138,10,52490,4.775086505190312
"Long Neck CDP, Delaware",2380,1159,1221,10,43245,51.30252100840336
"Millville town, Delaware",1083,746,337,10,48200,31.117266851338876
"Farmington town, Delaware",29,29,0,10,25840,0.0
"Frederica town, Delaware",424,364,60,10,28440,14.150943396226415
"Hartly town, Delaware",32,27,5,10,33250,15.625
"Kent Acres CDP, Delaware",799,772,27,10,38710,3.379224030037547
"Little Creek town, Delaware",104,81,23,10,42870,22.115384615384613
"Delaware City city, Delaware",739,658,81,10,19730,10.960757780784844
"Bridgeville town, Delaware",1281,1189,92,10,08680,7.181889149102264
"Greenville CDP, Delaware",1298,1075,223,10,31430,17.180277349768875
"Newark city, Delaware",11670,10626,1044,10,50670,8.946015424164525
"Ardencroft village, Delaware",86,84,2,10,01530,2.3255813953488373
"Houston town, Delaware",188,148,40,10,36760,21.27659574468085
"Rising Sun-Lebanon CDP, Delaware",1573,1470,103,10,61265,6.547997457088366
"Townsend town, Delaware",647,641,6,10,72510,0.9273570324574961
"Harrington city, Delaware",1474,1206,268,10,33120,18.181818181818183
"Edgemoor CDP, Delaware",2993,2702,291,10,23240,9.72268626795857
"Pike Creek Valley CDP, Delaware",4960,4598,362,10,56500,7.298387096774193
"St. Georges CDP, Delaware",322,274,48,10,63800,14.906832298136646
"Washington city, District of Columbia",311545,281322,30223,11,50000,9.70100627517694
"Haverhill town, Florida",675,621,54,12,29200,8.0
"Jupiter town, Florida",32599,25910,6689,12,35875,20.519034326206327
"Lake Belvedere Estates CDP, Florida",1182,1079,103,12,37542,8.714043993231812
"Clearwater city, Florida",58103,46667,11436,12,12875,19.682288349999137
"Harbor Bluffs CDP, Florida",1114,1102,12,12,28650,1.0771992818671454
"Indian Shores town, Florida",2488,716,1772,12,33675,71.22186495176848
"Palm Harbor CDP, Florida",30892,26674,4218,12,54350,13.6540204583711
"Tierra Verde CDP, Florida",2336,1579,757,12,71825,32.40582191780822
"Miramar Beach CDP, Florida",13721,3944,9777,12,46000,71.25573937759638
"Paxton town, Florida",372,298,74,12,55475,19.892473118279568
"Sky Lake CDP, Florida",2212,1836,376,12,66425,16.998191681735985
"Taft CDP, Florida",864,554,310,12,70525,35.879629629629626
"New Port Richey East CDP, Florida",5327,4739,588,12,48525,11.038107752956636
"Port Richey city, Florida",1813,1342,471,12,58600,25.97904026475455
"Laguna Beach CDP, Florida",4934,1952,2982,12,37500,60.43777867855695
"Panama City Beach city, Florida",16772,5490,11282,12,54725,67.26687336036251
"Coral Terrace CDP, Florida",7736,7420,316,12,14412,4.084798345398139
"Country Walk CDP, Florida",4777,4704,73,12,15055,1.5281557462842787
"North Miami city, Florida",20518,18040,2478,12,49450,12.077200506872014
"Princeton CDP, Florida",8430,7863,567,12,58975,6.725978647686833
"Richmond Heights CDP, Florida",2929,2781,148,12,60225,5.05291908501195
"Samoset CDP, Florida",1337,1169,168,12,63225,12.56544502617801
"Marineland town, Florida",14,0,14,12,43250,100.0
"Arcadia city, Florida",3345,2823,522,12,01750,15.605381165919283
"Lake Placid town, Florida",908,642,266,12,38625,29.295154185022028
"High Springs city, Florida",2343,2107,236,12,30525,10.072556551429791
"Tamarac city, Florida",31084,26787,4297,12,70675,13.82383219662849
"Sneads town, Florida",947,833,114,12,66725,12.038014783526927
"Geneva CDP, Florida",1085,1002,83,12,25750,7.649769585253456
"Winter Springs city, Florida",14706,13521,1185,12,78325,8.057935536515707
"Hollywood city, Florida",69710,56542,13168,12,32000,18.889685841342704
"Plantation city, Florida",37731,33610,4121,12,57425,10.922053483872677
"Sea Ranch Lakes village, Florida",259,193,66,12,64725,25.482625482625483
"Wilton Manors city, Florida",7994,6625,1369,12,78000,17.125344008006003
"Rotonda CDP, Florida",6656,4450,2206,12,61937,33.14302884615385
"Inverness city, Florida",4081,3325,756,12,33950,18.524871355060036
"Inverness Highlands South CDP, Florida",3244,2782,462,12,33966,14.241676942046855
"Lecanto CDP, Florida",2600,2122,478,12,39825,18.384615384615387
"Sugarmill Woods CDP, Florida",5138,4176,962,12,68950,18.72323861424679
"Jay town, Florida",236,184,52,12,35425,22.033898305084744
"Fort Pierce city, Florida",21498,16499,4999,12,24300,23.253325890780538
"Milton city, Florida",4478,3725,753,12,45750,16.815542652970077
"Newberry city, Florida",2183,1873,310,12,48200,14.200641319285387
"Brent CDP, Florida",8504,7255,1249,12,08300,14.687206020696141
"Sewall's Point town, Florida",944,851,93,12,65225,9.851694915254237
"Starke city, Florida",2488,2069,419,12,68525,16.840836012861736
"Stuart city, Florida",9146,6971,2175,12,68875,23.780887819811937
"Lynn Haven city, Florida",8476,7632,844,12,41825,9.957527135441246
"Hampton city, Florida",233,201,32,12,28575,13.733905579399142
"Altha town, Florida",280,216,64,12,01000,22.857142857142858
"Holmes Beach city, Florida",4623,2254,2369,12,32150,51.243781094527364
"Butler Beach CDP, Florida",4285,2338,1947,12,09630,45.43757292882147
"Crescent Beach CDP, Florida",1944,519,1425,12,15325,73.30246913580247
"Sawgrass CDP, Florida",3266,2329,937,12,64525,28.689528475199022
"Aventura city, Florida",31405,18718,12687,12,02681,40.39802579207132
"Brownsville CDP, Florida",6061,5322,739,12,09000,12.192707474014188
"Florida City city, Florida",3234,2810,424,12,22975,13.11069882498454
"Hialeah Gardens city, Florida",6899,6633,266,12,30025,3.8556312509059283
"Ives Estates CDP, Florida",8475,7484,991,12,34400,11.693215339233038
"Kendall CDP, Florida",30114,26806,3308,12,36100,10.984923955635253
"Miami Beach city, Florida",70187,44283,25904,12,45025,36.9071195520538
"Pinecrest village, Florida",6608,6033,575,12,56625,8.701573849878935
"Pinewood CDP, Florida",5467,4920,547,12,57250,10.005487470276202
"The Crossings CDP, Florida",8087,7530,557,12,71567,6.887597378508718
"Bushnell city, Florida",1807,1187,620,12,09625,34.31101272827892
"South Beach CDP, Florida",2488,1656,832,12,67192,33.440514469453376
"Vero Beach city, Florida",10837,7200,3637,12,74150,33.56094860201163
"Fernandina Beach city, Florida",7326,5451,1875,12,22175,25.593775593775593
"Dunnellon city, Florida",1396,1090,306,12,18675,21.91977077363897
"Ocala city, Florida",26900,22245,4655,12,50750,17.30483271375465
"Reddick town, Florida",273,232,41,12,59675,15.018315018315018
"Cocoa Beach city, Florida",8773,5803,2970,12,13175,33.853869827881
"Cocoa West CDP, Florida",2909,2320,589,12,13225,20.247507734616708
"June Park CDP, Florida",1891,1698,193,12,35800,10.206240084611316
"Broadview Park CDP, Florida",2359,2257,102,12,08650,4.323866044934294
"Davie town, Florida",39239,35096,4143,12,16475,10.558373047223425
"Franklin Park CDP, Florida",403,341,62,12,24710,15.384615384615385
"Hillsboro Pines CDP, Florida",178,178,0,12,30858,0.0
"South Patrick Shores CDP, Florida",3037,2765,272,12,67725,8.956206783009549
"Astatula town, Florida",681,566,115,12,02250,16.886930983847286
"Clermont city, Florida",14758,12462,2296,12,12925,15.55766364005963
"Lady Lake town, Florida",9513,7669,1844,12,37375,19.38400084095448
"Cooper City city, Florida",11712,11209,503,12,14125,4.29474043715847
"Coral Springs city, Florida",44720,41560,3160,12,14400,7.0661896243291595
"East Williston CDP, Florida",283,276,7,12,19575,2.4734982332155475
"South Brooksville CDP, Florida",2174,1801,373,12,67266,17.157313707451703
"Weeki Wachee city, Florida",3,2,1,12,75625,33.33333333333333
"Crescent City city, Florida",957,680,277,12,15375,28.94461859979101
"Williston city, Florida",1062,969,93,12,77825,8.757062146892656
"Belleair Beach city, Florida",1114,745,369,12,05100,33.123877917414724
"North Redington Beach town, Florida",1377,696,681,12,49725,49.45533769063181
"Ridgecrest CDP, Florida",1112,1018,94,12,60275,8.453237410071942
"Lake Panasoffkee CDP, Florida",2253,1471,782,12,38575,34.709276520195296
"Margate city, Florida",26799,22330,4469,12,43125,16.675995372961676
"Fellsmere city, Florida",1377,1088,289,12,22100,20.98765432098765
"Indian River Shores town, Florida",3574,1969,1605,12,33600,44.9076664801343
"Sebastian city, Florida",11030,9251,1779,12,64825,16.128739800543972
"Wabasso CDP, Florida",276,251,25,12,74625,9.057971014492754
"West Vero Corridor CDP, Florida",6277,4280,1997,12,76937,31.814561096065
"Winter Beach CDP, Florida",1085,823,262,12,78225,24.147465437788018
"Century town, Florida",842,650,192,12,11362,22.802850356294538
"Molino CDP, Florida",579,467,112,12,46225,19.343696027633854
"Fern Park CDP, Florida",3669,3330,339,12,22250,9.239574816026165
"Campbellton town, Florida",147,87,60,12,09900,40.816326530612244
"Malone town, Florida",360,265,95,12,42650,26.38888888888889
"Lake Lorraine CDP, Florida",3108,2932,176,12,38287,5.662805662805663
"Lake Mary city, Florida",6910,6052,858,12,38425,12.416787264833575
"Longwood city, Florida",6136,5590,546,12,41250,8.898305084745763
"North Lauderdale city, Florida",14496,13252,1244,12,49425,8.58167770419426
"Alachua city, Florida",4172,3687,485,12,00375,11.625119846596357
"Bunnell city, Florida",1259,1043,216,12,09550,17.156473391580622
"Greenwood town, Florida",320,240,80,12,27600,25.0
"Niceville city, Florida",6222,5668,554,12,48750,8.903889424622308
"Ocean City CDP, Florida",2928,2578,350,12,50925,11.953551912568305
"Heathrow CDP, Florida",2967,2630,337,12,29320,11.358274351196494
"Crestview city, Florida",9508,8336,1172,12,15475,12.326461926798485
"Ensley CDP, Florida",10690,9226,1464,12,20925,13.695042095416277
"Ferry Pass CDP, Florida",14811,13326,1485,12,22275,10.026331780433463
"Goulding CDP, Florida",1222,948,274,12,26925,22.42225859247136
"Shalimar town, Florida",375,342,33,12,65425,8.799999999999999
"Orchid town, Florida",360,208,152,12,52175,42.22222222222222
"Callahan town, Florida",650,592,58,12,09700,8.923076923076923
"Center Hill city, Florida",397,293,104,12,11325,26.19647355163728
"Coleman city, Florida",370,234,136,12,13400,36.75675675675676
"Bayshore Gardens CDP, Florida",10050,7941,2109,12,04350,20.98507462686567
"Key Largo CDP, Florida",8929,4215,4714,12,36375,52.79426587523799
"Key West city, Florida",13631,10021,3610,12,36550,26.483750275108207
"Freeport city, Florida",1282,1091,191,12,24825,14.898595943837753
"Bay Harbor Islands town, Florida",3106,2434,672,12,03975,21.635544108177722
"Glenvar Heights CDP, Florida",8126,7150,976,12,26100,12.010829436377062
"Treasure Island city, Florida",5956,3640,2316,12,72325,38.885157824042984
"Bay Pines CDP, Florida",1843,1437,406,12,04200,22.02930005425936
"Belle Glade city, Florida",7495,6434,1061,12,05200,14.156104069379586
"Delray Beach city, Florida",34575,27609,6966,12,17100,20.147505422993493
"Lake Harbor CDP, Florida",33,6,27,12,38000,81.81818181818183
"Lantana town, Florida",5267,4238,1029,12,39375,19.536738181127777
"Ocean Ridge town, Florida",1472,799,673,12,50950,45.72010869565217
"Brooksville city, Florida",4387,3524,863,12,08800,19.671757465238205
"North Brooksville CDP, Florida",1447,1241,206,12,49237,14.236351071181755
"Timber Pines CDP, Florida",3880,3054,826,12,71867,21.288659793814432
"Pomona Park town, Florida",493,330,163,12,58025,33.062880324543606
"Bokeelia CDP, Florida",1251,711,540,12,07375,43.16546762589928
"Whiskey Creek CDP, Florida",2621,2232,389,12,77137,14.841663487218618
"Elfers CDP, Florida",6640,5302,1338,12,20275,20.150602409638555
"Hudson CDP, Florida",7893,6018,1875,12,32825,23.755226149752946
"Feather Sound CDP, Florida",2053,1769,284,12,21945,13.833414515343401
"Zephyrhills city, Florida",8475,6535,1940,12,79225,22.89085545722714
"Zephyrhills South CDP, Florida",3865,2534,1331,12,79237,34.4372574385511
"Dunedin city, Florida",20781,17364,3417,12,18575,16.442904576295657
"Redington Shores town, Florida",2221,1205,1016,12,59750,45.745159837910855
"Safety Harbor city, Florida",8018,7050,968,12,62425,12.07283611873285
"Biscayne Park village, Florida",1089,1011,78,12,06600,7.162534435261708
"Coral Gables city, Florida",21240,17820,3420,12,14250,16.101694915254235
"Country Club CDP, Florida",17678,16527,1151,12,14895,6.510917524606856
"Kendall West CDP, Florida",12087,11541,546,12,36121,4.517249937949863
"Key Biscayne village, Florida",7340,4367,2973,12,36300,40.50408719346049
"Miami Shores village, Florida",3707,3262,445,12,45175,12.00431615861883
"Register town, Georgia",63,50,13,13,64372,20.634920634920633
"Statesboro city, Georgia",12041,10210,1831,13,73256,15.20637820779005
"North Druid Hills CDP, Georgia",9618,8517,1101,13,56168,11.447286338116031
"Midville city, Georgia",170,140,30,13,51240,17.647058823529413
"Pulaski town, Georgia",118,96,22,13,63000,18.64406779661017
"Gresham Park CDP, Georgia",3477,3061,416,13,35240,11.96433707218867
"Pinehurst city, Georgia",187,144,43,13,60984,22.994652406417114
"Jakin city, Georgia",113,97,16,13,41792,14.15929203539823
"Elberton city, Georgia",2289,1713,576,13,26616,25.16382699868938
"Martinez CDP, Georgia",14830,12124,2706,13,50036,18.246797033041133
"Fair Oaks CDP, Georgia",3428,3108,320,13,28520,9.334889148191365
"Powder Springs city, Georgia",5634,5277,357,13,62524,6.336528221512247
"Brooks town, Georgia",229,203,26,13,11056,11.353711790393014
"Doerun city, Georgia",359,272,87,13,23284,24.233983286908078
"Sparta city, Georgia",875,761,114,13,72584,13.028571428571428
"Blackshear city, Georgia",1492,1389,103,13,08284,6.90348525469169
"Patterson city, Georgia",386,319,67,13,59500,17.357512953367877
"Eatonton city, Georgia",3042,2411,631,13,26084,20.74293228139382
"Waynesboro city, Georgia",2347,2090,257,13,80984,10.950149126544526
"Doraville city, Georgia",3349,3159,190,13,23536,5.673335323977307
"Pooler city, Georgia",8985,8655,330,13,62104,3.672787979966611
"Skidaway Island CDP, Georgia",4467,4102,365,13,71184,8.171032012536378
"Sparks town, Georgia",935,793,142,13,72556,15.187165775401072
"Rhine town, Georgia",306,238,68,13,64932,22.22222222222222
"Bowman city, Georgia",411,346,65,13,09712,15.815085158150852
"Grovetown city, Georgia",5554,4370,1184,13,35716,21.317969031328772
"Harlem city, Georgia",1320,966,354,13,36696,26.81818181818182
"Coolidge city, Georgia",206,156,50,13,19392,24.271844660194176
"Waleska city, Georgia",107,85,22,13,79948,20.5607476635514
"Alpharetta city, Georgia",25470,23790,1680,13,01696,6.595995288574794
"Roswell city, Georgia",36731,34430,2301,13,67284,6.264463259916692
"Tallapoosa city, Georgia",1527,1377,150,13,75300,9.823182711198427
"Hartwell city, Georgia",1854,1572,282,13,37144,15.210355987055015
"Talking Rock town, Georgia",46,46,0,13,75272,0.0
"Meigs city, Georgia",449,366,83,13,50680,18.485523385300667
"Orchard Hill town, Georgia",105,85,20,13,58296,19.047619047619047
"Geneva town, Georgia",82,59,23,13,32412,28.04878048780488
"Junction City town, Georgia",97,83,14,13,42800,14.432989690721648
"Rochelle city, Georgia",595,385,210,13,66024,35.294117647058826
"Turin town, Georgia",167,166,1,13,77764,0.5988023952095809
"Boston city, Georgia",583,491,92,13,09460,15.780445969125214
"Monroe city, Georgia",5536,4981,555,13,52192,10.025289017341041
"Irwinton city, Georgia",232,173,59,13,41400,25.43103448275862
"Hannahs Mill CDP, Georgia",1553,1260,293,13,36416,18.866709594333546
"Norwood city, Georgia",147,111,36,13,56560,24.489795918367346
"Riddleville town, Georgia",25,19,6,13,65156,24.0
"Tennille city, Georgia",908,696,212,13,75888,23.348017621145374
"Glenwood city, Georgia",261,198,63,13,33392,24.137931034482758
"Berkeley Lake city, Georgia",763,723,40,13,07248,5.242463958060288
"Grayson city, Georgia",1184,1165,19,13,34596,1.6047297297297296
"Lawrenceville city, Georgia",11443,10377,1066,13,45488,9.315738879664423
"Varnell city, Georgia",825,766,59,13,78996,7.151515151515151
"Milledgeville city, Georgia",7438,6000,1438,13,51492,19.33315407367572
"Carl town, Georgia",81,79,2,13,13184,2.4691358024691357
"Cochran city, Georgia",2014,1484,530,13,17328,26.31578947368421
"Unionville CDP, Georgia",808,727,81,13,78464,10.024752475247526
"Jeffersonville city, Georgia",552,370,182,13,42100,32.971014492753625
"McIntyre town, Georgia",328,242,86,13,48848,26.21951219512195
"Blairsville city, Georgia",256,190,66,13,08480,25.78125
"Salem CDP, Georgia",158,151,7,13,68129,4.430379746835443
"St. Simons CDP, Georgia",10991,6720,4271,13,68040,38.859066508961874
"Yatesville town, Georgia",217,184,33,13,84708,15.207373271889402
"Waycross city, Georgia",7206,5760,1446,13,80956,20.06661115736886
"Dock Junction CDP, Georgia",3711,3402,309,13,23200,8.326596604688763
"Morgan city, Georgia",133,95,38,13,52696,28.57142857142857
"Redan CDP, Georgia",12439,11315,1124,13,63952,9.036096149208134
"Stone Mountain city, Georgia",2626,2274,352,13,73816,13.404417364813403
"Mitchell town, Georgia",88,65,23,13,51968,26.136363636363637
"Alto town, Georgia",467,370,97,13,01948,20.770877944325484
"Menlo city, Georgia",226,207,19,13,50848,8.4070796460177
"Douglas city, Georgia",4858,4121,737,13,23872,15.17085220255249
"Royston city, Georgia",1367,1207,160,13,67452,11.704462326261886
"Brunswick city, Georgia",7659,6395,1264,13,11560,16.50345998172085
"Woodville city, Georgia",188,165,23,13,84260,12.23404255319149
"Baldwin city, Georgia",1113,987,126,13,04980,11.320754716981133
"Maysville town, Georgia",832,749,83,13,50484,9.975961538461538
"Ellenton town, Georgia",113,76,37,13,27008,32.743362831858406
"Hawkinsville city, Georgia",1731,1364,367,13,37396,21.201617562102832
"Belvedere Park CDP, Georgia",7202,6138,1064,13,06884,14.773673979450152
"Holly Springs city, Georgia",4116,4041,75,13,39524,1.8221574344023324
"Druid Hills CDP, Georgia",4030,3561,469,13,24264,11.63771712158809
"Guyton city, Georgia",725,656,69,13,35884,9.517241379310343
"Bellville city, Georgia",74,70,4,13,06688,5.405405405405405
"Dawsonville city, Georgia",1066,948,118,13,21940,11.069418386491558
"Cave Spring city, Georgia",567,480,87,13,14108,15.343915343915343
"Woolsey town, Georgia",74,70,4,13,84288,5.405405405405405
"Carnesville city, Georgia",296,231,65,13,13352,21.95945945945946
"Franklin Springs city, Georgia",287,244,43,13,31320,14.982578397212542
"Commerce city, Georgia",2677,2398,279,13,19112,10.422114307060141
"Lone Oak town, Georgia",65,42,23,13,47252,35.38461538461539
"Arnoldsville city, Georgia",194,180,14,13,03124,7.216494845360824
"Molena city, Georgia",180,151,29,13,52108,16.11111111111111
"Newington town, Georgia",133,115,18,13,54992,13.533834586466165
"Hampton city, Georgia",2641,2317,324,13,36276,12.268080272624006
"Remerton city, Georgia",708,526,182,13,64596,25.70621468926554
"Hoschton city, Georgia",622,565,57,13,40056,9.163987138263666
"Gumbranch city, Georgia",107,85,22,13,35800,20.5607476635514
"Riceboro city, Georgia",353,302,51,13,64960,14.44759206798867
"Colbert city, Georgia",273,241,32,13,17552,11.72161172161172
"Luthersville city, Georgia",392,300,92,13,48008,23.46938775510204
"Byron city, Georgia",2363,2267,96,13,12260,4.062632247143462
"Cuthbert city, Georgia",1361,1155,206,13,21072,15.135929463629685
"Shellman city, Georgia",509,438,71,13,70120,13.948919449901767
"Hephzibah city, Georgia",1688,1523,165,13,38040,9.774881516587678
"Oliver city, Georgia",166,121,45,13,58100,27.10843373493976
"Meansville city, Georgia",72,46,26,13,50596,36.11111111111111
"Tiger town, Georgia",222,148,74,13,76504,33.33333333333333
"Sasser town, Georgia",130,116,14,13,68796,10.76923076923077
"Fairview CDP, Georgia",2966,2464,502,13,28632,16.925151719487523
"Albany city, Georgia",33753,28741,5012,13,01052,14.84905045477439
"Bartow town, Georgia",138,99,39,13,05680,28.26086956521739
"Barnesville city, Georgia",2377,1995,382,13,05344,16.070677324358435
"Thomson city, Georgia",3074,2711,363,13,76280,11.80871828236825
"Oglethorpe city, Georgia",684,545,139,13,57736,20.321637426900587
"Rutledge city, Georgia",432,403,29,13,67760,6.712962962962964
"Locust Grove city, Georgia",2267,2114,153,13,47140,6.749007498897221
"McDonough city, Georgia",9269,8458,811,13,48624,8.749595425612256
"Nicholson city, Georgia",701,499,202,13,55468,28.815977175463626
"Sugar Hill city, Georgia",7240,6990,250,13,74180,3.4530386740331496
"Lakeland city, Georgia",1338,1082,256,13,44592,19.13303437967115
"Putney CDP, Georgia",1173,952,221,13,63084,18.84057971014493
"Snellville city, Georgia",6481,6077,404,13,71604,6.233605925011573
"Dalton city, Georgia",12890,11461,1429,13,21380,11.08611326609775
"Candler-McAfee CDP, Georgia",10233,8812,1421,13,12834,13.886445812567185
"Alapaha town, Georgia",451,378,73,13,01024,16.186252771618626
"Nahunta city, Georgia",403,300,103,13,54124,25.55831265508685
"Davisboro city, Georgia",210,168,42,13,21800,20.0
"Flovilla city, Georgia",320,294,26,13,30312,8.125
"Harrison town, Georgia",216,171,45,13,36920,20.833333333333336
"Scotland city, Georgia",178,140,38,13,69336,21.34831460674157
"Lakeview CDP, Georgia",2191,1851,340,13,44900,15.518028297581013
"Temple city, Georgia",1598,1505,93,13,75832,5.819774718397998
"Fargo city, Georgia",148,96,52,13,28744,35.13513513513514
"Springfield city, Georgia",1387,1341,46,13,72780,3.316510454217736
"Canton city, Georgia",10046,9688,358,13,12988,3.5636074059327094
"Suwanee city, Georgia",7064,6699,365,13,74936,5.1670441676104195
"Hogansville city, Georgia",1356,1058,298,13,39244,21.976401179941004
"Ashburn city, Georgia",2013,1477,536,13,03236,26.626924987580725
"Lilburn city, Georgia",4168,3915,253,13,46356,6.070057581573896
"Mountain Park CDP, Georgia",4734,4626,108,13,53186,2.2813688212927756
"Pearson city, Georgia",839,610,229,13,59808,27.29439809296782
"Auburn city, Georgia",2453,2241,212,13,04140,8.642478597635549
"Winder city, Georgia",5995,5337,658,13,83420,10.97581317764804
"Fitzgerald city, Georgia",4235,3465,770,13,29528,18.181818181818183
"Bowdon city, Georgia",928,846,82,13,09544,8.836206896551724
"Savannah city, Georgia",62236,53187,9049,13,69000,14.539816183559354
"Haralson town, Georgia",73,70,3,13,36528,4.10958904109589
"Ochlocknee town, Georgia",314,232,82,13,57372,26.11464968152866
"Ty Ty city, Georgia",353,336,17,13,78100,4.815864022662889
"Danville town, Georgia",113,64,49,13,21688,43.36283185840708
"Oconee city, Georgia",154,131,23,13,57456,14.935064935064934
"Dacula city, Georgia",2059,1871,188,13,21184,9.130645944633317
"Tunnel Hill city, Georgia",454,454,0,13,77736,0.0
"Warrenton city, Georgia",1007,855,152,13,80592,15.09433962264151
"Homerville city, Georgia",1275,978,297,13,39748,23.294117647058822
"Buford city, Georgia",5199,4818,381,13,11784,7.328332371609925
"Rest Haven town, Georgia",63,56,7,13,64792,11.11111111111111
"Ocilla city, Georgia",1345,1144,201,13,57428,14.944237918215613
"Willacoochee city, Georgia",697,492,205,13,82972,29.411764705882355
"Statham city, Georgia",1026,951,75,13,73312,7.309941520467836
"Hoboken city, Georgia",241,224,17,13,39216,7.053941908713693
"Pembroke city, Georgia",1007,854,153,13,60004,15.193644488579942
"Indian Springs CDP, Georgia",943,906,37,13,41036,3.923647932131495
"Mount Zion city, Georgia",725,684,41,13,53620,5.655172413793103
"Vernonburg town, Georgia",59,41,18,13,79164,30.508474576271187
"Eastman city, Georgia",2223,1841,382,13,25552,17.183985605038238
"Pavo city, Georgia",304,262,42,13,59556,13.815789473684212
"Fort Oglethorpe city, Georgia",4496,3991,505,13,30956,11.232206405693951
"Ringgold city, Georgia",1655,1488,167,13,65324,10.090634441087614
"Kingsland city, Georgia",6544,6015,529,13,43640,8.083740831295843
"Monticello city, Georgia",1386,1063,323,13,52416,23.304473304473305
"Denton city, Georgia",84,60,24,13,22388,28.57142857142857
"Leesburg city, Georgia",1005,909,96,13,45768,9.55223880597015
"East Dublin city, Georgia",1256,1010,246,13,25300,19.5859872611465
"Pelham city, Georgia",1400,1289,111,13,59976,7.928571428571428
"Culloden city, Georgia",94,80,14,13,20848,14.893617021276595
"Flemington city, Georgia",272,229,43,13,30088,15.808823529411764
"Forsyth city, Georgia",1785,1522,263,13,30732,14.73389355742297
"Buckhead town, Georgia",73,68,5,13,11672,6.8493150684931505
"Stockbridge city, Georgia",10714,9752,962,13,73704,8.978906104162778
"Fort Stewart CDP, Georgia",2968,2455,513,13,31068,17.28436657681941
"Darien city, Georgia",1342,1060,282,13,21716,21.013412816691503
"Sharon city, Georgia",75,62,13,13,69896,17.333333333333336
"Covington city, Georgia",5518,5071,447,13,20064,8.100761145342515
"Crawford city, Georgia",377,350,27,13,20288,7.161803713527852
"Cairo city, Georgia",3974,3399,575,13,12400,14.469048817312533
"Shady Dale town, Georgia",157,124,33,13,69784,21.019108280254777
"Louisville city, Georgia",1166,950,216,13,47560,18.524871355060036
"Wrens city, Georgia",1026,841,185,13,84456,18.03118908382066
"Milner city, Georgia",379,363,16,13,51604,4.221635883905013
"Smithville city, Georgia",312,249,63,13,71464,20.192307692307693
"Dudley city, Georgia",327,281,46,13,24488,14.067278287461773
"Montrose town, Georgia",90,72,18,13,52500,20.0
"Dahlonega city, Georgia",2230,1900,330,13,21240,14.798206278026907
"Morven city, Georgia",311,283,28,13,53032,9.003215434083602
"Alma city, Georgia",1382,1064,318,13,01612,23.01013024602026
"Enigma town, Georgia",433,354,79,13,27596,18.244803695150118
"Ray City city, Georgia",537,420,117,13,63728,21.787709497206702
"Richmond Hill city, Georgia",4438,4251,187,13,65044,4.213609734114466
"Folkston city, Georgia",1225,1023,202,13,30424,16.48979591836735
"Homeland city, Georgia",300,248,52,13,39692,17.333333333333336
"Carrollton city, Georgia",9919,8906,1013,13,13492,10.212723056759753
"Isle of Hope CDP, Georgia",1133,1020,113,13,41484,9.973521624007061
"Port Wentworth city, Georgia",3509,3179,330,13,62328,9.404388714733543
"Du Pont town, Georgia",95,74,21,13,24796,22.105263157894736
"Sharpsburg town, Georgia",174,166,8,13,69980,4.597701149425287
"Grantville city, Georgia",1140,1058,82,13,34428,7.192982456140351
"Newnan city, Georgia",15510,14771,739,13,55020,4.764667956157318
"Senoia city, Georgia",1439,1367,72,13,69672,5.003474635163308
"LaGrange city, Georgia",12607,11005,1602,13,44340,12.707226144205599
"West Point city, Georgia",1871,1559,312,13,82132,16.675574559059328
"Lincoln Park CDP, Georgia",336,214,122,13,46524,36.30952380952381
"Deenwood CDP, Georgia",1218,1126,92,13,22080,7.55336617405583
"Duluth city, Georgia",11970,11152,818,13,24600,6.83375104427736
"Loganville city, Georgia",4070,3792,278,13,47196,6.830466830466831
"Hapeville city, Georgia",3303,2664,639,13,36472,19.346049046321525
"Riverdale city, Georgia",6553,5875,678,13,65464,10.34640622615596
"Climax city, Georgia",112,79,33,13,16908,29.464285714285715
"Douglasville city, Georgia",13391,12501,890,13,23900,6.646254947352699
"Buchanan city, Georgia",546,453,93,13,11616,17.032967032967033
"Reed Creek CDP, Georgia",2465,1179,1286,13,64288,52.17038539553752
"Rockmart city, Georgia",1768,1552,216,13,66276,12.217194570135746
"Donalsonville city, Georgia",1260,982,278,13,23368,22.063492063492063
"Iron City town, Georgia",160,123,37,13,41344,23.125
"East Griffin CDP, Georgia",611,497,114,13,25440,18.657937806873978
"Griffin city, Georgia",10227,8918,1309,13,35324,12.799452429842573
"Glennville city, Georgia",1867,1532,335,13,33336,17.943224424209962
"Lumber City city, Georgia",772,491,281,13,47952,36.39896373056995
"Helen city, Georgia",803,205,598,13,37788,74.47073474470734
"Parrott town, Georgia",101,60,41,13,59416,40.5940594059406
"Vidalia city, Georgia",4746,4169,577,13,79388,12.157606405394015
"Screven city, Georgia",428,361,67,13,69448,15.654205607476634
"Warwick city, Georgia",190,171,19,13,80676,10.0
"Irondale CDP, Georgia",2456,2256,200,13,41347,8.143322475570033
"Chattanooga Valley CDP, Georgia",1739,1472,267,13,15585,15.35365152386429
"Jonesboro city, Georgia",1352,1210,142,13,42604,10.502958579881657
"Bronwood town, Georgia",177,127,50,13,10860,28.24858757062147
"Dawson city, Georgia",1947,1442,505,13,21912,25.937339496661533
"Washington city, Georgia",1970,1625,345,13,80704,17.512690355329948
"Rome city, Georgia",15776,13994,1782,13,66668,11.295638945233266
"Gray city, Georgia",1338,1243,95,13,34512,7.100149476831091
"Hinesville city, Georgia",15583,13103,2480,13,38964,15.914778925752424
"Dasher town, Georgia",351,289,62,13,21744,17.663817663817664
"Valdosta city, Georgia",24568,20764,3804,13,78800,15.483555845001629
"Comer city, Georgia",563,512,51,13,19084,9.058614564831261
"Danielsville city, Georgia",335,319,16,13,21632,4.776119402985075
"Martin town, Georgia",298,242,56,13,50008,18.79194630872483
"Adrian city, Georgia",300,224,76,13,00660,25.333333333333336
"Oak Park town, Georgia",262,241,21,13,57232,8.015267175572518
"Fayetteville city, Georgia",6978,6601,377,13,28968,5.402694181713958
"Peachtree City city, Georgia",14080,13196,884,13,59724,6.278409090909092
"Gumlog CDP, Georgia",1618,924,694,13,35814,42.89245982694685
"Union Point city, Georgia",834,712,122,13,78380,14.628297362110313
"Centerville city, Georgia",3329,3007,322,13,14920,9.672574346650647
"Baxley city, Georgia",1995,1530,465,13,06016,23.308270676691727
"Winterville city, Georgia",513,446,67,13,83728,13.060428849902534
"Edge Hill city, Georgia",12,6,6,13,26224,50.0
"Lula city, Georgia",1144,959,185,13,47896,16.171328671328673
"Moultrie city, Georgia",5945,4876,1069,13,53060,17.981497056349873
"Norman Park city, Georgia",415,365,50,13,55860,12.048192771084338
"Girard town, Georgia",74,61,13,13,32916,17.56756756756757
"Chamblee city, Georgia",12082,10983,1099,13,15172,9.096176129779836
"Clarkston city, Georgia",4135,3770,365,13,16544,8.827085852478838
"Lithonia city, Georgia",983,827,156,13,46860,15.869786368260428
"Pine Lake city, Georgia",425,381,44,13,61040,10.352941176470589
"North Decatur CDP, Georgia",8628,8167,461,13,56112,5.343069077422346
"Scottdale CDP, Georgia",4789,4180,609,13,69392,12.71664230528294
"Whitemarsh Island CDP, Georgia",3208,2863,345,13,82636,10.754364089775562
"Woodbine city, Georgia",613,500,113,13,83868,18.43393148450245
"Roopville town, Georgia",96,88,8,13,66696,8.333333333333332
"Villa Rica city, Georgia",5587,5152,435,13,79528,7.78593162699123
"Wilmington Island CDP, Georgia",6936,6288,648,13,83168,9.342560553633218
"Adel city, Georgia",2347,1993,354,13,00576,15.083084789092457
"Roberta city, Georgia",387,323,64,13,65856,16.5374677002584
"Chester town, Georgia",285,214,71,13,15900,24.912280701754387
"Vienna city, Georgia",1754,1409,345,13,79444,19.66932725199544
"Claxton city, Georgia",1005,895,110,13,16600,10.945273631840797
"Hagan city, Georgia",470,406,64,13,36024,13.617021276595745
"Mountain Park city, Georgia",276,249,27,13,53172,9.782608695652174
"Nelson city, Georgia",579,531,48,13,54572,8.290155440414509
"Acworth city, Georgia",9396,8543,853,13,00408,9.078331204767986
"Marietta city, Georgia",26225,23947,2278,13,49756,8.686367969494757
"Smyrna city, Georgia",27116,24531,2585,13,71492,9.533116978905444
"Dooling town, Georgia",64,51,13,13,23480,20.3125
"Austell city, Georgia",2887,2562,325,13,04252,11.257360581918947
"Mableton CDP, Georgia",15199,14168,1031,13,48288,6.783341009276926
"Canon city, Georgia",412,329,83,13,12932,20.145631067961165
"Lavonia city, Georgia",1098,914,184,13,45460,16.757741347905284
"Siloam town, Georgia",161,138,23,13,70932,14.285714285714285
"Swainsboro city, Georgia",2896,2503,393,13,74964,13.570441988950277
"Greensboro city, Georgia",1424,1294,130,13,34876,9.129213483146067
"Jackson city, Georgia",2101,1754,347,13,41596,16.515944788196098
"Surrency town, Georgia",146,115,31,13,74852,21.232876712328768
"Offerman city, Georgia",195,162,33,13,57568,16.923076923076923
"Vidette city, Georgia",70,56,14,13,79416,20.0
"Atlanta city, Georgia",242421,199478,42943,13,04000,17.71422442775172
"Bogart town, Georgia",580,531,49,13,09068,8.448275862068966
"Bluffton town, Georgia",39,29,10,13,08956,25.64102564102564
"Gibson city, Georgia",325,238,87,13,32748,26.769230769230766
"Homer town, Georgia",508,455,53,13,39720,10.433070866141732
"Ambrose city, Georgia",154,128,26,13,02060,16.883116883116884
"Bostwick city, Georgia",118,95,23,13,09488,19.491525423728813
"Columbus city, Georgia",84416,72924,11492,13,19000,13.613532979529946
"Lenox city, Georgia",416,344,72,13,45936,17.307692307692307
"Berlin city, Georgia",272,217,55,13,07304,20.22058823529412
"Blythe town, Georgia",299,258,41,13,09040,13.712374581939798
"Braswell town, Georgia",171,153,18,13,10104,10.526315789473683
"Brooklet city, Georgia",744,689,55,13,11000,7.39247311827957
"Cecil city, Georgia",178,139,39,13,14192,21.910112359550563
"Chauncey city, Georgia",178,150,28,13,15648,15.730337078651685
"Cohutta city, Georgia",253,202,51,13,17496,20.158102766798418
"Concord city, Georgia",123,103,20,13,19168,16.260162601626014
"Damascus city, Georgia",127,109,18,13,21436,14.173228346456693
"Ephesus city, Georgia",189,146,43,13,27708,22.75132275132275
"Flowery Branch city, Georgia",3296,2938,358,13,30340,10.861650485436893
"Funston city, Georgia",215,186,29,13,31684,13.488372093023257
"Garfield city, Georgia",66,54,12,13,32188,18.181818181818183
"Good Hope city, Georgia",214,185,29,13,33896,13.551401869158877
"Hiawassee city, Georgia",764,407,357,13,38124,46.72774869109947
"Hiltonia town, Georgia",176,143,33,13,38920,18.75
"Ivey city, Georgia",387,319,68,13,41540,17.571059431524546
"Jacksonville city, Georgia",73,52,21,13,41708,28.767123287671232
"Jersey city, Georgia",57,43,14,13,42184,24.561403508771928
"Keysville city, Georgia",85,63,22,13,43360,25.882352941176475
"Kite city, Georgia",123,77,46,13,43892,37.39837398373984
"LaFayette city, Georgia",3609,2870,739,13,44312,20.47658631199778
"Lithia Springs CDP, Georgia",6820,6326,494,13,46832,7.243401759530792
"Milan city, Georgia",514,311,203,13,51408,39.494163424124515
"Morganton city, Georgia",150,95,55,13,52724,36.666666666666664
"Nunez city, Georgia",71,65,6,13,56644,8.450704225352112
"Odum city, Georgia",238,201,37,13,57540,15.546218487394958
"Pendergrass town, Georgia",214,186,28,13,60032,13.084112149532709
"Allentown city, Georgia",57,37,20,13,01500,35.08771929824561
"Porterdale city, Georgia",776,631,145,13,62244,18.685567010309278
"Watkinsville city, Georgia",1054,1043,11,13,80788,1.0436432637571158
"Chattahoochee Hills city, Georgia",1248,1068,180,13,15552,14.423076923076922
"Webster County unified government, Georgia",1426,1101,325,13,81128,22.79102384291725
"Alamo town, Georgia",557,493,64,13,00996,11.490125673249551
"Allenhurst city, Georgia",328,300,28,13,01472,8.536585365853659
"Barwick city, Georgia",159,129,30,13,05708,18.867924528301888
"Rebecca town, Georgia",101,86,15,13,63840,14.85148514851485
"Rentz city, Georgia",174,116,58,13,64680,33.33333333333333
"Resaca town, Georgia",361,307,54,13,64736,14.958448753462603
"Reynolds city, Georgia",634,481,153,13,64876,24.13249211356467
"Rincon town, Georgia",3822,3788,34,13,65296,0.8895866038723181
"Sale City city, Georgia",186,160,26,13,68096,13.978494623655912
"Sandy Springs city, Georgia",50386,45833,4553,13,68516,9.036240225459453
"Sardis city, Georgia",424,323,101,13,68740,23.82075471698113
"Stillmore city, Georgia",217,178,39,13,73620,17.972350230414747
"Summertown city, Georgia",68,64,4,13,74348,5.88235294117647
"Whitesburg city, Georgia",280,248,32,13,82720,11.428571428571429
"Tarrytown town, Georgia",32,25,7,13,75496,21.875
"Toomsboro city, Georgia",221,152,69,13,76952,31.221719457013574
"Walnut Grove city, Georgia",549,485,64,13,80228,11.657559198542804
"Williamson city, Georgia",238,216,22,13,83084,9.243697478991598
"Athens-Clarke County unified government (balance), Georgia",52027,46708,5319,13,03440,10.223537778461184
"Augusta-Richmond County consolidated government (balance), Georgia",86169,70390,15779,13,04204,18.311689818844364
"Johns Creek city, Georgia",29025,27945,1080,13,42425,3.7209302325581395
"Milton city, Georgia",13625,12897,728,13,51670,5.343119266055045
"Russell CDP, Georgia",433,355,78,13,67676,18.013856812933028
"Cusseta-Chattahoochee County unified government, Georgia",3346,2550,796,13,21017,23.789599521817095
"Georgetown-Quitman County unified government, Georgia",2034,934,1100,13,32528,54.08062930186824
"Boykin CDP, Georgia",40,27,13,13,09852,32.5
"Calvary CDP, Georgia",27,27,0,13,12484,0.0
"Canoochee CDP, Georgia",55,55,0,13,12960,0.0
"Cedar Springs CDP, Georgia",154,94,60,13,14472,38.961038961038966
"Cherry Log CDP, Georgia",75,24,51,13,15844,68.0
"Coleman CDP, Georgia",6,6,0,13,17580,0.0
"Crooked Creek CDP, Georgia",472,211,261,13,20550,55.29661016949152
"Dewy Rose CDP, Georgia",58,58,0,13,22724,0.0
"Dunwoody city, Georgia",22305,20025,2280,13,24768,10.221923335574983
"Dutch Island CDP, Georgia",418,391,27,13,24876,6.4593301435406705
"Eagle Grove CDP, Georgia",0,0,0,13,24964,
"Empire CDP, Georgia",216,173,43,13,27512,19.90740740740741
"Epworth CDP, Georgia",240,95,145,13,27736,60.416666666666664
"Hardwick CDP, Georgia",2096,1472,624,13,36668,29.770992366412212
"Henderson CDP, Georgia",938,857,81,13,37910,8.635394456289978
"Heron Bay CDP, Georgia",1212,1056,156,13,38105,12.871287128712872
"Howard CDP, Georgia",0,0,0,13,40196,
"Jenkinsburg city, Georgia",139,113,26,13,42156,18.705035971223023
"Knoxville CDP, Georgia",25,6,19,13,44060,76.0
"Matthews CDP, Georgia",50,50,0,13,50176,0.0
"Mendes CDP, Georgia",32,32,0,13,50820,0.0
"Mineral Bluff CDP, Georgia",112,112,0,13,51744,0.0
"Norristown CDP, Georgia",31,31,0,13,55944,0.0
"Perkins CDP, Georgia",60,60,0,13,60312,0.0
"Rockingham CDP, Georgia",60,60,0,13,66220,0.0
"Satilla CDP, Georgia",122,122,0,13,68805,0.0
"Seville CDP, Georgia",83,69,14,13,69728,16.867469879518072
"Talahi Island CDP, Georgia",537,527,10,13,75239,1.86219739292365
"Tate City CDP, Georgia",11,0,11,13,75580,100.0
"The Rock CDP, Georgia",65,52,13,13,76112,20.0
"Yonah CDP, Georgia",375,284,91,13,84832,24.266666666666666
"Echols County consolidated government, Georgia",1838,1559,279,13,26156,15.179542981501632
"Stonecrest city, Georgia",21720,19626,2094,13,73784,9.640883977900552
"Tucker city, Georgia",16101,14528,1573,13,77652,9.769579529221788
"South Fulton city, Georgia",36059,31526,4533,13,72122,12.571064089409024
"Appling CDP, Georgia",405,322,83,13,02536,20.493827160493826
"Brookhaven city, Georgia",24353,22071,2282,13,10944,9.370508766887037
"Peachtree Corners city, Georgia",17554,16685,869,13,59735,4.950438646462345
"Macon-Bibb County, Georgia",70205,58010,12195,13,49008,17.370557652588847
"Sautee-Nacoochee CDP, Georgia",131,106,25,13,68880,19.083969465648856
"McRae-Helena city, Georgia",2835,2043,792,13,49100,27.936507936507937
"East Hope city, Idaho",143,71,72,16,23680,50.349650349650354
"Montpelier city, Idaho",1219,993,226,16,53920,18.539786710418376
"Idaho Falls city, Idaho",23906,22197,1709,16,39700,7.148832928971806
"Sugar City city, Idaho",389,367,22,16,78040,5.655526992287918
"Osburn city, Idaho",715,635,80,16,59590,11.188811188811188
"Wallace city, Idaho",622,439,183,16,84790,29.421221864951768
"Butte City city, Idaho",70,45,25,16,11710,35.714285714285715
"Hayden city, Idaho",5852,5719,133,16,36370,2.272727272727273
"Deary city, Idaho",156,134,22,16,20890,14.102564102564102
"Troy city, Idaho",358,321,37,16,82360,10.335195530726256
"Eden city, Idaho",149,135,14,16,24310,9.395973154362416
"Horseshoe Bend city, Idaho",395,347,48,16,38620,12.151898734177214
"Newdale city, Idaho",125,123,2,16,56800,1.6
"Ketchum city, Idaho",3626,1213,2413,16,43030,66.54715940430226
"Sun Valley city, Idaho",2745,601,2144,16,78850,78.10564663023679
"Iona city, Idaho",785,755,30,16,40420,3.821656050955414
"Nezperce city, Idaho",222,194,28,16,57250,12.612612612612612
"Pinehurst city, Idaho",808,675,133,16,63100,16.46039603960396
"Wardner city, Idaho",113,84,29,16,85240,25.663716814159294
"Weiser city, Idaho",2349,2079,270,16,86140,11.494252873563218
"Homedale city, Idaho",988,931,57,16,38170,5.769230769230769
"Murtaugh city, Idaho",49,33,16,16,55900,32.6530612244898
"American Falls city, Idaho",1716,1447,269,16,01900,15.675990675990676
"Tetonia city, Idaho",146,110,36,16,80470,24.65753424657534
"Buhl city, Idaho",1827,1763,64,16,10810,3.503010399562124
"Ammon city, Idaho",5323,5139,184,16,01990,3.4566973511177905
"Swan Valley city, Idaho",103,55,48,16,79120,46.601941747572816
"McCall city, Idaho",4259,1440,2819,16,48790,66.18924630194881
"Arbon Valley CDP, Idaho",282,268,14,16,02935,4.964539007092199
"Parma city, Idaho",880,831,49,16,60940,5.568181818181818
"Hollister city, Idaho",112,100,12,16,38080,10.714285714285714
"Mud Lake city, Idaho",122,107,15,16,55450,12.295081967213115
"Driggs city, Idaho",885,606,279,16,22690,31.52542372881356
"New Meadows city, Idaho",251,175,76,16,56890,30.278884462151396
"Georgetown city, Idaho",218,188,30,16,30340,13.761467889908257
"Hope city, Idaho",57,40,17,16,38440,29.82456140350877
"Sandpoint city, Idaho",3945,3366,579,16,72100,14.67680608365019
"Juliaetta city, Idaho",322,258,64,16,42130,19.875776397515526
"Kendrick city, Idaho",151,142,9,16,42760,5.960264900662252
"Onaway city, Idaho",83,80,3,16,58870,3.614457831325301
"Weippe city, Idaho",248,219,29,16,86050,11.693548387096774
"Drummond city, Idaho",6,2,4,16,22780,66.66666666666666
"Kuna city, Idaho",5992,5992,0,16,44290,0.0
"Albion city, Idaho",127,108,19,16,01000,14.960629921259844
"Ferdinand city, Idaho",62,53,9,16,27460,14.516129032258066
"White Bird city, Idaho",52,45,7,16,87310,13.461538461538462
"Rigby city, Idaho",1506,1413,93,16,67780,6.175298804780876
"Leadore city, Idaho",70,30,40,16,45910,57.14285714285714
"Heyburn city, Idaho",1270,1077,193,16,37360,15.196850393700787
"Oakley city, Idaho",295,277,18,16,58330,6.101694915254238
"Franklin city, Idaho",226,213,13,16,28810,5.752212389380531
"Oxford city, Idaho",14,14,0,16,60040,0.0
"Hamer city, Idaho",27,15,12,16,34570,44.44444444444444
"Ririe city, Idaho",283,214,69,16,67960,24.381625441696116
"Basalt city, Idaho",144,129,15,16,05230,10.416666666666668
"Blackfoot city, Idaho",4785,4210,575,16,07840,12.016718913270637
"Priest River city, Idaho",914,802,112,16,65530,12.25382932166302
"Challis city, Idaho",503,328,175,16,13780,34.791252485089466
"State Line city, Idaho",4,4,0,16,77050,0.0
"Worley city, Idaho",136,113,23,16,88480,16.911764705882355
"Huetter city, Idaho",65,65,0,16,39070,0.0
"Ponderay city, Idaho",540,504,36,16,64450,6.666666666666667
"Atomic City city, Idaho",50,29,21,16,03970,42.0
"Athol city, Idaho",413,373,40,16,03700,9.685230024213075
"Harrison city, Idaho",187,117,70,16,35200,37.4331550802139
"Post Falls city, Idaho",12448,12117,331,16,64810,2.6590616966580978
"Aberdeen city, Idaho",707,602,105,16,00100,14.85148514851485
"Pierce city, Idaho",344,220,124,16,62740,36.04651162790697
"Bellevue city, Idaho",926,851,75,16,06220,8.099352051835854
"Peck city, Idaho",79,65,14,16,61840,17.72151898734177
"Ucon city, Idaho",438,393,45,16,83350,10.273972602739725
"Boise City city, Idaho",95104,89975,5129,16,08830,5.393043405114401
"Meridian city, Idaho",35955,34783,1172,16,52120,3.2596300931720203
"Craigmont city, Idaho",279,238,41,16,19270,14.695340501792115
"Winchester city, Idaho",160,136,24,16,87850,15.0
"Warm River city, Idaho",2,0,2,16,85420,100.0
"Malad City city, Idaho",995,842,153,16,50140,15.376884422110553
"Clifton city, Idaho",77,67,10,16,16120,12.987012987012985
"Preston city, Idaho",2024,1966,58,16,65260,2.8656126482213438
"Twin Falls city, Idaho",19026,18047,979,16,82810,5.145590244927993
"Chubbuck city, Idaho",5259,5131,128,16,14680,2.433922799011219
"Dietrich city, Idaho",96,86,10,16,21790,10.416666666666668
"Richfield city, Idaho",215,166,49,16,67600,22.790697674418606
"Oldtown city, Idaho",119,89,30,16,58600,25.210084033613445
"Lost River city, Idaho",21,0,21,16,47890,100.0
"Coeur d'Alene city, Idaho",22497,20766,1731,16,16750,7.69435924789972
"Hauser city, Idaho",387,369,18,16,35830,4.651162790697675
"Spirit Lake city, Idaho",894,821,73,16,76060,8.165548098434003
"Genesee city, Idaho",396,369,27,16,30160,6.8181818181818175
"Hailey city, Idaho",3198,2560,638,16,34390,19.949968730456536
"Island Park city, Idaho",571,97,474,16,40600,83.0122591943958
"Parker city, Idaho",123,109,14,16,60760,11.38211382113821
"Teton city, Idaho",427,368,59,16,80380,13.817330210772832
"Garden City city, Idaho",6018,5624,394,16,29620,6.547025589896975
"Star city, Idaho",3197,3157,40,16,76870,1.2511729746637474
"Council city, Idaho",465,356,109,16,18820,23.440860215053764
"Potlatch city, Idaho",412,352,60,16,64900,14.563106796116504
"St. Marks city, Florida",159,100,59,12,62825,37.10691823899371
"West Bradenton CDP, Florida",1756,1540,216,12,76050,12.300683371298406
"Eagle Lake city, Florida",926,792,134,12,18875,14.47084233261339
"Roosevelt Gardens CDP, Florida",920,833,87,12,61807,9.456521739130434
"Deerfield Beach city, Florida",41609,31863,9746,12,16725,23.422817178975702
"Valparaiso city, Florida",1882,1516,366,12,73675,19.44739638682253
"Cottondale town, Florida",439,311,128,12,14850,29.157175398633257
"Bayport CDP, Florida",78,31,47,12,04250,60.256410256410255
"Okeechobee city, Florida",2412,2046,366,12,51200,15.17412935323383
"Redington Beach town, Florida",1024,659,365,12,59725,35.64453125
"Wedgefield CDP, Florida",2763,2465,298,12,75612,10.785378212088311
"St. James City CDP, Florida",3244,1637,1607,12,62675,49.53760789149199
"Greenacres city, Florida",16709,13833,2876,12,27322,17.21228080675085
"Chiefland city, Florida",1101,986,115,12,11925,10.44504995458674
"Tarpon Springs city, Florida",12183,9651,2532,12,71150,20.78305836000985
"Ruskin CDP, Florida",8775,7355,1420,12,62275,16.182336182336183
"Yulee CDP, Florida",4805,4443,362,12,79175,7.533818938605618
"Lazy Lake village, Florida",26,6,20,12,39750,76.92307692307693
"Pine Lakes CDP, Florida",297,223,74,12,56865,24.915824915824917
"South Palm Beach town, Florida",1689,806,883,12,67650,52.27945529899348
"South Daytona city, Florida",6200,5415,785,12,67325,12.661290322580646
"Palm Springs North CDP, Florida",1553,1529,24,12,54500,1.5453960077269802
"Laurel CDP, Florida",5709,4618,1091,12,39600,19.110176913645123
"Fisher Island CDP, Florida",291,53,238,12,22375,81.78694158075601
"Melbourne Village town, Florida",345,320,25,12,44075,7.246376811594203
"Leesburg city, Florida",10277,8732,1545,12,39875,15.033570108008174
"Madison city, Florida",1240,983,257,12,42425,20.7258064516129
"Miami Springs city, Florida",5505,5010,495,12,45200,8.991825613079019
"Perry city, Florida",3126,2521,605,12,56150,19.353806781829814
"Williamsburg CDP, Florida",4577,3338,1239,12,77735,27.070133275071008
"Mulberry city, Florida",1974,1518,456,12,47200,23.10030395136778
"Tallahassee city, Florida",87561,75508,12053,12,70600,13.765260789620951
"Belleair Bluffs city, Florida",1571,1166,405,12,05125,25.779758115849777
"Ocoee city, Florida",15596,14704,892,12,51075,5.719415234675558
"Cape Canaveral city, Florida",8967,5425,3542,12,10250,39.50039032006245
"Umatilla city, Florida",1909,1558,351,12,73025,18.386589837611314
"Manasota Key CDP, Florida",2039,585,1454,12,42750,71.30946542422755
"West Samoset CDP, Florida",2457,2185,272,12,76740,11.07041107041107
"Hastings town, Florida",381,333,48,12,29100,12.598425196850393
"Golden Beach town, Florida",346,185,161,12,26250,46.53179190751445
"Leisure City CDP, Florida",7256,6734,522,12,39950,7.194046306504961
"North Miami Beach city, Florida",16935,14345,2590,12,49475,15.293770298198996
"West Melbourne city, Florida",8643,7946,697,12,76500,8.064329515214624
"Cocoa city, Florida",8615,6935,1680,12,13150,19.50087057457922
"Melbourne city, Florida",38341,33030,5311,12,43975,13.852012206254402
"Melbourne Beach town, Florida",1455,1159,296,12,44000,20.343642611683848
"Altoona CDP, Florida",66,49,17,12,01050,25.757575757575758
"Celebration CDP, Florida",4637,3216,1421,12,11285,30.644813456976493
"Howey-in-the-Hills town, Florida",670,583,87,12,32775,12.985074626865673
"Lake Mack-Forest Hills CDP, Florida",473,358,115,12,38332,24.312896405919663
"Kissimmee city, Florida",27966,21667,6299,12,36950,22.52377887434742
"Harlem CDP, Florida",928,840,88,12,28925,9.482758620689655
"Bartow city, Florida",7835,6534,1301,12,03675,16.60497766432674
"Fort Meade city, Florida",2783,1968,815,12,24100,29.28494430470715
"Bonifay city, Florida",1203,1017,186,12,07450,15.46134663341646
"Noma town, Florida",103,85,18,12,48900,17.475728155339805
"Westville town, Florida",156,121,35,12,76975,22.435897435897438
"Florida Ridge CDP, Florida",9699,6816,2883,12,23050,29.72471388802969
"Hilliard town, Florida",1243,1132,111,12,30750,8.930008045052293
"Wildwood city, Florida",3521,2607,914,12,77675,25.95853450724226
"McIntosh town, Florida",236,180,56,12,42150,23.728813559322035
"Gulf Breeze city, Florida",2842,2765,77,12,28000,2.70935960591133
"Pace CDP, Florida",8840,8050,790,12,53725,8.936651583710407
"Malabar town, Florida",1322,1207,115,12,42625,8.69894099848714
"Lisbon CDP, Florida",138,90,48,12,40750,34.78260869565217
"Mascotte city, Florida",1764,1719,45,12,43425,2.5510204081632653
"Okahumpka CDP, Florida",102,102,0,12,51150,0.0
"Lake City city, Florida",5338,4649,689,12,37775,12.907455976020982
"Bonita Springs city, Florida",36059,22074,13985,12,07525,38.783660112593246
"Buckingham CDP, Florida",1688,1397,291,12,09350,17.239336492890995
"Cape Coral city, Florida",83778,64981,18797,12,10275,22.436677886796055
"Punta Rassa CDP, Florida",1616,1136,480,12,59250,29.7029702970297
"Dade City North CDP, Florida",907,775,132,12,16175,14.553472987872107
"Wesley Chapel CDP, Florida",20305,18539,1766,12,75875,8.697365180989904
"Panama City city, Florida",17983,15197,2786,12,54700,15.49240949785909
"Pretty Bayou CDP, Florida",1560,1435,125,12,58962,8.012820512820513
"Chokoloskee CDP, Florida",326,119,207,12,12150,63.49693251533742
"Plantation Island CDP, Florida",124,80,44,12,57492,35.483870967741936
"Spring Lake CDP, Florida",252,252,0,12,68375,0.0
"Bristol city, Florida",375,310,65,12,08600,17.333333333333336
"Manalapan town, Florida",338,143,195,12,42700,57.692307692307686
"East Palatka CDP, Florida",639,525,114,12,19350,17.84037558685446
"Winter Park city, Florida",14367,12631,1736,12,78300,12.083246328391454
"Gulf Stream town, Florida",555,311,244,12,28275,43.96396396396396
"Pinellas Park city, Florida",24426,21085,3341,12,56975,13.678047981658889
"Tildenville CDP, Florida",419,419,0,12,71850,0.0
"Upper Grand Lagoon CDP, Florida",8811,6615,2196,12,73312,24.923391215526046
"Ojus CDP, Florida",7798,6618,1180,12,51125,15.13208515003847
"St. Augustine city, Florida",7376,5689,1687,12,62500,22.871475054229933
"Palm Coast city, Florida",36176,30677,5499,12,54200,15.200685537372843
"Wabasso Beach CDP, Florida",1550,871,679,12,74635,43.806451612903224
"Palm Bay city, Florida",44052,38774,5278,12,54000,11.981294833378735
"Laurel Hill city, Florida",345,269,76,12,39650,22.028985507246375
"Vero Beach South CDP, Florida",11504,9184,2320,12,74200,20.166898470097358
"Mangonia Park town, Florida",844,741,103,12,42900,12.203791469194313
"Lake Hamilton town, Florida",690,491,199,12,37975,28.840579710144926
"Brandon CDP, Florida",45855,42453,3402,12,08150,7.419038272816486
"Branford town, Florida",384,298,86,12,08175,22.395833333333336
"Poinciana CDP, Florida",23739,18595,5144,12,57900,21.66898352921353
"Davenport city, Florida",1693,1211,482,12,16450,28.470171293561723
"Ebro town, Florida",142,106,36,12,19725,25.352112676056336
"Valrico CDP, Florida",14225,13388,837,12,73700,5.884007029876978
"Fort White town, Florida",288,231,57,12,24500,19.791666666666664
"North Bay Village city, Florida",4410,3444,966,12,49225,21.904761904761905
"South Gate Ridge CDP, Florida",2827,2550,277,12,67450,9.798372833392289
"Welaka town, Florida",603,277,326,12,75750,54.063018242122716
"Lakeside CDP, Florida",12065,11323,742,12,38813,6.150020721094074
"Esto town, Florida",155,134,21,12,21250,13.548387096774196
"Webster city, Florida",334,240,94,12,75600,28.143712574850298
"Astor CDP, Florida",1033,663,370,12,02275,35.81800580832527
"Watertown CDP, Florida",1487,1258,229,12,75300,15.400134498991259
"Villas CDP, Florida",7487,5196,2291,12,74512,30.59970615733939
"Springfield city, Florida",4062,3379,683,12,68275,16.814377154111277
"Brooker town, Florida",162,125,37,12,08725,22.839506172839506
"Paisley CDP, Florida",549,439,110,12,53850,20.036429872495447
"Pembroke Pines city, Florida",63771,56788,6983,12,55775,10.950118392372708
"Zolfo Springs town, Florida",576,449,127,12,79250,22.04861111111111
"Graceville city, Florida",1014,819,195,12,27000,19.230769230769234
"Mount Plymouth CDP, Florida",1845,1845,0,12,47125,0.0
"Keystone Heights city, Florida",644,584,60,12,36475,9.316770186335404
"Pompano Beach city, Florida",54163,41084,13079,12,58050,24.14748075254325
"Gainesville city, Florida",59273,48407,10866,12,25175,18.332124238692156
"Largo city, Florida",46927,37327,9600,12,39425,20.45730602851237
"Fort Pierce North CDP, Florida",3047,2321,726,12,24337,23.826714801444044
"South Miami city, Florida",4841,4395,446,12,67550,9.212972526337532
"Lake Kathryn CDP, Florida",539,337,202,12,38162,37.47680890538033
"Port St. John CDP, Florida",5400,4414,986,12,58700,18.25925925925926
"Rockledge city, Florida",12039,10519,1520,12,61500,12.625633358252347
"Sharpes CDP, Florida",1576,1227,349,12,65525,22.144670050761423
"Raiford town, Florida",91,75,16,12,59400,17.582417582417584
"Clewiston city, Florida",2891,2512,379,12,13000,13.109650639916984
"Tamiami CDP, Florida",16731,16120,611,12,70700,3.651903651903652
"University Park CDP, Florida",7983,7433,550,12,73287,6.889640486032819
"Westview CDP, Florida",3473,3296,177,12,76950,5.096458393319896
"Westwood Lakes CDP, Florida",3307,3161,146,12,77075,4.414877532506804
"Big Coppitt Key CDP, Florida",1503,1008,495,12,06350,32.93413173652694
"Duck Key CDP, Florida",865,305,560,12,18425,64.73988439306359
"Nokomis CDP, Florida",1877,1563,314,12,48875,16.728822589238145
"Tavernier CDP, Florida",1978,800,1178,12,71250,59.555106167846304
"Fruitville CDP, Florida",6020,5452,568,12,25000,9.435215946843854
"Kensington Park CDP, Florida",1715,1582,133,12,36200,7.755102040816326
"North Port city, Florida",27827,23367,4460,12,49675,16.027599094404714
"North Sarasota CDP, Florida",3626,3185,441,12,49787,12.162162162162163
"Osprey CDP, Florida",3543,3003,540,12,53425,15.241320914479257
"Sarasota city, Florida",31328,24416,6912,12,64175,22.06332992849847
"The Meadows CDP, Florida",3378,2458,920,12,71580,27.23505032563647
"Lake Butler city, Florida",842,755,87,12,37650,10.332541567695962
"Auburndale city, Florida",6074,5314,760,12,02550,12.512347711557458
"Combee Settlement CDP, Florida",2307,2057,250,12,13775,10.836584308625921
"Washington Park CDP, Florida",656,624,32,12,75225,4.878048780487805
"Crystal River city, Florida",2145,1403,742,12,15775,34.59207459207459
"Satellite Beach city, Florida",4690,4212,478,12,64400,10.19189765458422
"Titusville city, Florida",24392,18888,5504,12,71900,22.564775336175796
"Groveland city, Florida",4721,4275,446,12,27800,9.44715102732472
"Montverde town, Florida",603,537,66,12,46525,10.945273631840797
"Homosassa Springs CDP, Florida",6999,5605,1394,12,32400,19.91713101871696
"Solana CDP, Florida",441,314,127,12,66875,28.798185941043087
"Citrus Springs CDP, Florida",3991,3152,839,12,12450,21.022300175394637
"Homosassa CDP, Florida",1859,1063,796,12,32375,42.81871974179666
"Weston city, Florida",25041,21320,3721,12,76582,14.859630206461402
"Charlotte Harbor CDP, Florida",2755,1894,861,12,11625,31.252268602540834
"Cleveland CDP, Florida",1876,1509,367,12,12950,19.56289978678038
"Harbour Heights CDP, Florida",1618,1277,341,12,28800,21.07540173053152
"Port Charlotte CDP, Florida",29614,24578,5036,12,58350,17.005470385628417
"Punta Gorda city, Florida",13250,9825,3425,12,59200,25.849056603773583
"Beverly Hills CDP, Florida",5095,4169,926,12,06125,18.17468105986261
"Bowling Green city, Florida",874,659,215,12,07775,24.59954233409611
"Belleview city, Florida",2402,2067,335,12,05375,13.946711074104911
"Bagdad CDP, Florida",1444,1319,125,12,02925,8.65650969529086
"Merritt Island CDP, Florida",17675,15119,2556,12,44275,14.461103253182461
"Mims CDP, Florida",3518,2481,1037,12,45775,29.476975554292213
"Campbell CDP, Florida",1471,1046,425,12,09875,28.891910265125766
"Lauderhill city, Florida",27784,23287,4497,12,39550,16.18557443132738
"Lighthouse Point city, Florida",6286,5097,1189,12,40450,18.915049315940184
"Miramar city, Florida",44205,39759,4446,12,45975,10.05768578215134
"Oakland Park city, Florida",18615,16515,2100,12,50575,11.281224818694602
"Hernando CDP, Florida",5433,4064,1369,12,29425,25.197864899687094
"Inverness Highlands North CDP, Florida",1024,899,125,12,33958,12.20703125
"Wauchula city, Florida",1891,1659,232,12,75375,12.268640930724485
"Anna Maria city, Florida",1367,416,951,12,01475,69.56839795171909
"Stock Island CDP, Florida",1759,1409,350,12,68800,19.897669130187605
"Lake Sarasota CDP, Florida",1818,1640,178,12,38690,9.79097909790979
"Warm Mineral Springs CDP, Florida",4086,2666,1420,12,75175,34.75281448849731
"Palmetto city, Florida",6751,4686,2065,12,54250,30.58806102799585
"Flagler Beach city, Florida",3879,2456,1423,12,22550,36.68471255478216
"Glencoe CDP, Florida",912,666,246,12,26000,26.973684210526315
"Orange City city, Florida",5838,5003,835,12,51825,14.302843439534088
"Jacksonville city, Florida",379288,333866,45422,12,35000,11.975596380586783
"Jupiter Island town, Florida",789,335,454,12,35925,57.54119138149556
"Gonzalez CDP, Florida",5534,5271,263,12,26700,4.7524394651246835
"Micco CDP, Florida",6702,4651,2051,12,45275,30.602805132796178
"La Crosse town, Florida",141,123,18,12,37300,12.76595744680851
"Bellview CDP, Florida",10334,8993,1341,12,05462,12.976582155989934
"Cudjoe Key CDP, Florida",1779,1031,748,12,15862,42.04609331084879
"Islamorada, Village of Islands village; Florida",6055,2859,3196,12,34132,52.782824112303885
"Opa-locka city, Florida",6168,5413,755,12,51650,12.24059662775616
"Palmetto Estates CDP, Florida",4133,3895,238,12,54300,5.758528913622066
"West Miami city, Florida",2543,2452,91,12,76525,3.578450648839953
"Key Colony Beach city, Florida",1421,349,1072,12,36325,75.43983110485574
"Marathon city, Florida",5919,3605,2314,12,43000,39.094441628653485
"North Key Largo CDP, Florida",1766,422,1344,12,49406,76.10419026047565
"Bee Ridge CDP, Florida",5143,4677,466,12,04925,9.060859420571651
"Venice city, Florida",17599,11879,5720,12,73900,32.50184669583499
"Avon Park city, Florida",4425,3472,953,12,02750,21.53672316384181
"Lee town, Florida",154,113,41,12,39850,26.623376623376622
"Four Corners CDP, Florida",30416,13609,16807,12,24581,55.25710152551289
"Hallandale Beach city, Florida",28021,17537,10484,12,28452,37.414796045822776
"Miami Lakes town, Florida",10756,10189,567,12,45100,5.271476385273336
"Southwest Ranches town, Florida",2707,2335,372,12,68135,13.74214998152937
"Crystal Lake CDP, Florida",2633,2184,449,12,15725,17.052791492594
"Dania Beach city, Florida",15433,12072,3361,12,16335,21.778008164323204
"Doral city, Florida",22839,17139,5700,12,17935,24.95730986470511
"LaBelle city, Florida",1676,1407,269,12,37225,16.050119331742245
"Marco Island city, Florida",18742,8515,10227,12,43083,54.567282040337204
"Miami Gardens city, Florida",33196,30379,2817,12,45060,8.48596216411616
"Ormond-by-the-Sea CDP, Florida",6227,3778,2449,12,53200,39.32872972538944
"Palmetto Bay village, Florida",7822,7414,408,12,54275,5.216057274354386
"Sunny Isles Beach city, Florida",22192,10532,11660,12,69555,52.54145638067772
"Sweetwater city, Florida",6298,6063,235,12,70345,3.731343283582089
"Buenaventura Lakes CDP, Florida",10548,9188,1360,12,09415,12.893439514599924
"West Park city, Florida",4870,4418,452,12,76658,9.281314168377824
"Cutler Bay town, Florida",13826,12823,1003,12,15968,7.254448141183278
"Loxahatchee Groves town, Florida",1170,1028,142,12,41577,12.136752136752136
"DeBary city, Florida",8858,8083,775,12,16675,8.749153307744411
"Fountainebleau CDP, Florida",21779,19415,2364,12,24562,10.854492860094586
"Grant-Valkaria town, Florida",1785,1532,253,12,27256,14.173669467787114
"Lake Butler CDP, Florida",6869,6086,783,12,37648,11.399039161449993
"Manatee Road CDP, Florida",1188,1097,91,12,42787,7.65993265993266
"St. Lucie Village town, Florida",349,260,89,12,62800,25.501432664756447
"Acacia Villas CDP, Florida",129,129,0,12,00075,0.0
"Alafaya CDP, Florida",31225,28932,2293,12,00410,7.343474779823859
"Allentown CDP, Florida",440,402,38,12,00800,8.636363636363637
"Alturas CDP, Florida",1599,1328,271,12,01100,16.948092557848653
"Aripeka CDP, Florida",167,70,97,12,01875,58.08383233532935
"Aucilla CDP, Florida",102,102,0,12,02575,0.0
"Avalon CDP, Florida",267,235,32,12,02660,11.985018726591761
"Balm CDP, Florida",1186,1104,82,12,03375,6.913996627318718
"Bardmoor CDP, Florida",4558,3987,571,12,03480,12.527424308907415
"Bear Creek CDP, Florida",1137,810,327,12,04735,28.759894459102902
"Berrydale CDP, Florida",68,68,0,12,05825,0.0
"Black Hammock CDP, Florida",485,412,73,12,06670,15.051546391752577
"Bradley Junction CDP, Florida",289,179,110,12,08125,38.062283737024224
"Brownsdale CDP, Florida",191,165,26,12,08925,13.612565445026178
"Cabana Colony CDP, Florida",916,896,20,12,09655,2.1834061135371177
"Carrollwood CDP, Florida",15440,14364,1076,12,10825,6.9689119170984455
"Cedar Grove CDP, Florida",1408,1205,203,12,11150,14.417613636363635
"Chumuckla CDP, Florida",353,335,18,12,12300,5.099150141643059
"Clarcona CDP, Florida",1594,1246,348,12,12675,21.831869510664994
"Cobbtown CDP, Florida",7,7,0,12,13125,0.0
"Connerton CDP, Florida",534,534,0,12,13965,0.0
"Crawfordville CDP, Florida",1795,1677,118,12,15300,6.573816155988858
"Dickerson City CDP, Florida",127,95,32,12,17450,25.196850393700785
"Day CDP, Florida",34,25,9,12,16500,26.47058823529412
"DeLand city, Florida",13671,12148,1523,12,16875,11.140370126545243
"DeLand Southwest CDP, Florida",526,433,93,12,16937,17.680608365019012
"Dixonville CDP, Florida",138,78,60,12,17710,43.47826086956522
"East Milton CDP, Florida",3283,2728,555,12,19275,16.905269570514772
"Fidelis CDP, Florida",92,67,25,12,22325,27.173913043478258
"Flagler Estates CDP, Florida",1318,1073,245,12,22560,18.588770864946888
"Fleming Island CDP, Florida",10840,10292,548,12,22660,5.055350553505535
"Floridatown CDP, Florida",91,91,0,12,23125,0.0
"Fort Denaud CDP, Florida",926,755,171,12,23730,18.466522678185747
"Fort Green CDP, Florida",66,51,15,12,23850,22.727272727272727
"Fort Green Springs CDP, Florida",75,75,0,12,23875,0.0
"Fuller Heights CDP, Florida",3785,3304,481,12,25025,12.708058124174373
"Garcon Point CDP, Florida",204,158,46,12,25392,22.54901960784314
"Garden Grove CDP, Florida",382,305,77,12,25475,20.157068062827225
"Gardner CDP, Florida",274,174,100,12,25550,36.496350364963504
"Greenbriar CDP, Florida",1184,1129,55,12,27360,4.64527027027027
"Grenelefe CDP, Florida",1370,993,377,12,27635,27.51824817518248
"Harold CDP, Florida",402,369,33,12,29000,8.208955223880597
"Heritage Pines CDP, Florida",1411,1224,187,12,29385,13.253012048192772
"Calhoun city, Georgia",6512,5918,594,13,12456,9.121621621621621
"Gainesville city, Georgia",14736,12957,1779,13,31908,12.072475570032573
"College Park city, Georgia",8188,6116,2072,13,17776,25.30532486565706
"Experiment CDP, Georgia",1169,904,265,13,28296,22.668947818648416
"Adairsville city, Georgia",1964,1838,126,13,00436,6.415478615071284
"Toccoa city, Georgia",3945,3141,804,13,76756,20.380228136882128
"Thomasville city, Georgia",8966,7248,1718,13,76224,19.161275931296007
"Tifton city, Georgia",6303,5783,520,13,76476,8.25003966365223
"Whigham city, Georgia",220,181,39,13,82412,17.727272727272727
"Aldora town, Georgia",49,43,6,13,01248,12.244897959183673
"Cadwell town, Georgia",152,139,13,13,12344,8.552631578947368
"Marshallville city, Georgia",755,587,168,13,49924,22.251655629139073
"Buena Vista city, Georgia",998,736,262,13,11728,26.252505010020037
"Madison city, Georgia",1912,1583,329,13,49196,17.207112970711297
"Lake City city, Georgia",726,579,147,13,44508,20.24793388429752
"Fairmount city, Georgia",354,319,35,13,28492,9.887005649717514
"Plainville city, Georgia",142,130,12,13,61684,8.450704225352112
"Union City city, Georgia",9716,8331,1385,13,78324,14.254837381638536
"Shiloh city, Georgia",196,173,23,13,70428,11.73469387755102
"Bowersville town, Georgia",237,175,62,13,09656,26.160337552742618
"Conyers city, Georgia",6949,6067,882,13,19336,12.692473737228378
"Lumpkin city, Georgia",595,455,140,13,47980,23.52941176470588
"De Soto city, Georgia",85,65,20,13,22472,23.52941176470588
"Leslie city, Georgia",241,189,52,13,46020,21.57676348547718
"Portal town, Georgia",314,271,43,13,62216,13.694267515923567
"Sandersville city, Georgia",2554,2120,434,13,68208,16.992952231793264
"Braselton town, Georgia",3628,3342,286,13,10076,7.883131201764057
"Bremen city, Georgia",2449,2205,244,13,10132,9.963250306247447
"Metter city, Georgia",1677,1411,266,13,51072,15.861657722122837
"Lilly city, Georgia",108,72,36,13,46384,33.33333333333333
"Daisy city, Georgia",63,58,5,13,21268,7.936507936507936
"East Ellijay city, Georgia",253,203,50,13,25356,19.76284584980237
"Montgomery CDP, Georgia",1854,1740,114,13,52332,6.148867313915858
"Arlington city, Georgia",763,583,180,13,02928,23.591087811271297
"Jefferson city, Georgia",4294,3839,455,13,41988,10.596180717279925
"Ludowici city, Georgia",1012,859,153,13,47784,15.118577075098813
"Midway city, Georgia",757,673,84,13,51352,11.096433289299867
"Fort Valley city, Georgia",3533,2894,639,13,31096,18.086611944523067
"Cobbtown city, Georgia",206,184,22,13,17272,10.679611650485436
"Sylvester city, Georgia",2648,2318,330,13,75188,12.462235649546828
"Collins city, Georgia",333,262,71,13,17832,21.32132132132132
"Baconton city, Georgia",330,288,42,13,04840,12.727272727272727
"Dublin city, Georgia",6884,5626,1258,13,24376,18.274259151656015
"Colquitt city, Georgia",916,778,138,13,18000,15.065502183406112
"North High Shoals town, Georgia",194,191,3,13,56308,1.5463917525773196
"Zebulon city, Georgia",558,474,84,13,85128,15.053763440860216
"Tallulah Falls town, Georgia",72,33,39,13,75328,54.166666666666664
"Clermont town, Georgia",391,352,39,13,16796,9.974424552429667
"Richland city, Georgia",821,685,136,13,65016,16.56516443361754
"Euharlee city, Georgia",1492,1391,101,13,27988,6.769436997319035
"Bonanza CDP, Georgia",1151,1117,34,13,09272,2.9539530842745436
"Aragon city, Georgia",526,465,61,13,02592,11.596958174904943
"Georgetown CDP, Georgia",5439,4987,452,13,32482,8.310351167494025
"Gordon city, Georgia",908,757,151,13,33980,16.629955947136562
"White Plains city, Georgia",139,102,37,13,82692,26.618705035971225
"Summerville city, Georgia",2024,1717,307,13,74376,15.167984189723322
"Graham city, Georgia",145,112,33,13,34260,22.758620689655174
"Broxton city, Georgia",600,485,115,13,11504,19.166666666666668
"Newton city, Georgia",387,320,67,13,55244,17.31266149870801
"East Newnan CDP, Georgia",555,507,48,13,25692,8.64864864864865
"Byromville town, Georgia",207,175,32,13,12232,15.458937198067632
"Vinings CDP, Georgia",7302,6511,791,13,79612,10.832648589427555
"Social Circle city, Georgia",1765,1583,182,13,71660,10.311614730878187
"Raoul CDP, Georgia",406,382,24,13,63588,5.911330049261084
"Cedartown city, Georgia",4172,3674,498,13,14500,11.93672099712368
"Camak town, Georgia",93,60,33,13,12512,35.483870967741936
"St. Marys city, Georgia",7904,7053,851,13,67984,10.7667004048583
"Between town, Georgia",114,102,12,13,07640,10.526315789473683
"Bethlehem town, Georgia",337,289,48,13,07612,14.243323442136498
"Rayle town, Georgia",90,65,25,13,63756,27.77777777777778
"Talbotton city, Georgia",552,408,144,13,75244,26.08695652173913
"Woodland city, Georgia",180,130,50,13,83952,27.77777777777778
"Tignall town, Georgia",240,197,43,13,76532,17.916666666666668
"Poulan city, Georgia",363,276,87,13,62496,23.96694214876033
"Hazlehurst city, Georgia",1947,1427,520,13,37564,26.70775552131484
"Wadley city, Georgia",867,663,204,13,79864,23.52941176470588
"Wrightsville city, Georgia",1388,1198,190,13,84512,13.688760806916425
"Montezuma city, Georgia",1603,1320,283,13,52304,17.654398003742983
"Camilla city, Georgia",2057,1769,288,13,12624,14.000972289742345
"Pitts city, Georgia",156,132,24,13,61544,15.384615384615385
"Attapulgus city, Georgia",235,215,20,13,04084,8.51063829787234
"Blue Ridge city, Georgia",563,503,60,13,08928,10.657193605683837
"McCaysville city, Georgia",669,590,79,13,48428,11.80866965620329
"Ranger town, Georgia",42,42,0,13,63560,0.0
"Mount Airy town, Georgia",515,455,60,13,53284,11.650485436893204
"Americus city, Georgia",7147,6274,873,13,02116,12.214915349097524
"Kingston city, Georgia",226,190,36,13,43668,15.929203539823009
"Clarkesville city, Georgia",864,706,158,13,16460,18.287037037037038
"Cornelia city, Georgia",1593,1406,187,13,19728,11.738857501569367
"Demorest city, Georgia",790,632,158,13,22304,20.0
"Andersonville city, Georgia",135,107,28,13,02256,20.74074074074074
"Butler city, Georgia",1043,854,189,13,12120,18.120805369127517
"White city, Georgia",324,297,27,13,82468,8.333333333333332
"Crawfordville city, Georgia",283,204,79,13,20316,27.915194346289752
"Tyrone town, Georgia",2559,2402,157,13,78044,6.135209066041422
"Omega city, Georgia",524,434,90,13,58184,17.17557251908397
"Avondale Estates city, Georgia",1441,1403,38,13,04644,2.63705759888966
"Decatur city, Georgia",9079,8480,599,13,22052,6.597642912215002
"Edison city, Georgia",600,503,97,13,26448,16.166666666666664
"Leary city, Georgia",358,268,90,13,45600,25.139664804469277
"Twin City city, Georgia",662,591,71,13,77988,10.725075528700906
"Ellijay city, Georgia",1069,940,129,13,27092,12.067352666043032
"Country Club Estates CDP, Georgia",3950,3336,614,13,19830,15.544303797468354
"Panthersville CDP, Georgia",4870,3826,1044,13,59080,21.437371663244353
"Nashville city, Georgia",2264,1958,306,13,54264,13.51590106007067
"Quitman city, Georgia",2029,1497,532,13,63224,26.21981271562346
"Kings Bay Base CDP, Georgia",653,529,124,13,43580,18.98928024502297
"Bloomingdale city, Georgia",1280,1208,72,13,08844,5.625
"Garden City city, Georgia",3552,3169,383,13,32048,10.782657657657657
"Thunderbolt town, Georgia",1186,1044,142,13,76364,11.973018549747048
"Tybee Island city, Georgia",3334,1274,2060,13,78036,61.7876424715057
"Argyle town, Georgia",146,91,55,13,02844,37.67123287671233
"Trenton city, Georgia",1106,945,161,13,77372,14.556962025316455
"Unadilla city, Georgia",1073,847,226,13,78156,21.062441752096923
"Blakely city, Georgia",1871,1619,252,13,08536,13.468733297701762
"Evans CDP, Georgia",11862,10367,1495,13,28044,12.603270949249703
"Ball Ground city, Georgia",848,749,99,13,05036,11.674528301886793
"Woodstock city, Georgia",12708,12060,648,13,84176,5.099150141643059
"Kennesaw city, Georgia",13365,12807,558,13,43192,4.175084175084176
"Arabi town, Georgia",322,269,53,13,02564,16.459627329192546
"Cordele city, Georgia",4627,3715,912,13,19616,19.710395504646637
"Lake Park city, Georgia",341,314,27,13,44704,7.9178885630498534
"Lincolnton city, Georgia",741,695,46,13,46552,6.207827260458839
"Walthourville city, Georgia",2113,1610,503,13,80256,23.805016564126834
"Hahira city, Georgia",1032,940,92,13,36052,8.914728682170542
"Alston town, Georgia",82,61,21,13,01808,25.609756097560975
"Hull city, Georgia",92,80,12,13,40532,13.043478260869565
"Woodbury city, Georgia",550,451,99,13,83896,18.0
"Ailey city, Georgia",190,134,56,13,00828,29.47368421052631
"Lexington city, Georgia",91,81,10,13,46188,10.989010989010989
"Mountain City town, Georgia",565,413,152,13,53116,26.902654867256636
"Sylvania city, Georgia",1301,1092,209,13,75160,16.06456571867794
"Shannon CDP, Georgia",901,758,143,13,69868,15.871254162042176
"Moody AFB CDP, Georgia",320,220,100,13,52556,31.25
"Carlton city, Georgia",190,173,17,13,13212,8.947368421052632
"Ila city, Georgia",169,148,21,13,40840,12.42603550295858
"Mount Vernon city, Georgia",1053,894,159,13,53508,15.0997150997151
"Oxford city, Georgia",684,614,70,13,58744,10.23391812865497
"Chickamauga city, Georgia",1455,1306,149,13,15984,10.240549828178693
"Clayton city, Georgia",1098,829,269,13,16656,24.499089253187613
"Sky Valley city, Georgia",912,172,740,13,71282,81.14035087719299
"Santa Claus city, Georgia",87,74,13,13,68600,14.942528735632186
"Jesup city, Georgia",3659,3022,637,13,42268,17.409128177097568
"Franklin city, Georgia",521,445,76,13,31292,14.587332053742802
"Stapleton city, Georgia",186,131,55,13,73004,29.56989247311828
"East Point city, Georgia",17598,14039,3559,13,25720,20.223889078304353
"Centralhatchee town, Georgia",190,164,26,13,15026,13.684210526315791
"Millen city, Georgia",1578,1145,433,13,51520,27.439797211660327
"Avera city, Georgia",130,82,48,13,04448,36.92307692307693
"Lindale CDP, Georgia",1922,1626,296,13,46580,15.400624349635796
"Cumming city, Georgia",2516,2437,79,13,20932,3.1399046104928456
"Arcade city, Georgia",647,538,109,13,02648,16.846986089644513
"Uvalda city, Georgia",260,193,67,13,78744,25.769230769230766
"Talmo town, Georgia",119,90,29,13,75412,24.369747899159663
"Warm Springs city, Georgia",226,172,54,13,80480,23.893805309734514
"Higgston town, Georgia",163,140,23,13,38348,14.11042944785276
"Eton city, Georgia",388,354,34,13,27932,8.762886597938143
"Bishop town, Georgia",130,114,16,13,08200,12.307692307692308
"Perry city, Georgia",6646,5834,812,13,60340,12.217875413782727
"Warner Robins city, Georgia",32793,29306,3487,13,80508,10.633366877077426
"Dallas city, Georgia",5105,4670,435,13,21324,8.521057786483839
"Hilltop CDP, Georgia",128,96,32,13,38866,25.0
"Maxeys town, Georgia",105,97,8,13,50260,7.6190476190476195
"Dillard city, Georgia",263,175,88,13,22976,33.460076045627375
"Hiram city, Georgia",1479,1410,69,13,39076,4.665314401622718
"Rocky Ford town, Georgia",136,76,60,13,66444,44.11764705882353
"Forest Park city, Georgia",7555,6420,1135,13,30536,15.023163467902052
"Morrow city, Georgia",2425,2115,310,13,53004,12.783505154639174
"Thomaston city, Georgia",3866,3338,528,13,76168,13.657527159855148
"Palmetto city, Georgia",1987,1687,300,13,58884,15.098137896326119
"Phillipsburg CDP, Georgia",437,296,141,13,60508,32.265446224256294
"Sunset Village CDP, Georgia",384,328,56,13,74768,14.583333333333334
"Sunnyside CDP, Georgia",559,479,80,13,74628,14.311270125223613
"Deepstep town, Georgia",67,56,11,13,22108,16.417910447761194
"Reidsville city, Georgia",1390,1209,181,13,64512,13.02158273381295
"Cleveland city, Georgia",1512,1260,252,13,16824,16.666666666666664
"Lyons city, Georgia",1971,1612,359,13,48232,18.21410451547438
"Young Harris city, Georgia",205,167,38,13,84960,18.536585365853657
"Lookout Mountain city, Georgia",732,655,77,13,47336,10.51912568306011
"Lovejoy city, Georgia",2219,1952,267,13,47616,12.032447048219918
"Bainbridge city, Georgia",5253,4436,817,13,04896,15.55301732343423
"Brinson town, Georgia",90,83,7,13,10608,7.777777777777778
"Mansfield city, Georgia",152,143,9,13,49616,5.921052631578947
"Dexter town, Georgia",273,220,53,13,22752,19.413919413919416
"Gay town, Georgia",45,31,14,13,32384,31.11111111111111
"Greenville city, Georgia",441,419,22,13,35016,4.988662131519274
"Pine Mountain town, Georgia",810,608,202,13,61124,24.938271604938272
"Chatsworth city, Georgia",1822,1745,77,13,15508,4.226125137211855
"Newborn town, Georgia",303,267,36,13,54656,11.881188118811881
"Manassas city, Georgia",49,31,18,13,49504,36.734693877551024
"Rossville city, Georgia",1750,1411,339,13,67256,19.371428571428574
"Sumner town, Georgia",177,157,20,13,74432,11.299435028248588
"Abbeville city, Georgia",436,321,115,13,00184,26.376146788990823
"Pineview town, Georgia",239,171,68,13,61320,28.451882845188287
"Lakeview Estates CDP, Georgia",756,656,100,13,44956,13.227513227513226
"Fairburn city, Georgia",5046,4895,151,13,28380,2.992469282600079
"Hamilton city, Georgia",448,423,25,13,36220,5.580357142857143
"Waverly Hall town, Georgia",372,316,56,13,80844,15.053763440860216
"Ellaville city, Georgia",841,656,185,13,26980,21.997621878715815
"Plains city, Georgia",282,222,60,13,61628,21.27659574468085
"Manchester city, Georgia",2058,1608,450,13,49532,21.865889212827987
"Moreland town, Georgia",155,142,13,13,52668,8.38709677419355
"Avalon town, Georgia",96,71,25,13,04392,26.041666666666668
"Soperton city, Georgia",1466,1183,283,13,71772,19.304229195088677
"Sycamore city, Georgia",285,237,48,13,75104,16.842105263157894
"Conley CDP, Georgia",2327,2088,239,13,19280,10.270734851740439
"Oakwood city, Georgia",1640,1414,226,13,57260,13.78048780487805
"Waco city, Georgia",196,178,18,13,79808,9.183673469387756
"Sunny Side city, Georgia",70,56,14,13,74572,20.0
"Cartersville city, Georgia",8467,7824,643,13,13688,7.594189205149404
"Nicholls city, Georgia",404,281,123,13,55440,30.445544554455445
"Emerson city, Georgia",639,596,43,13,27344,6.729264475743349
"Taylorsville town, Georgia",93,82,11,13,75664,11.827956989247312
"Norcross city, Georgia",5417,5089,328,13,55776,6.055011999261584
"Dearing town, Georgia",281,232,49,13,22024,17.437722419928825
"Ideal city, Georgia",188,132,56,13,40812,29.78723404255319
"Jasper city, Georgia",1667,1562,105,13,41932,6.29874025194961
"Fort Gaines city, Georgia",527,371,156,13,30816,29.601518026565465
"Gillsville city, Georgia",85,70,15,13,32860,17.647058823529413
"Lyerly town, Georgia",256,233,23,13,48092,8.984375
"Trion town, Georgia",872,793,79,13,77540,9.059633027522935
"Robins AFB CDP, Georgia",314,302,12,13,65968,3.821656050955414
"Carbon Cliff village, Illinois",917,812,105,17,11150,11.450381679389313
"Coal Valley village, Illinois",1724,1560,164,17,15235,9.51276102088167
"Wheeling village, Illinois",14757,14019,738,17,81087,5.001016466761537
"Godfrey village, Illinois",7740,7362,378,17,30094,4.883720930232558
"Hampton village, Illinois",848,809,39,17,32564,4.599056603773585
"Milan village, Illinois",2655,2486,169,17,49009,6.365348399246705
"Le Roy city, Illinois",1494,1376,118,17,42971,7.898259705488621
"Clarendon Hills village, Illinois",3377,3200,177,17,14572,5.241338466094167
"Glen Ellyn village, Illinois",11147,10599,548,17,29756,4.916120929398044
"Itasca village, Illinois",3603,3463,140,17,37907,3.885650846516792
"Normal town, Illinois",21468,19536,1932,17,53234,8.999441028507546
"Franklin village, Illinois",293,239,54,17,27663,18.43003412969283
"Buda village, Illinois",297,267,30,17,09356,10.1010101010101
"Ladd village, Illinois",566,519,47,17,40598,8.303886925795052
"Seatonville village, Illinois",139,128,11,17,68471,7.913669064748201
"Sheffield village, Illinois",425,374,51,17,69147,12.0
"Loraine village, Illinois",139,126,13,17,44719,9.352517985611511
"DeKalb city, Illinois",16871,15015,1856,17,19161,11.001126192875347
"Kirkland village, Illinois",696,648,48,17,40156,6.896551724137931
"Cornell village, Illinois",211,177,34,17,16405,16.113744075829384
"Roodhouse city, Illinois",940,703,237,17,65481,25.21276595744681
"Odell village, Illinois",415,385,30,17,55171,7.228915662650602
"Camden village, Illinois",59,39,20,17,10695,33.89830508474576
"Martinsville city, Illinois",571,527,44,17,47254,7.705779334500876
"Watson village, Illinois",341,304,37,17,79241,10.850439882697946
"Gladstone village, Illinois",128,113,15,17,29431,11.71875
"Raritan village, Illinois",36,30,6,17,62848,16.666666666666664
"Newark village, Illinois",437,412,25,17,52103,5.720823798627003
"Sandwich city, Illinois",2847,2720,127,17,67548,4.460835967685283
"Bethany village, Illinois",624,554,70,17,05612,11.217948717948719
"Collinsville city, Illinois",11481,10468,1013,17,15599,8.823273234038846
"McLean village, Illinois",360,333,27,17,45811,7.5
"Saybrook village, Illinois",330,304,26,17,67912,7.878787878787878
"Jacksonville city, Illinois",8088,7290,798,17,38115,9.86646884272997
"Bartlett village, Illinois",14048,13388,660,17,04013,4.698177676537585
"Elgin city, Illinois",39172,36682,2490,17,23074,6.356581231491883
"Lexington city, Illinois",871,782,89,17,43094,10.218140068886337
"West Chicago city, Illinois",8085,7585,500,17,80060,6.184291898577613
"Irwin village, Illinois",24,23,1,17,37803,4.166666666666666
"Bloomington city, Illinois",34506,31952,2554,17,06613,7.401611313974381
"Assumption city, Illinois",582,525,57,17,02609,9.793814432989691
"Clinton city, Illinois",3389,2996,393,17,15001,11.596341103570374
"Lyndon village, Illinois",266,238,28,17,45278,10.526315789473683
"Redmon village, Illinois",102,80,22,17,63069,21.568627450980394
"Jeisyville village, Illinois",43,31,12,17,38349,27.906976744186046
"Nason city, Illinois",130,109,21,17,51726,16.153846153846153
"Pana city, Illinois",3100,2440,660,17,57472,21.29032258064516
"Ashmore village, Illinois",455,385,70,17,02557,15.384615384615385
"Bonnie village, Illinois",152,138,14,17,07263,9.210526315789473
"Grandview village, Illinois",732,635,97,17,30835,13.25136612021858
"Riverton village, Illinois",1441,1380,61,17,64486,4.233171408743928
"Spaulding village, Illinois",341,336,5,17,71474,1.466275659824047
"Williamsville village, Illinois",537,512,25,17,81854,4.655493482309125
"New Bedford village, Illinois",33,33,0,17,52155,0.0
"Ohio village, Illinois",224,205,19,17,55379,8.482142857142858
"Frankfort village, Illinois",6363,6067,296,17,27624,4.651893760804652
"Lockport city, Illinois",9362,8853,509,17,44225,5.4368724631489
"Peotone village, Illinois",1555,1514,41,17,59052,2.636655948553055
"Liberty village, Illinois",189,159,30,17,43133,15.873015873015872
"Lima village, Illinois",69,51,18,17,43445,26.08695652173913
"Homer village, Illinois",562,490,72,17,35814,12.811387900355871
"Lake of the Woods CDP, Illinois",1069,974,95,17,41346,8.886810102899906
"Ludlow village, Illinois",211,140,71,17,45174,33.649289099526065
"Elk Grove Village village, Illinois",13786,13224,562,17,23256,4.076599448716089
"Glendale Heights village, Illinois",12097,11418,679,17,29730,5.612961891378028
"Freeman Spur village, Illinois",131,124,7,17,27858,5.343511450381679
"Hurst city, Illinois",404,357,47,17,36815,11.633663366336634
"Walshville village, Illinois",45,41,4,17,78656,8.88888888888889
"McCullom Lake village, Illinois",450,420,30,17,45616,6.666666666666667
"Marengo city, Illinois",3147,3034,113,17,46786,3.5907213218938674
"Donnellson village, Illinois",103,85,18,17,20318,17.475728155339805
"Taylor Springs village, Illinois",257,245,12,17,74561,4.669260700389105
"Ridott village, Illinois",58,58,0,17,64044,0.0
"El Paso city, Illinois",1098,1051,47,17,23737,4.280510018214937
"Galena city, Illinois",1945,1584,361,17,28300,18.560411311053983
"Nora village, Illinois",77,62,15,17,53195,19.480519480519483
"Emden village, Illinois",235,221,14,17,23971,5.957446808510639
"Long Grove village, Illinois",2579,2389,190,17,44524,7.367196587824738
"Riverwoods village, Illinois",1441,1245,196,17,64538,13.601665510062459
"Round Lake village, Illinois",5958,5747,211,17,66027,3.5414568647197044
"Round Lake Heights village, Illinois",920,858,62,17,66053,6.739130434782608
"Venetian Village CDP, Illinois",1146,1030,116,17,77460,10.12216404886562
"Wadsworth village, Illinois",1393,1393,0,17,78370,0.0
"Sherrard village, Illinois",282,264,18,17,69368,6.382978723404255
"Mount Pulaski city, Illinois",713,643,70,17,51128,9.817671809256662
"Joy village, Illinois",210,179,31,17,38739,14.761904761904763
"North Henderson village, Illinois",87,81,6,17,53793,6.896551724137931
"Barry city, Illinois",688,625,63,17,03948,9.156976744186046
"Shelbyville city, Illinois",2239,2060,179,17,69186,7.994640464493077
"Casey city, Illinois",1369,1189,180,17,11618,13.148283418553689
"Toledo village, Illinois",605,561,44,17,75601,7.2727272727272725
"Warren village, Illinois",719,554,165,17,78851,22.94853963838665
"Middletown village, Illinois",174,136,38,17,48853,21.839080459770116
"Aurora city, Illinois",66916,63204,3712,17,03012,5.547253272759878
"Windsor village, Illinois",400,353,47,17,82309,11.75
"Baylis village, Illinois",78,57,21,17,04247,26.923076923076923
"Detroit village, Illinois",33,22,11,17,19681,33.33333333333333
"Oconee village, Illinois",76,72,4,17,55132,5.263157894736842
"Crete village, Illinois",3457,3063,394,17,17523,11.39716517211455
"Crystal Lawns CDP, Illinois",732,702,30,17,17939,4.098360655737705
"Centreville city, Illinois",2630,2010,620,17,12203,23.574144486692013
"Cortland town, Illinois",1470,1342,128,17,16470,8.707482993197278
"Genoa city, Illinois",1925,1874,51,17,28898,2.6493506493506493
"St. Libory village, Illinois",267,218,49,17,66989,18.352059925093634
"Washington Park village, Illinois",2146,1335,811,17,79085,37.79123951537745
"West Salem village, Illinois",451,387,64,17,80853,14.19068736141907
"Dupo village, Illinois",1719,1621,98,17,21254,5.700988947062245
"Freeburg village, Illinois",1749,1721,28,17,27806,1.6009148084619784
"Edinburg village, Illinois",537,496,41,17,22645,7.635009310986965
"Bowen village, Illinois",215,166,49,17,07510,22.790697674418606
"Elvaston village, Illinois",70,59,11,17,23841,15.714285714285714
"Hamilton city, Illinois",1319,1170,149,17,32434,11.296436694465504
"Dowell village, Illinois",220,188,32,17,20565,14.545454545454545
"Murphysboro city, Illinois",4097,3405,692,17,51453,16.89040761532829
"Vergennes village, Illinois",99,85,14,17,77525,14.14141414141414
"West Peoria city, Illinois",2231,1994,237,17,80736,10.623038995965935
"Tallula village, Illinois",235,209,26,17,74379,11.063829787234042
"Lenzburg village, Illinois",214,182,32,17,42860,14.953271028037381
"Summerfield village, Illinois",168,151,17,17,73547,10.119047619047619
"Carlyle city, Illinois",1533,1384,149,17,11228,9.719504240052185
"Germantown village, Illinois",510,489,21,17,29041,4.117647058823529
"Roberts village, Illinois",247,193,54,17,64655,21.86234817813765
"Vernon village, Illinois",81,46,35,17,77681,43.20987654320987
"New Boston city, Illinois",274,229,45,17,52220,16.423357664233578
"Seaton village, Illinois",107,96,11,17,68458,10.2803738317757
"Griggsville city, Illinois",604,544,60,17,31771,9.933774834437086
"New Salem village, Illinois",133,117,16,17,52805,12.030075187969924
"Windsor city, Illinois",587,494,93,17,82322,15.843270868824533
"Channahon village, Illinois",4169,4085,84,17,12476,2.0148716718637565
"Albany village, Illinois",457,417,40,17,00516,8.752735229759299
"Countryside city, Illinois",2636,2544,92,17,16873,3.490136570561457
"Carthage city, Illinois",1400,1115,285,17,11527,20.357142857142858
"La Harpe city, Illinois",631,575,56,17,40832,8.874801901743265
"Nauvoo city, Illinois",689,397,292,17,51791,42.380261248185775
"Pontoosuc village, Illinois",99,54,45,17,61080,45.45454545454545
"Shannon village, Illinois",353,328,25,17,68991,7.0821529745042495
"Wapella village, Illinois",271,239,32,17,78773,11.808118081180812
"Mazon village, Illinois",422,408,14,17,47787,3.3175355450236967
"Huey village, Illinois",104,99,5,17,36477,4.807692307692308
"Naples town, Illinois",102,34,68,17,51661,66.66666666666666
"Beaverville village, Illinois",163,143,20,17,04507,12.269938650306749
"Newman city, Illinois",414,341,73,17,52623,17.632850241545896
"Macedonia village, Illinois",35,20,15,17,45642,42.857142857142854
"Good Hope village, Illinois",208,180,28,17,30458,13.461538461538462
"Chapin village, Illinois",234,182,52,17,12528,22.22222222222222
"Carterville city, Illinois",2592,2368,224,17,11514,8.641975308641975
"Danforth village, Illinois",248,226,22,17,18498,8.870967741935484
"Donovan village, Illinois",130,104,26,17,20331,20.0
"Gilman city, Illinois",810,714,96,17,29275,11.851851851851853
"Energy village, Illinois",603,557,46,17,24166,7.628524046434494
"Spillertown village, Illinois",127,110,17,17,71526,13.385826771653544
"Chrisman city, Illinois",616,539,77,17,14273,12.5
"Metcalf village, Illinois",77,69,8,17,48632,10.38961038961039
"Vermilion village, Illinois",115,97,18,17,77551,15.65217391304348
"Taylorville city, Illinois",5513,5069,444,17,74574,8.053691275167784
"Bone Gap village, Illinois",87,71,16,17,07224,18.39080459770115
"Browns village, Illinois",71,66,5,17,08979,7.042253521126761
"Bentley town, Illinois",17,12,5,17,05274,29.411764705882355
"Schaumburg village, Illinois",31746,29735,2011,17,68003,6.3346563346563345
"Addison village, Illinois",13137,12608,529,17,00243,4.026794549744995
"Elmhurst city, Illinois",17001,16074,927,17,23620,5.452620434092112
"Bradley village, Illinois",6174,5556,618,17,07744,10.00971817298348
"Willowbrook village, Illinois",4131,3907,224,17,81919,5.42241587993222
"Kankakee city, Illinois",11071,9024,2047,17,38934,18.489747990244783
"Momence city, Illinois",1263,1091,172,17,49893,13.618368962787015
"Union Hill village, Illinois",20,17,3,17,76771,15.0
"Ellsworth village, Illinois",105,100,5,17,23555,4.761904761904762
"Concord village, Illinois",85,81,4,17,16054,4.705882352941177
"South Jacksonville village, Illinois",1703,1563,140,17,70889,8.220786846741044
"Granville village, Illinois",580,547,33,17,31017,5.689655172413794
"Maunie village, Illinois",87,68,19,17,47592,21.839080459770116
"Norris City village, Illinois",626,552,74,17,53403,11.821086261980831
"Tampico village, Illinois",331,307,24,17,74470,7.250755287009064
"Crescent City village, Illinois",291,262,29,17,17406,9.965635738831615
"Martinton village, Illinois",158,140,18,17,47280,11.39240506329114
"Pittsburg village, Illinois",272,232,40,17,60209,14.705882352941178
"St. Elmo city, Illinois",604,513,91,17,66794,15.066225165562914
"Bishop Hill village, Illinois",73,64,9,17,06171,12.32876712328767
"Brookfield village, Illinois",7599,6975,624,17,08576,8.211606790367155
"Calumet City city, Illinois",16111,13769,2342,17,10487,14.536651976910186
"Hickory Hills city, Illinois",5480,4957,523,17,34514,9.543795620437956
"Melrose Park village, Illinois",8285,7678,607,17,48242,7.326493663246832
"Palos Hills city, Illinois",7147,6714,433,17,57394,6.058486078074717
"Richton Park village, Illinois",5571,4947,624,17,63706,11.200861604738826
"Merrionette Park village, Illinois",1006,908,98,17,48554,9.74155069582505
"Niles village, Illinois",11746,10966,780,17,53000,6.640558487995913
"Oak Lawn village, Illinois",22857,21415,1442,17,54820,6.308789429933936
"Phoenix village, Illinois",869,721,148,17,59572,17.03107019562716
"Schiller Park village, Illinois",4545,4291,254,17,68081,5.588558855885588
"Stone Park village, Illinois",1416,1264,152,17,72923,10.734463276836157
"Thornton village, Illinois",1103,1033,70,17,75185,6.346328195829557
"Worth village, Illinois",4407,3999,408,17,83518,9.257998638529612
"Arcola city, Illinois",1030,967,63,17,01881,6.116504854368932
"Broughton village, Illinois",78,57,21,17,08875,26.923076923076923
"Plymouth village, Illinois",234,188,46,17,60833,19.65811965811966
"Durand village, Illinois",601,562,39,17,21280,6.4891846921797
"Machesney Park village, Illinois",9272,8751,521,17,45726,5.619068162208801
"Plainville village, Illinois",138,131,7,17,60339,5.072463768115942
"Oak Park village, Illinois",23380,21684,1696,17,54885,7.254063301967493
"Hennepin village, Illinois",416,357,59,17,34098,14.182692307692307
"Inverness village, Illinois",2896,2702,194,17,37608,6.698895027624309
"Markham city, Illinois",4590,4174,416,17,47007,9.063180827886711
"Robbins village, Illinois",2062,1626,436,17,64616,21.144519883608147
"Westchester village, Illinois",6927,6557,370,17,80047,5.34141764111448
"Beardstown city, Illinois",2588,2246,342,17,04351,13.21483771251932
"Chandlerville village, Illinois",238,202,36,17,12450,15.126050420168067
"De Land village, Illinois",227,166,61,17,19200,26.87224669603524
"Batchtown village, Illinois",111,77,34,17,04117,30.630630630630627
"Zeigler city, Illinois",741,605,136,17,84155,18.353576248313093
"Grand Tower city, Illinois",292,242,50,17,30770,17.123287671232877
"Kampsville village, Illinois",198,129,69,17,38856,34.84848484848485
"Mount Carmel city, Illinois",3539,3093,446,17,50868,12.602430064990111
"Rock Island city, Illinois",17218,15412,1806,17,65078,10.489023115344406
"Silvis city, Illinois",3670,3243,427,17,69979,11.634877384196185
"East Peoria city, Illinois",10888,10046,842,17,22164,7.733284349742836
"Keensburg village, Illinois",64,42,22,17,39259,34.375
"Lake Barrington village, Illinois",2456,2326,130,17,40884,5.293159609120521
"Magnolia village, Illinois",145,135,10,17,46110,6.896551724137931
"Hinsdale village, Illinois",6221,5778,443,17,35307,7.1210416331779465
"Warrenville city, Illinois",5135,4872,263,17,78929,5.1217137293086665
"Rosiclare city, Illinois",483,333,150,17,65897,31.05590062111801
"Cabery village, Illinois",112,100,12,17,10292,10.714285714285714
"Essex village, Illinois",300,282,18,17,24452,6.0
"Grant Park village, Illinois",530,493,37,17,30991,6.981132075471698
"Colfax village, Illinois",435,394,41,17,15495,9.425287356321839
"Stanford village, Illinois",308,249,59,17,72260,19.155844155844157
"Murrayville village, Illinois",244,227,17,17,51479,6.967213114754098
"Hopedale village, Illinois",420,377,43,17,36126,10.238095238095237
"Marquette Heights city, Illinois",964,951,13,17,47111,1.3485477178423237
"Carpentersville village, Illinois",11195,10824,371,17,11358,3.31397945511389
"North Aurora village, Illinois",6672,6485,187,17,53442,2.802757793764988
"Fox River Grove village, Illinois",1809,1809,0,17,27533,0.0
"Hebron village, Illinois",536,487,49,17,33851,9.14179104477612
"Johnsburg village, Illinois",2278,2138,140,17,38479,6.145741878841089
"Union village, Illinois",200,168,32,17,76706,16.0
"Harvel village, Illinois",95,77,18,17,33357,18.947368421052634
"Ullin village, Illinois",258,157,101,17,76615,39.14728682170542
"Sun River Terrace village, Illinois",190,146,44,17,73943,23.157894736842106
"Chenoa city, Illinois",926,804,122,17,12931,13.174946004319654
"Downs village, Illinois",334,322,12,17,20643,3.592814371257485
"Gridley village, Illinois",661,605,56,17,31732,8.472012102874432
"Towanda village, Illinois",241,214,27,17,75822,11.20331950207469
"Woodson village, Illinois",202,178,24,17,83336,11.881188118811881
"Monmouth city, Illinois",3913,3494,419,17,50010,10.707896754408381
"Mound Station village, Illinois",57,52,5,17,50790,8.771929824561402
"St. David village, Illinois",331,269,62,17,66768,18.731117824773413
"Ste. Marie village, Illinois",147,120,27,17,66800,18.367346938775512
"Yale village, Illinois",49,31,18,17,83765,36.734693877551024
"Sumner city, Illinois",551,445,106,17,73703,19.237749546279492
"Davis Junction village, Illinois",838,780,58,17,18719,6.921241050119331
"Oakdale village, Illinois",80,69,11,17,54586,13.750000000000002
"Richview village, Illinois",134,111,23,17,63719,17.16417910447761
"Venedy village, Illinois",73,59,14,17,77408,19.17808219178082
"Alsip village, Illinois",7597,7213,384,17,01010,5.054626826378834
"Broadview village, Illinois",3418,3204,214,17,08446,6.260971328262141
"Mount Sterling city, Illinois",1066,946,120,17,51154,11.25703564727955
"Des Plaines city, Illinois",22960,22036,924,17,19642,4.024390243902439
"Forest View village, Illinois",310,290,20,17,26987,6.451612903225806
"Hazel Crest village, Illinois",5761,5192,569,17,33695,9.876757507377192
"Versailles village, Illinois",300,237,63,17,77720,21.0
"Robinson city, Illinois",3238,2733,505,17,64707,15.596046942557134
"Columbia city, Illinois",4283,4125,158,17,15833,3.689003035255662
"East Carondelet village, Illinois",201,166,35,17,21618,17.412935323383085
"Fairmont City village, Illinois",881,740,141,17,24933,16.00454029511918
"Mascoutah city, Illinois",3252,2804,448,17,47423,13.776137761377614
"Bath village, Illinois",146,116,30,17,04156,20.54794520547945
"San Jose village, Illinois",289,264,25,17,67613,8.650519031141869
"Bartonville village, Illinois",2725,2503,222,17,04039,8.146788990825687
"Bellevue village, Illinois",807,718,89,17,04871,11.028500619578686
"Mapleton village, Illinois",127,111,16,17,46643,12.598425196850393
"Hoffman village, Illinois",197,197,0,17,35398,0.0
"Mulberry Grove village, Illinois",276,250,26,17,51284,9.420289855072465
"Glasgow village, Illinois",64,44,20,17,29496,31.25
"Bartelso village, Illinois",234,227,7,17,04000,2.9914529914529915
"Trenton city, Illinois",1204,1112,92,17,75991,7.641196013289036
"Elliott village, Illinois",146,134,12,17,23425,8.21917808219178
"Melvin village, Illinois",267,204,63,17,48268,23.595505617977526
"Forest Lake CDP, Illinois",607,563,44,17,26896,7.248764415156507
"Cobden village, Illinois",463,432,31,17,15300,6.695464362850973
"Cairo city, Illinois",1771,964,807,17,10383,45.56747600225861
"Galva city, Illinois",1299,1157,142,17,28430,10.931485758275597
"Alton city, Illinois",13769,11492,2277,17,01114,16.5371486672961
"Grayslake village, Illinois",8090,7940,150,17,31121,1.8541409147095178
"Highland Park city, Illinois",12418,11564,854,17,34722,6.877113866967305
"Indian Creek village, Illinois",190,190,0,17,37218,0.0
"Kildeer village, Illinois",1366,1292,74,17,39883,5.417276720351391
"Edwardsville city, Illinois",9210,8554,656,17,22697,7.122692725298589
"Old Mill Creek village, Illinois",109,66,43,17,55639,39.44954128440367
"Tremont village, Illinois",905,877,28,17,75965,3.0939226519337018
"Creve Coeur village, Illinois",2252,2146,106,17,17549,4.706927175843695
"Pekin city, Illinois",15188,13892,1296,17,58447,8.533052409797207
"Spring Valley city, Illinois",2406,2190,216,17,72156,8.977556109725686
"Scales Mound village, Illinois",204,195,9,17,67925,4.411764705882353
"Broadwell village, Illinois",85,78,7,17,08472,8.235294117647058
"Elkhart village, Illinois",207,179,28,17,23269,13.526570048309178
"Gifford village, Illinois",378,342,36,17,29145,9.523809523809524
"Bourbonnais village, Illinois",7300,6743,557,17,07471,7.63013698630137
"Beach Park village, Illinois",5046,4682,364,17,04303,7.2136345620293305
"Gurnee village, Illinois",11885,11432,453,17,32018,3.811527135044173
"Gages Lake CDP, Illinois",3947,3592,355,17,28248,8.99417278946035
"Payson village, Illinois",454,411,43,17,58265,9.47136563876652
"Fisher village, Illinois",801,740,61,17,26194,7.615480649188515
"Lake Forest city, Illinois",7648,6878,770,17,41105,10.067991631799163
"Greensburg city, Indiana",5259,4891,368,18,29718,6.997528047157255
"North Barrington village, Illinois",1153,1068,85,17,53455,7.372072853425846
"Fox Lake Hills CDP, Illinois",1078,968,110,17,27455,10.204081632653061
"Highwood city, Illinois",2094,1994,100,17,34865,4.775549188156638
"Cuba city, Illinois",554,482,72,17,17991,12.996389891696749
"Smithfield village, Illinois",99,85,14,17,70226,14.14141414141414
"Leaf River village, Illinois",263,251,12,17,42457,4.562737642585551
"Nashville city, Illinois",1410,1340,70,17,51700,4.964539007092199
"Dakota village, Illinois",233,214,19,17,18342,8.15450643776824
"Roanoke village, Illinois",906,786,120,17,64590,13.245033112582782
"Loda village, Illinois",187,146,41,17,44264,21.92513368983957
"Papineau village, Illinois",73,68,5,17,57576,6.8493150684931505
"Johnston City city, Illinois",1560,1438,122,17,38544,7.82051282051282
"Petersburg city, Illinois",1137,1065,72,17,59312,6.33245382585752
"Atwood village, Illinois",558,487,71,17,02882,12.724014336917563
"Cerro Gordo village, Illinois",568,531,37,17,12268,6.514084507042253
"Benton city, Illinois",3364,2873,491,17,05300,14.595719381688465
"Glasford village, Illinois",494,463,31,17,29483,6.275303643724696
"Millstadt village, Illinois",1561,1518,43,17,49386,2.754644458680333
"New Baden village, Illinois",1330,1232,98,17,52142,7.368421052631578
"Shiloh village, Illinois",5902,5149,753,17,69524,12.75838698746188
"Athens city, Illinois",898,803,95,17,02674,10.579064587973273
"West City village, Illinois",328,276,52,17,80073,15.853658536585366
"Salem city, Illinois",3339,3001,338,17,67236,10.122791254866726
"Greenville city, Illinois",2412,1996,416,17,31589,17.24709784411277
"Ashkum village, Illinois",365,322,43,17,02479,11.78082191780822
"Junction City village, Illinois",220,199,21,17,38791,9.545454545454547
"Cahokia village, Illinois",6575,4910,1665,17,10370,25.323193916349812
"Washburn village, Illinois",454,426,28,17,79007,6.167400881057269
"East Galesburg village, Illinois",326,307,19,17,21826,5.828220858895705
"Royal Lakes village, Illinois",130,84,46,17,66196,35.38461538461539
"Standard City village, Illinois",72,72,0,17,72234,0.0
"Olney city, Illinois",4465,3762,703,17,55912,15.74468085106383
"Hoopeston city, Illinois",2649,2188,461,17,36061,17.40279350698377
"Indianola village, Illinois",101,95,6,17,37348,5.9405940594059405
"Muncie village, Illinois",79,75,4,17,51336,5.063291139240507
"Loami village, Illinois",392,360,32,17,44173,8.16326530612245
"Quincy city, Illinois",19234,17308,1926,17,62367,10.013517729021524
"Ursa village, Illinois",289,255,34,17,77044,11.76470588235294
"Broadlands village, Illinois",136,130,6,17,08420,4.411764705882353
"Pawnee village, Illinois",1118,1007,111,17,58174,9.928443649373882
"Jeffersonville village, Illinois",203,181,22,17,38323,10.83743842364532
"Johnsonville village, Illinois",41,27,14,17,38531,34.146341463414636
"Wayne City village, Illinois",506,421,85,17,79436,16.798418972332016
"Cowden village, Illinois",259,221,38,17,17055,14.671814671814673
"Herrick village, Illinois",185,156,29,17,34332,15.675675675675677
"Moweaqua village, Illinois",928,814,114,17,51232,12.284482758620689
"Braidwood city, Illinois",3121,2467,654,17,07770,20.954822172380645
"Ingalls Park CDP, Illinois",1346,1197,149,17,37465,11.069836552748885
"Manhattan village, Illinois",2578,2526,52,17,46357,2.017067494181536
"Park Forest village, Illinois",9257,8302,955,17,57732,10.31651723020417
"Yates City village, Illinois",348,317,31,17,83817,8.908045977011495
"Medora village, Illinois",216,167,49,17,48138,22.685185185185187
"Claremont village, Illinois",91,76,15,17,14533,16.483516483516482
"Fithian village, Illinois",240,212,28,17,26233,11.666666666666666
"Springerton village, Illinois",57,47,10,17,71643,17.543859649122805
"Carmi city, Illinois",2644,2192,452,17,11293,17.095310136157337
"Crossville village, Illinois",386,324,62,17,17783,16.06217616580311
"Grayville city, Illinois",876,704,172,17,31165,19.63470319634703
"Phillipstown village, Illinois",32,31,1,17,59520,3.125
"Fulton city, Illinois",1519,1496,23,17,28144,1.5141540487162608
"Ringwood village, Illinois",291,275,16,17,64135,5.498281786941581
"Trout Valley village, Illinois",191,175,16,17,76160,8.37696335078534
"Coffeen city, Illinois",330,263,67,17,15352,20.303030303030305
"Nokomis city, Illinois",1066,880,186,17,53169,17.4484052532833
"Panama village, Illinois",134,113,21,17,57498,15.671641791044777
"Wenonah village, Illinois",12,12,0,17,79826,0.0
"Congerville village, Illinois",226,222,4,17,16119,1.7699115044247788
"Goodfield village, Illinois",340,332,8,17,30445,2.3529411764705883
"Harmon village, Illinois",57,57,0,17,32967,0.0
"Paw Paw village, Illinois",414,350,64,17,58226,15.458937198067632
"Clear Lake village, Illinois",103,92,11,17,14845,10.679611650485436
"Lynnville village, Illinois",39,34,5,17,45369,12.82051282051282
"Bensenville village, Illinois",6432,6330,102,17,05248,1.585820895522388
"Pesotum village, Illinois",226,207,19,17,59273,8.4070796460177
"Rantoul village, Illinois",6024,5088,936,17,62783,15.53784860557769
"Sidney village, Illinois",540,515,25,17,69875,4.62962962962963
"Roselle village, Illinois",8680,8441,239,17,65806,2.7534562211981566
"Winfield village, Illinois",3988,3946,42,17,82400,1.053159478435306
"Ford Heights village, Illinois",1195,920,275,17,26710,23.01255230125523
"Herscher village, Illinois",635,605,30,17,34384,4.724409448818897
"Bedford Park village, Illinois",218,204,14,17,04572,6.422018348623854
"Cicero town, Illinois",24582,22226,2356,17,14351,9.584248637214223
"Franklin Park village, Illinois",6775,6270,505,17,27702,7.453874538745388
"Glencoe village, Illinois",3528,3234,294,17,29652,8.333333333333332
"Scott AFB CDP, Illinois",1078,872,206,17,68328,19.109461966604822
"Smithton village, Illinois",1575,1517,58,17,70252,3.6825396825396823
"Swansea village, Illinois",6047,5579,468,17,74119,7.739374896642963
"Forest City village, Illinois",117,109,8,17,26753,6.837606837606838
"Mason City city, Illinois",1174,1067,107,17,47475,9.114139693356048
"Dolton village, Illinois",8834,7690,1144,17,20292,12.949966040298847
"Flossmoor village, Illinois",3566,3329,237,17,26571,6.646102075154234
"Glenwood village, Illinois",3396,2954,442,17,30029,13.015312131919906
"Palestine village, Illinois",692,591,101,17,57277,14.595375722543352
"Fairview village, Illinois",212,186,26,17,25063,12.264150943396226
"Marietta village, Illinois",51,43,8,17,46825,15.686274509803921
"Vermont village, Illinois",369,329,40,17,77642,10.840108401084011
"Hidalgo village, Illinois",43,40,3,17,34553,6.976744186046512
"Newton city, Illinois",1409,1157,252,17,52844,17.885024840312276
"Willow Hill village, Illinois",82,82,0,17,82010,0.0
"St. Francisville city, Illinois",335,266,69,17,66833,20.597014925373134
"Henry city, Illinois",1195,1040,155,17,34163,12.97071129707113
"Varna village, Illinois",214,182,32,17,77395,14.953271028037381
"Polo city, Illinois",1094,928,166,17,60937,15.173674588665447
"Raleigh village, Illinois",157,117,40,17,62588,25.477707006369428
"Radom village, Illinois",97,82,15,17,62523,15.463917525773196
"Berkeley village, Illinois",1816,1723,93,17,05404,5.121145374449339
"Blue Island city, Illinois",9246,8036,1210,17,06704,13.08674021198356
"Rossville village, Illinois",619,513,106,17,65962,17.12439418416801
"Thomson village, Illinois",247,194,53,17,75172,21.45748987854251
"Eldred village, Illinois",113,80,33,17,23022,29.20353982300885
"Camp Point village, Illinois",502,437,65,17,10877,12.94820717131474
"Columbus village, Illinois",24,20,4,17,15846,16.666666666666664
"Carrollton city, Illinois",1173,996,177,17,11462,15.089514066496163
"Centralia city, Illinois",6332,5449,883,17,12164,13.94504106127606
"Irvington village, Illinois",323,295,28,17,37777,8.6687306501548
"Okawville village, Illinois",737,657,80,17,55470,10.854816824966079
"Burbank city, Illinois",9646,9197,449,17,09642,4.65477918308107
"Pleasant Plains village, Illinois",313,295,18,17,60599,5.7507987220447285
"Thayer village, Illinois",349,314,35,17,74860,10.028653295128938
"Altona village, Illinois",238,229,9,17,01140,3.7815126050420167
"Hillcrest village, Illinois",426,421,5,17,34982,1.1737089201877933
"Pearl village, Illinois",87,60,27,17,58343,31.03448275862069
"Pittsfield city, Illinois",2023,1845,178,17,60222,8.7988136431043
"Mokena village, Illinois",7385,7144,241,17,49854,3.2633716993906567
"Monee village, Illinois",2226,2126,100,17,49945,4.492362982929021
"New Lenox village, Illinois",8884,8542,342,17,52584,3.84961728950923
"Steger village, Illinois",4782,4297,485,17,72520,10.142199916352991
"Mount Carroll city, Illinois",845,677,168,17,50881,19.881656804733726
"De Witt village, Illinois",108,92,16,17,19798,14.814814814814813
"Maple Park village, Illinois",517,499,18,17,46604,3.481624758220503
"South Elgin village, Illinois",7344,7246,98,17,70720,1.3344226579520697
"Greenwood village, Illinois",100,95,5,17,31667,5.0
"Holiday Hills village, Illinois",291,278,13,17,35515,4.4673539518900345
"McLeansboro city, Illinois",1375,1184,191,17,45824,13.89090909090909
"Macomb city, Illinois",8370,6128,2242,17,45889,26.786140979689364
"Cypress village, Illinois",107,85,22,17,18251,20.5607476635514
"New Burnside village, Illinois",101,77,24,17,52285,23.762376237623762
"Colchester city, Illinois",739,609,130,17,15378,17.591339648173207
"Rosewood Heights CDP, Illinois",1902,1782,120,17,65884,6.309148264984227
"Wilsonville village, Illinois",321,278,43,17,82218,13.395638629283487
"Noble village, Illinois",246,228,18,17,53143,7.317073170731707
"Hamel village, Illinois",347,318,29,17,32408,8.357348703170029
"Pierron village, Illinois",232,218,14,17,59709,6.0344827586206895
"Pontoon Beach village, Illinois",2575,2134,441,17,61067,17.12621359223301
"Roxana village, Illinois",698,616,82,17,66131,11.74785100286533
"Venice city, Illinois",991,790,201,17,77473,20.282542885973765
"Wood River city, Illinois",4854,4312,542,17,83271,11.166048619695097
"Port Byron village, Illinois",800,749,51,17,61223,6.375
"Bellmont village, Illinois",100,86,14,17,04936,14.000000000000002
"Woodland village, Illinois",128,125,3,17,83102,2.34375
"Crainville village, Illinois",658,588,70,17,17185,10.638297872340425
"Creal Springs city, Illinois",267,208,59,17,17289,22.09737827715356
"Herrin city, Illinois",6153,5241,912,17,34358,14.822038030229157
"Hillsdale village, Illinois",261,200,61,17,35073,23.371647509578544
"Marion city, Illinois",8412,7468,944,17,46916,11.222063718497385
"Edgewood village, Illinois",251,200,51,17,22567,20.318725099601593
"Effingham city, Illinois",5660,5285,375,17,22736,6.625441696113074
"Mason town, Illinois",138,126,12,17,47449,8.695652173913043
"Montrose village, Illinois",119,98,21,17,50283,17.647058823529413
"Oquawka village, Illinois",796,687,109,17,56237,13.693467336683419
"Oswego village, Illinois",11292,11114,178,17,56887,1.5763372298972722
"Forsyth village, Illinois",1209,1153,56,17,27091,4.631927212572374
"Long Creek village, Illinois",548,529,19,17,44498,3.4671532846715327
"Mount Zion village, Illinois",2344,2181,163,17,51206,6.953924914675767
"Dongola village, Illinois",356,270,86,17,20305,24.15730337078652
"Jonesboro city, Illinois",865,749,116,17,38635,13.410404624277456
"Mill Creek village, Illinois",37,23,14,17,49178,37.83783783783784
"Fidelity village, Illinois",79,49,30,17,25960,37.9746835443038
"Fieldon village, Illinois",116,92,24,17,26012,20.689655172413794
"Jerseyville city, Illinois",3915,3425,490,17,38414,12.51596424010217
"Forrest village, Illinois",456,427,29,17,27026,6.359649122807018
"Vandalia city, Illinois",2533,2059,474,17,77317,18.712988551125147
"Colona city, Illinois",2174,2015,159,17,15664,7.313707451701931
"Geneseo city, Illinois",3038,2740,298,17,28846,9.809084924292298
"Glen Carbon village, Illinois",5614,5220,394,17,29639,7.018168863555398
"Highland city, Illinois",4419,4211,208,17,34670,4.706947273138719
"St. Jacob village, Illinois",534,521,13,17,66859,2.4344569288389515
"Reddick village, Illinois",82,73,9,17,63056,10.975609756097562
"Baldwin village, Illinois",167,126,41,17,03454,24.550898203592812
"Rockwood village, Illinois",11,11,0,17,65221,0.0
"Thebes village, Illinois",198,115,83,17,74873,41.91919191919192
"Iola village, Illinois",57,46,11,17,37621,19.298245614035086
"Sailor Springs village, Illinois",68,48,20,17,66599,29.411764705882355
"Culdesac city, Idaho",166,144,22,16,19900,13.253012048192772
"Lapwai city, Idaho",436,391,45,16,45370,10.321100917431194
"Kamiah city, Idaho",644,548,96,16,42400,14.906832298136646
"Mullan city, Idaho",401,307,94,16,55630,23.44139650872818
"Arco city, Idaho",438,273,165,16,03160,37.67123287671233
"Weston city, Idaho",167,145,22,16,87040,13.17365269461078
"Marsing city, Idaho",541,489,52,16,50950,9.611829944547134
"Hansen city, Idaho",584,534,50,16,34930,8.561643835616438
"Stanley city, Idaho",103,35,68,16,76780,66.01941747572816
"Bovill city, Idaho",147,115,32,16,09730,21.768707482993197
"Paris city, Idaho",344,243,101,16,60580,29.360465116279073
"Dover city, Idaho",344,259,85,16,22510,24.709302325581394
"Dalton Gardens city, Idaho",1065,1014,51,16,20350,4.788732394366197
"Rathdrum city, Idaho",3122,2831,291,16,66340,9.320948110185778
"Moscow city, Idaho",10589,9977,612,16,54550,5.779582585702143
"Carey city, Idaho",241,213,28,16,12790,11.618257261410788
"Lewiston city, Idaho",14477,13564,913,16,46540,6.306555225530151
"Elk River city, Idaho",145,71,74,16,25120,51.03448275862069
"Hazelton city, Idaho",270,238,32,16,36730,11.851851851851853
"Idaho City city, Idaho",260,207,53,16,39610,20.384615384615383
"Ashton city, Idaho",500,376,124,16,03610,24.8
"Reubens city, Idaho",35,29,6,16,67150,17.142857142857142
"Kellogg city, Idaho",1267,991,276,16,42580,21.783741120757696
"Cambridge city, Idaho",156,121,35,16,12520,22.435897435897438
"Grand View city, Idaho",169,160,9,16,32770,5.325443786982249
"Rexburg city, Idaho",10873,8018,2855,16,67420,26.25770256598915
"Donnelly city, Idaho",73,24,49,16,22330,67.12328767123287
"Declo city, Idaho",140,136,4,16,20980,2.857142857142857
"Rupert city, Idaho",2394,2076,318,16,70660,13.283208020050125
"Glenns Ferry city, Idaho",697,553,144,16,31690,20.65997130559541
"Mountain Home city, Idaho",6150,5497,653,16,54730,10.61788617886179
"Greenleaf city, Idaho",462,408,54,16,33490,11.688311688311687
"Middleton city, Idaho",2405,2288,117,16,52660,4.864864864864865
"Castleford city, Idaho",81,72,9,16,13240,11.11111111111111
"Fairfield city, Idaho",219,135,84,16,26290,38.35616438356164
"Dubois city, Idaho",263,206,57,16,22960,21.673003802281368
"Bliss city, Idaho",161,140,21,16,08470,13.043478260869565
"Payette city, Idaho",3058,2959,99,16,61300,3.237410071942446
"St. Maries city, Idaho",1214,1145,69,16,71470,5.683690280065898
"Cottonwood city, Idaho",380,333,47,16,18640,12.368421052631579
"Grangeville city, Idaho",1566,1341,225,16,32950,14.367816091954023
"Bonners Ferry city, Idaho",1245,1155,90,16,09370,7.228915662650602
"Grace city, Idaho",496,445,51,16,32500,10.28225806451613
"Spencer city, Idaho",69,14,55,16,75970,79.71014492753623
"Pocatello city, Idaho",22896,20552,2344,16,64090,10.23759608665269
"Rockland city, Idaho",101,73,28,16,69130,27.722772277227726
"New Plymouth city, Idaho",638,583,55,16,56980,8.620689655172415
"Moyie Springs city, Idaho",337,311,26,16,55270,7.71513353115727
"Mountain Home AFB CDP, Idaho",1086,1010,76,16,54820,6.998158379373849
"Filer city, Idaho",1047,945,102,16,27730,9.742120343839542
"Soda Springs city, Idaho",1269,1082,187,16,75195,14.736012608353033
"Gooding city, Idaho",1662,1413,249,16,32140,14.981949458483754
"Hagerman city, Idaho",529,431,98,16,34300,18.525519848771268
"McCammon city, Idaho",321,266,55,16,48880,17.133956386292834
"Stites city, Idaho",128,110,18,16,77500,14.0625
"Acequia city, Idaho",54,52,2,16,00280,3.7037037037037033
"Fruitland city, Idaho",2168,2032,136,16,28990,6.273062730627306
"Emmett city, Idaho",2995,2684,311,16,25570,10.38397328881469
"Downey city, Idaho",353,299,54,16,22600,15.29745042492918
"Tensed city, Idaho",49,36,13,16,80200,26.53061224489796
"Paul city, Idaho",511,465,46,16,61210,9.001956947162427
"Kimberly city, Idaho",1314,1206,108,16,43570,8.21917808219178
"Lewisville city, Idaho",160,151,9,16,46720,5.625
"Caldwell city, Idaho",17294,16342,952,16,12250,5.504799352376547
"Notus city, Idaho",234,209,25,16,58060,10.683760683760683
"Salmon city, Idaho",1620,1395,225,16,71650,13.88888888888889
"Plummer city, Idaho",418,357,61,16,63910,14.5933014354067
"Mackay city, Idaho",339,191,148,16,49240,43.657817109144545
"Minidoka city, Idaho",55,38,17,16,53110,30.909090909090907
"Arimo city, Idaho",125,113,12,16,03340,9.6
"Inkom city, Idaho",324,303,21,16,40330,6.481481481481481
"Nampa city, Idaho",33122,31585,1537,16,56260,4.6404202644767825
"Wilder city, Idaho",525,486,39,16,87670,7.428571428571429
"Bancroft city, Idaho",144,113,31,16,04420,21.52777777777778
"St. Charles city, Idaho",145,53,92,16,71110,63.44827586206897
"Clark Fork city, Idaho",266,243,23,16,14950,8.646616541353383
"Kootenai city, Idaho",337,305,32,16,44200,9.495548961424333
"Hayden Lake city, Idaho",438,332,106,16,36460,24.200913242009133
"Firth city, Idaho",172,167,5,16,27910,2.9069767441860463
"Fort Hall CDP, Idaho",1169,1056,113,16,28360,9.666381522668948
"Shelley city, Idaho",1360,1262,98,16,73450,7.205882352941176
"Jerome city, Idaho",4277,3908,369,16,41320,8.627542670095862
"Crouch city, Idaho",83,50,33,16,19720,39.75903614457831
"St. Anthony city, Idaho",1158,1026,132,16,71020,11.398963730569948
"Smelterville city, Idaho",378,301,77,16,75070,20.37037037037037
"Midvale city, Idaho",112,80,32,16,52750,28.57142857142857
"Moore city, Idaho",120,84,36,16,54100,30.0
"Dayton city, Idaho",181,162,19,16,20710,10.497237569060774
"Burley city, Idaho",3960,3659,301,16,11260,7.601010101010101
"Placerville city, Idaho",67,17,50,16,63550,74.6268656716418
"Riggins city, Idaho",272,148,124,16,67870,45.588235294117645
"Bloomington city, Idaho",117,69,48,16,08560,41.02564102564102
"Fernan Lake Village city, Idaho",77,66,11,16,27550,14.285714285714285
"Shoshone city, Idaho",609,512,97,16,73900,15.92775041050903
"Irwin city, Idaho",188,105,83,16,40510,44.148936170212764
"Cascade city, Idaho",602,195,407,16,13150,67.60797342192691
"Orofino city, Idaho",1155,1015,140,16,59320,12.121212121212121
"Eagle city, Idaho",9910,9337,573,16,23410,5.782038345105954
"Wendell city, Idaho",967,862,105,16,86320,10.858324715615305
"Menan city, Idaho",254,236,18,16,52030,7.086614173228346
"Kooskia city, Idaho",306,246,60,16,44110,19.607843137254903
"Lava Hot Springs city, Idaho",280,114,166,16,45820,59.285714285714285
"Roberts city, Idaho",218,188,30,16,68500,13.761467889908257
"Clayton city, Idaho",7,0,7,16,15490,100.0
"Malta city, Idaho",92,65,27,16,50230,29.347826086956523
"Melba city, Idaho",243,219,24,16,51850,9.876543209876543
"Victor city, Idaho",1060,799,261,16,84250,24.62264150943396
"Banks CDP, Idaho",36,7,29,16,04600,80.55555555555556
"Bennington CDP, Idaho",155,116,39,16,06670,25.161290322580644
"Blanchard CDP, Idaho",274,105,169,16,08290,61.67883211678832
"Conkling Park CDP, Idaho",171,37,134,16,17830,78.3625730994152
"De Smet CDP, Idaho",50,41,9,16,21520,18.0
"Garden Valley CDP, Idaho",185,131,54,16,29710,29.18918918918919
"Groveland CDP, Idaho",271,271,0,16,34030,0.0
"Lincoln CDP, Idaho",1275,1186,89,16,47080,6.980392156862745
"Lowman CDP, Idaho",76,16,60,16,48250,78.94736842105263
"Moreland CDP, Idaho",459,386,73,16,54370,15.904139433551197
"Murphy CDP, Idaho",29,17,12,16,55720,41.37931034482759
"Princeton CDP, Idaho",43,43,0,16,65620,0.0
"Riverside CDP, Idaho",372,338,34,16,68230,9.13978494623656
"Robie Creek CDP, Idaho",837,657,180,16,68545,21.50537634408602
"Rockford CDP, Idaho",56,56,0,16,68860,0.0
"Rockford Bay CDP, Idaho",512,143,369,16,68950,72.0703125
"Smiths Ferry CDP, Idaho",188,39,149,16,75160,79.25531914893617
"Sweetwater CDP, Idaho",66,58,8,16,79300,12.121212121212121
"Yellow Pine CDP, Idaho",185,0,185,16,88660,100.0
"Hidden Springs CDP, Idaho",904,828,76,16,37500,8.4070796460177
"Elk City CDP, Idaho",104,40,64,16,25030,61.53846153846154
"Parkline CDP, Idaho",27,24,3,16,60880,11.11111111111111
"Tyhee CDP, Idaho",433,415,18,16,83170,4.157043879907621
"Maunaloa CDP, Hawaii",178,124,54,15,50150,30.337078651685395
"Kilauea CDP, Hawaii",950,796,154,15,36650,16.210526315789473
"Pakala Village CDP, Hawaii",141,93,48,15,60350,34.04255319148936
"Ahuimanu CDP, Hawaii",2671,2625,46,15,00400,1.7222014226881317
"Aiea CDP, Hawaii",2813,2620,193,15,00550,6.8610024884464975
"Ewa Beach CDP, Hawaii",3334,3050,284,15,07450,8.518296340731855
"Halawa CDP, Hawaii",4315,4077,238,15,10000,5.515643105446118
"Keaau CDP, Hawaii",775,696,79,15,32900,10.193548387096774
"Kapaa CDP, Hawaii",4639,3552,1087,15,28850,23.43177408924337
"Haiku-Pauwela CDP, Hawaii",3437,2942,495,15,09260,14.402094850160024
"Kahului CDP, Hawaii",8529,7914,615,15,22700,7.210692930003518
"Mililani Town CDP, Hawaii",9029,8801,228,15,51050,2.5251965887695205
"Wahiawa CDP, Hawaii",6013,5546,467,15,72650,7.766505903874937
"Honaunau-Napoopoo CDP, Hawaii",1047,823,224,15,16160,21.39446036294174
"Kapaau CDP, Hawaii",731,572,159,15,29000,21.751025991792066
"Nanawale Estates CDP, Hawaii",772,663,109,15,53975,14.119170984455959
"Papaikou CDP, Hawaii",534,384,150,15,61550,28.08988764044944
"Paukaa CDP, Hawaii",289,242,47,15,61700,16.26297577854671
"Waikoloa Village CDP, Hawaii",3291,2428,863,15,76600,26.223032512914006
"Kihei CDP, Hawaii",12345,8001,4344,15,36500,35.18833535844472
"Maalaea CDP, Hawaii",599,157,442,15,46400,73.78964941569282
"Makawao CDP, Hawaii",2648,2582,66,15,48050,2.492447129909366
"Waikapu CDP, Hawaii",1051,995,56,15,75950,5.32825880114177
"Hanamaulu CDP, Hawaii",1237,1170,67,15,11650,5.416329830234439
"Kalaheo CDP, Hawaii",1929,1655,274,15,24950,14.204250907205807
"Puhi CDP, Hawaii",1006,956,50,15,65750,4.970178926441352
"Wailua CDP, Hawaii",1547,997,550,15,77000,35.55268261150614
"Kahaluu CDP, Hawaii",1490,1269,221,15,21200,14.832214765100671
"Pearl City CDP, Hawaii",14540,13987,553,15,62600,3.8033012379642366
"Schofield Barracks CDP, Hawaii",4842,4462,380,15,69050,7.847996695580339
"Ainaloa CDP, Hawaii",1256,1158,98,15,01085,7.802547770700636
"Fern Acres CDP, Hawaii",746,590,156,15,07542,20.91152815013405
"Hawaiian Ocean View CDP, Hawaii",2407,1639,768,15,12530,31.906938097216454
"Holualoa CDP, Hawaii",5227,3372,1855,15,15700,35.48880811172757
"Kealakekua CDP, Hawaii",810,756,54,15,33950,6.666666666666667
"Kukuihaele CDP, Hawaii",138,99,39,15,41000,28.26086956521739
"Pahala CDP, Hawaii",517,437,80,15,59750,15.473887814313347
"Pahoa CDP, Hawaii",408,319,89,15,59900,21.813725490196077
"Kaanapali CDP, Hawaii",1778,455,1323,15,20000,74.40944881889764
"Napili-Honokowai CDP, Hawaii",4341,2772,1569,15,54100,36.14374568071873
"Waihee-Waiehu CDP, Hawaii",2542,2419,123,15,75510,4.838709677419355
"Wailuku CDP, Hawaii",6805,6147,658,15,77450,9.669360764144013
"Wailua Homesteads CDP, Hawaii",2188,2039,149,15,77225,6.809872029250457
"Kekaha CDP, Hawaii",1373,1075,298,15,35600,21.704297159504733
"Koloa CDP, Hawaii",938,866,72,15,39200,7.675906183368871
"Princeville CDP, Hawaii",2424,783,1641,15,65075,67.69801980198021
"Ewa Gentry CDP, Hawaii",7473,7264,209,15,07470,2.796734912351131
"Hauula CDP, Hawaii",1025,837,188,15,12400,18.341463414634145
"Makaha Valley CDP, Hawaii",743,511,232,15,47560,31.22476446837147
"Kaaawa CDP, Hawaii",501,415,86,15,19550,17.16566866267465
"Kailua CDP (Honolulu County), Hawaii",13331,12436,895,15,23150,6.713674893106293
"Kaneohe CDP, Hawaii",11195,10559,636,15,28250,5.681107637338098
"Laie CDP, Hawaii",971,855,116,15,43250,11.946446961894953
"Mokuleia CDP, Hawaii",914,738,176,15,52550,19.25601750547046
"Waipio CDP, Hawaii",3964,3850,114,15,79860,2.875882946518668
"Nanakuli CDP, Hawaii",2792,2711,81,15,53900,2.9011461318051577
"Pupukea CDP, Hawaii",1840,1453,387,15,66800,21.032608695652176
"Waialua CDP, Hawaii",1215,1129,86,15,74000,7.078189300411522
"Leilani Estates CDP, Hawaii",937,806,131,15,44562,13.980789754535753
"Hawi CDP, Hawaii",431,378,53,15,13600,12.296983758700696
"Wainaku CDP, Hawaii",512,434,78,15,78950,15.234375
"Eleele CDP, Hawaii",860,810,50,15,07000,5.813953488372093
"Waimanalo CDP, Hawaii",1399,1366,33,15,78050,2.3588277340957826
"Captain Cook CDP, Hawaii",1286,1152,134,15,03850,10.419906687402799
"Halaula CDP, Hawaii",189,169,20,15,09700,10.582010582010582
"Honalo CDP, Hawaii",858,779,79,15,16000,9.207459207459207
"Honokaa CDP, Hawaii",808,640,168,15,16450,20.792079207920793
"Kailua CDP (Hawaii County), Hawaii",5754,4674,1080,15,23000,18.769551616266945
"Puako CDP, Hawaii",2358,414,1944,15,65150,82.44274809160305
"Haliimaile CDP, Hawaii",351,308,43,15,10900,12.250712250712251
"Lanai City CDP, Hawaii",1463,1130,333,15,43700,22.761449077238552
"Paia CDP, Hawaii",977,723,254,15,60200,25.99795291709314
"Pukalani CDP, Hawaii",3145,2866,279,15,65900,8.871224165341813
"Hanalei CDP, Hawaii",401,120,281,15,11500,70.07481296758104
"Poipu CDP, Hawaii",1662,479,1183,15,64550,71.17930204572804
"Waimea CDP (Kauai County), Hawaii",793,664,129,15,78800,16.26733921815889
"Hickam Housing CDP, Hawaii",2810,2583,227,15,14200,8.07829181494662
"Iroquois Point CDP, Hawaii",1170,1051,119,15,19100,10.17094017094017
"Kaneohe Station CDP, Hawaii",2737,2548,189,15,28400,6.905370843989769
"Maunawili CDP, Hawaii",712,704,8,15,50750,1.1235955056179776
"Waimanalo Beach CDP, Hawaii",1125,986,139,15,78200,12.355555555555556
"Waipio Acres CDP, Hawaii",1952,1847,105,15,80000,5.379098360655737
"Whitmore Village CDP, Hawaii",1077,1028,49,15,80900,4.549675023212628
"Honomu CDP, Hawaii",236,164,72,15,17450,30.508474576271187
"Kalaoa CDP, Hawaii",4694,4117,577,15,25400,12.292288027268853
"Naalehu CDP, Hawaii",342,286,56,15,53600,16.374269005847953
"Orchidlands Estates CDP, Hawaii",1122,1033,89,15,58775,7.932263814616755
"Volcano CDP, Hawaii",1928,1405,523,15,72350,27.126556016597508
"Omao CDP, Hawaii",533,465,68,15,57800,12.757973733583489
"Hanapepe CDP, Hawaii",948,860,88,15,11800,9.282700421940929
"Kalihiwai CDP, Hawaii",217,94,123,15,26750,56.68202764976959
"Lihue CDP, Hawaii",2722,2365,357,15,45200,13.115356355620866
"Maili CDP, Hawaii",2741,2657,84,15,47300,3.0645749726377236
"Waianae CDP, Hawaii",3361,3201,160,15,74450,4.760487950014877
"Waikane CDP, Hawaii",184,163,21,15,75800,11.41304347826087
"Waipahu CDP, Hawaii",8654,8205,449,15,79700,5.188352207071874
"Kapalua CDP, Hawaii",972,152,820,15,29725,84.36213991769547
"Lahaina CDP, Hawaii",4298,3574,724,15,42950,16.845044206607724
"Kaumakani CDP, Hawaii",232,228,4,15,30650,1.7241379310344827
"Lawai CDP, Hawaii",901,809,92,15,44450,10.21087680355161
"Discovery Harbour CDP, Hawaii",583,423,160,15,05900,27.4442538593482
"East Honolulu CDP, Hawaii",18413,16552,1861,15,06290,10.106989626894041
"Haena CDP, Hawaii",305,96,209,15,08950,68.52459016393443
"Kalaeloa CDP, Hawaii",2,2,0,15,24850,0.0
"Kapolei CDP, Hawaii",5803,5649,154,15,30300,2.6537997587454765
"Keokea CDP, Hawaii",749,695,54,15,36050,7.209612817089453
"Ko Olina CDP, Hawaii",1410,702,708,15,39400,50.212765957446805
"Kula CDP, Hawaii",3126,2906,220,15,41600,7.037747920665387
"Launiupoko CDP, Hawaii",288,209,79,15,44075,27.430555555555557
"Mahinahina CDP, Hawaii",386,350,36,15,47050,9.32642487046632
"Makakilo CDP, Hawaii",6159,5942,217,15,47600,3.5232992368891054
"Makena CDP, Hawaii",138,78,60,15,48350,43.47826086956522
"Olinda CDP, Hawaii",438,369,69,15,57350,15.753424657534246
"Manele CDP, Hawaii",80,13,67,15,49425,83.75
"Mililani Mauka CDP, Hawaii",7183,6837,346,15,51000,4.81692885980788
"Ocean Pointe CDP, Hawaii",4237,4023,214,15,56685,5.050743450554638
"Olowalu CDP, Hawaii",83,57,26,15,57650,31.32530120481928
"Royal Kunia CDP, Hawaii",4067,3894,173,15,68815,4.253749692648143
"Urban Honolulu CDP, Hawaii",151368,128814,22554,15,71550,14.900110987791344
"Waikele CDP, Hawaii",2860,2696,164,15,76250,5.734265734265734
"Wailea CDP, Hawaii",6236,2521,3715,15,76925,59.5734445157152
"Wainiha CDP, Hawaii",131,46,85,15,79250,64.8854961832061
"Waiohinu CDP, Hawaii",105,99,6,15,79550,5.714285714285714
"West Loch Estate CDP, Hawaii",1623,1535,88,15,80470,5.422057917436845
"Ualapue CDP, Hawaii",313,137,176,15,70700,56.23003194888179
"Hawaiian Acres CDP, Hawaii",1262,956,306,15,12450,24.247226624405705
"Hawaiian Beaches CDP, Hawaii",2172,1665,507,15,12500,23.34254143646409
"Kahaluu-Keauhou CDP, Hawaii",2917,1643,1274,15,21230,43.675008570449094
"Laupahoehoe CDP, Hawaii",292,200,92,15,44150,31.506849315068493
"Paauilo CDP, Hawaii",230,206,24,15,59300,10.434782608695652
"Ewa Villages CDP, Hawaii",1684,1658,26,15,07485,1.5439429928741093
"Kawela Bay CDP, Hawaii",529,134,395,15,32700,74.66918714555766
"Punaluu CDP, Hawaii",577,396,181,15,66500,31.369150779896017
"Wheeler AFB CDP, Hawaii",975,871,104,15,80600,10.666666666666668
"Fern Forest CDP, Hawaii",385,322,63,15,07675,16.363636363636363
"Kahuku CDP, Hawaii",606,557,49,15,22250,8.085808580858085
"Pepeekeo CDP, Hawaii",713,590,123,15,63650,17.251051893408135
"Haleiwa CDP, Hawaii",1254,1096,158,15,10750,12.599681020733652
"Heeia CDP, Hawaii",1553,1497,56,15,13900,3.60592401802962
"Makaha CDP, Hawaii",3165,2302,863,15,47450,27.266982622432863
"Waimalu CDP, Hawaii",5946,5499,447,15,77750,7.51765893037336
"Anahola CDP, Hawaii",754,618,136,15,02200,18.037135278514587
"Eden Roc CDP, Hawaii",381,305,76,15,06325,19.94750656167979
"Hawaiian Paradise Park CDP, Hawaii",4636,3861,775,15,12600,16.71699741156169
"Hilo CDP, Hawaii",18506,16302,2204,15,14650,11.90965092402464
"Kurtistown CDP, Hawaii",538,476,62,15,42800,11.524163568773234
"Mountain View CDP, Hawaii",1533,1313,220,15,53300,14.350945857795171
"Waimea CDP (Hawaii County), Hawaii",3724,3280,444,15,78500,11.92266380236305
"Hana CDP, Hawaii",412,260,152,15,11350,36.89320388349515
"Kaunakakai CDP, Hawaii",1633,1242,391,15,31100,23.943661971830984
"Kualapuu CDP, Hawaii",689,568,121,15,39500,17.561683599419446
"Stronghurst village, Illinois",417,361,56,17,73261,13.42925659472422
"Big Rock village, Illinois",471,444,27,17,05976,5.7324840764331215
"Homer Glen village, Illinois",8561,8292,269,17,35835,3.14215629015302
"LaSalle city, Illinois",4393,3896,497,17,42184,11.313453221033463
"Millbrook village, Illinois",129,129,0,17,49100,0.0
"Monroe Center village, Illinois",175,162,13,17,50062,7.428571428571429
"New Milford village, Illinois",311,311,0,17,52701,0.0
"Port Barrington village, Illinois",551,536,15,17,61216,2.722323049001815
"Curran village, Illinois",109,103,6,17,18147,5.5045871559633035
"McClure village, Illinois",175,112,63,17,45525,36.0
"Campton Hills village, Illinois",3595,3534,61,17,10906,1.6968011126564673
"Kaneville village, Illinois",171,163,8,17,38895,4.678362573099415
"Limestone village, Illinois",587,557,30,17,43510,5.110732538330494
"Plattville village, Illinois",95,95,0,17,60391,0.0
"Sammons Point village, Illinois",110,91,19,17,67372,17.272727272727273
"Alvan village, Illinois",134,115,19,17,01242,14.17910447761194
"Gibson City city, Illinois",1583,1497,86,17,29125,5.432722678458623
"Lake Ka-Ho village, Illinois",155,110,45,17,41214,29.03225806451613
"Astoria town, Illinois",465,386,79,17,02635,16.989247311827956
"Adair CDP, Illinois",102,102,0,17,00178,0.0
"Annapolis CDP, Illinois",17,17,0,17,01556,0.0
"Apple Canyon Lake CDP, Illinois",891,226,665,17,01647,74.63524130190797
"Beason CDP, Illinois",90,72,18,17,04403,20.0
"Boody CDP, Illinois",92,87,5,17,07315,5.434782608695652
"Chemung CDP, Illinois",160,160,0,17,12879,0.0
"Chestnut CDP, Illinois",44,44,0,17,13230,0.0
"Como CDP, Illinois",222,222,0,17,15950,0.0
"Cornland CDP, Illinois",37,37,0,17,16431,0.0
"Crab Orchard CDP, Illinois",113,87,26,17,17094,23.008849557522122
"Darmstadt CDP, Illinois",0,0,0,17,18641,
"Dayton CDP, Illinois",248,227,21,17,18771,8.46774193548387
"Floraville CDP, Illinois",17,17,0,17,26467,0.0
"Georgetown CDP, Illinois",215,190,25,17,28950,11.627906976744185
"Gilson CDP, Illinois",84,84,0,17,29340,0.0
"Goofy Ridge CDP, Illinois",249,154,95,17,30510,38.152610441767074
"Grand Detour CDP, Illinois",248,210,38,17,30705,15.32258064516129
"Harrison CDP, Illinois",416,382,34,17,33162,8.173076923076923
"Heritage Lake CDP, Illinois",548,548,0,17,34272,0.0
"Holiday Shores CDP, Illinois",1054,979,75,17,35541,7.115749525616698
"Knollwood CDP, Illinois",646,584,62,17,40364,9.597523219814242
"Lake Camelot CDP, Illinois",705,624,81,17,40962,11.48936170212766
"Lake Holiday CDP, Illinois",1921,1659,262,17,41157,13.63872982821447
"Lake Petersburg CDP, Illinois",410,335,75,17,41404,18.29268292682927
"Langleyville CDP, Illinois",181,181,0,17,42002,0.0
"LaPlace CDP, Illinois",124,78,46,17,42067,37.096774193548384
"Lost Nation CDP, Illinois",334,334,0,17,44836,0.0
"Lovington village, Illinois",545,514,31,17,45044,5.688073394495413
"East St. Louis city, Illinois",13509,10616,2893,17,22255,21.415352727811086
"Sauget village, Illinois",86,82,4,17,67756,4.651162790697675
"Watseka city, Illinois",2858,2383,475,17,79228,16.62001399580126
"Wellington village, Illinois",118,108,10,17,79735,8.47457627118644
"Stonefort village, Illinois",141,127,14,17,72884,9.929078014184398
"Bement village, Illinois",704,606,98,17,05144,13.920454545454545
"Mansfield village, Illinois",472,436,36,17,46487,7.627118644067797
"Malta village, Illinois",454,398,56,17,46279,12.334801762114537
"Sycamore city, Illinois",6978,6752,226,17,74223,3.2387503582688453
"White Hall city, Illinois",1222,1010,212,17,81256,17.348608837970538
"Wilmington village, Illinois",49,36,13,17,82088,26.53061224489796
"Media village, Illinois",44,44,0,17,48073,0.0
"Willisville village, Illinois",247,233,14,17,81867,5.668016194331984
"Shumway village, Illinois",69,61,8,17,69797,11.594202898550725
"Dallas City city, Illinois",524,419,105,17,18420,20.0381679389313
"Argenta village, Illinois",447,397,50,17,01972,11.185682326621924
"Maroa city, Illinois",737,652,85,17,47072,11.533242876526458
"Ellis Grove village, Illinois",142,131,11,17,23503,7.746478873239436
"Willowbrook CDP, Illinois",777,708,69,17,81938,8.880308880308881
"Hollowayville village, Illinois",24,24,0,17,35671,0.0
"Cedarville village, Illinois",289,263,26,17,12008,8.996539792387544
"Rock City village, Illinois",107,103,4,17,64837,3.7383177570093453
"Minonk city, Illinois",940,882,58,17,49568,6.170212765957447
"Panola village, Illinois",10,10,0,17,57524,0.0
"Mount Vernon city, Illinois",7675,6735,940,17,51180,12.247557003257329
"Steward village, Illinois",128,118,10,17,72624,7.8125
"Jerome village, Illinois",912,898,14,17,38375,1.5350877192982455
"Ridge Farm village, Illinois",455,373,82,17,63862,18.021978021978022
"Belle Rive village, Illinois",143,134,9,17,04806,6.293706293706294
"Tilton village, Illinois",1245,1144,101,17,75276,8.112449799196787
"Kincaid village, Illinois",749,673,76,17,39909,10.14686248331108
"Albion city, Illinois",1001,921,80,17,00568,7.992007992007992
"Nelson village, Illinois",64,58,6,17,51947,9.375
"West Brooklyn village, Illinois",57,53,4,17,80008,7.017543859649122
"Illiopolis village, Illinois",391,328,63,17,37127,16.11253196930946
"Southern View village, Illinois",797,756,41,17,70759,5.144291091593475
"Springfield city, Illinois",56458,50890,5568,17,72000,9.862198448404124
"Virden city, Illinois",1707,1450,257,17,78149,15.055653192735793
"Lanark city, Illinois",717,637,80,17,41859,11.157601115760112
"Milledgeville village, Illinois",545,505,40,17,49191,7.339449541284404
"Kenney village, Illinois",163,147,16,17,39532,9.815950920245399
"Verona village, Illinois",96,90,6,17,77707,6.25
"Charleston city, Illinois",8998,7786,1212,17,12567,13.469659924427651
"Christopher city, Illinois",1366,1135,231,17,14286,16.910688140556367
"Mendota city, Illinois",3038,2683,355,17,48333,11.685319289005925
"Seneca village, Illinois",1052,965,87,17,68640,8.26996197718631
"Teutopolis village, Illinois",726,676,50,17,74743,6.887052341597796
"Burnt Prairie village, Illinois",37,21,16,17,09889,43.24324324324324
"Easton village, Illinois",133,121,12,17,22151,9.022556390977442
"Havana city, Illinois",1474,1385,89,17,33513,6.0379918588873815
"Manito village, Illinois",733,672,61,17,46383,8.321964529331515
"Red Bud city, Illinois",1544,1384,160,17,63043,10.362694300518134
"Steeleville village, Illinois",1022,925,97,17,72468,9.49119373776908
"Anna city, Illinois",2014,1665,349,17,01543,17.328699106256206
"Louisville village, Illinois",562,486,76,17,44927,13.523131672597867
"Sibley village, Illinois",157,139,18,17,69810,11.464968152866243
"Worden village, Illinois",456,433,23,17,83505,5.0438596491228065
"Granite City city, Illinois",14194,12374,1820,17,30926,12.822319289840777
"Hartford village, Illinois",759,632,127,17,33279,16.73254281949934
"Troy city, Illinois",3983,3874,109,17,76199,2.7366306803916647
"Cordova village, Illinois",322,309,13,17,16366,4.037267080745342
"Moline city, Illinois",20097,18254,1843,17,49867,9.170522963626413
"Round Lake Beach village, Illinois",8766,8277,489,17,66040,5.578370978781656
"Round Lake Park village, Illinois",3285,3140,145,17,66066,4.41400304414003
"Vernon Hills village, Illinois",10477,9752,725,17,77694,6.9199198243772075
"South Roxana village, Illinois",937,787,150,17,71240,16.008537886872997
"Oak Grove village, Illinois",310,241,69,17,54703,22.258064516129032
"Reynolds village, Illinois",217,210,7,17,63420,3.225806451612903
"Sparta city, Illinois",2261,1978,283,17,71448,12.516585581601062
"East Cape Girardeau village, Illinois",224,171,53,17,21605,23.660714285714285
"Brownstown village, Illinois",376,326,50,17,08992,13.297872340425531
"Ramsey village, Illinois",468,391,77,17,62627,16.45299145299145
"Buckley village, Illinois",298,255,43,17,09317,14.429530201342283
"Cissna Park village, Illinois",420,366,54,17,14468,12.857142857142856
"Cambria village, Illinois",614,516,98,17,10630,15.960912052117262
"Monticello city, Illinois",2582,2425,157,17,50244,6.0805577072037185
"Kane village, Illinois",174,118,56,17,38869,32.18390804597701
"Rockbridge village, Illinois",89,70,19,17,64811,21.34831460674157
"Otterville town, Illinois",55,49,6,17,56978,10.909090909090908
"Dwight village, Illinois",2031,1807,224,17,21358,11.029049729197439
"Long Point village, Illinois",93,80,13,17,44576,13.978494623655912
"Pontiac city, Illinois",4612,4247,365,17,61015,7.9141370338248045
"Metropolis city, Illinois",3247,2694,553,17,48645,17.031105635971667
"Cutler village, Illinois",181,157,24,17,18225,13.259668508287293
"New Douglas village, Illinois",133,119,14,17,52415,10.526315789473683
"Browning village, Illinois",62,42,20,17,08953,32.25806451612903
"Carbon Hill village, Illinois",128,128,0,17,11176,0.0
"Maryville village, Illinois",3610,3455,155,17,47397,4.293628808864266
"Andalusia village, Illinois",488,469,19,17,01426,3.8934426229508197
"Coyne Center CDP, Illinois",342,342,0,17,17077,0.0
"Colp village, Illinois",153,132,21,17,15807,13.725490196078432
"Chebanse village, Illinois",468,430,38,17,12801,8.11965811965812
"Bellflower village, Illinois",173,154,19,17,04897,10.982658959537572
"Cooksville village, Illinois",88,80,8,17,16210,9.090909090909092
"Bannockburn village, Illinois",270,225,45,17,03610,16.666666666666664
"Buffalo Grove village, Illinois",16064,15580,484,17,09447,3.012948207171315
"Grandwood Park CDP, Illinois",1896,1814,82,17,30900,4.324894514767933
"Lake Catherine CDP, Illinois",785,584,201,17,40988,25.605095541401273
"Hawthorn Woods village, Illinois",2673,2578,95,17,33630,3.554059109614665
"Libertyville village, Illinois",7881,7491,390,17,43250,4.9486105824134
"Third Lake village, Illinois",424,409,15,17,75081,3.5377358490566038
"Mettawa village, Illinois",229,207,22,17,48671,9.606986899563319
"North Chicago city, Illinois",8530,7219,1311,17,53559,15.36928487690504
"Volo village, Illinois",1781,1617,164,17,78227,9.208309938236946
"Waukegan city, Illinois",31590,29077,2513,17,79293,7.955049066160178
"Zion city, Illinois",8740,7820,920,17,84220,10.526315789473683
"Grantfork village, Illinois",138,128,10,17,30978,7.246376811594203
"Livingston village, Illinois",439,384,55,17,44160,12.52847380410023
"Marine village, Illinois",443,401,42,17,46864,9.480812641083523
"Washington city, Illinois",6886,6530,356,17,79033,5.16990996224223
"Algonquin village, Illinois",11465,10790,675,17,00685,5.887483645878762
"Pingree Grove village, Illinois",2824,2639,185,17,59988,6.550991501416431
"St. Charles city, Illinois",13278,12708,570,17,66703,4.292815183009489
"Lakemoor village, Illinois",2458,2177,281,17,41326,11.43205858421481
"Oakwood Hills village, Illinois",821,806,15,17,55041,1.8270401948842874
"Wonder Lake village, Illinois",1717,1658,59,17,82855,3.43622597553873
"Coalton village, Illinois",173,131,42,17,15209,24.277456647398843
"Farmersville village, Illinois",305,269,36,17,25440,11.80327868852459
"Irving village, Illinois",192,142,50,17,37738,26.041666666666668
"Waggoner village, Illinois",93,72,21,17,78383,22.58064516129032
"Olmsted village, Illinois",221,164,57,17,55899,25.791855203619914
"German Valley village, Illinois",238,223,15,17,29093,6.302521008403361
"Lena village, Illinois",1373,1213,160,17,42834,11.653313911143481
"Bay View Gardens village, Illinois",179,176,3,17,04273,1.675977653631285
"Keyesport village, Illinois",251,163,88,17,39753,35.0597609561753
"Winchester city, Illinois",821,696,125,17,82270,15.225334957369064
"Thawville village, Illinois",99,83,16,17,74847,16.161616161616163
"Greenfield city, Illinois",606,491,115,17,31368,18.976897689768975
"Hillview village, Illinois",63,36,27,17,35203,42.857142857142854
"Grafton city, Illinois",498,371,127,17,30653,25.502008032128515
"Flanagan village, Illinois",465,391,74,17,26311,15.913978494623656
"Strawn village, Illinois",41,39,2,17,73131,4.878048780487805
"Kilbourne village, Illinois",168,154,14,17,39857,8.333333333333332
"Brimfield village, Illinois",374,348,26,17,08303,6.951871657754011
"Dunlap village, Illinois",444,410,34,17,21176,7.657657657657657
"Rome CDP, Illinois",759,688,71,17,65403,9.354413702239789
"Oakford village, Illinois",160,150,10,17,54625,6.25
"Pocahontas village, Illinois",331,312,19,17,60872,5.740181268882175
"Sorento village, Illinois",298,230,68,17,70525,22.818791946308725
"Paxton city, Illinois",1922,1773,149,17,58239,7.752341311134235
"Leonore village, Illinois",41,31,10,17,42912,24.390243902439025
"Piper City village, Illinois",434,371,63,17,60079,14.516129032258066
"Clifton village, Illinois",556,515,41,17,14936,7.374100719424461
"Norwood village, Illinois",188,166,22,17,54404,11.702127659574469
"Kinmundy city, Illinois",435,383,52,17,40117,11.954022988505747
"Lebanon city, Illinois",1943,1656,287,17,42496,14.770972722593928
"Northlake city, Illinois",4166,3776,390,17,53871,9.361497839654346
"Bridgeport city, Illinois",1001,826,175,17,08186,17.482517482517483
"Byron city, Illinois",1552,1437,115,17,10240,7.40979381443299
"Berwyn city, Illinois",19788,18225,1563,17,05573,7.898726500909642
"Gilberts village, Illinois",2542,2406,136,17,29171,5.350118017309206
"Davis village, Illinois",239,237,2,17,18706,0.8368200836820083
"Stockton village, Illinois",874,832,42,17,72780,4.805491990846682
"Nebo village, Illinois",144,124,20,17,51882,13.88888888888889
"Knoxville city, Illinois",1192,1111,81,17,40416,6.795302013422819
"Saunemin village, Illinois",158,140,18,17,67795,11.39240506329114
"Country Club Hills city, Illinois",6525,5824,701,17,16691,10.743295019157088
"Hutsonville village, Illinois",233,207,26,17,36841,11.158798283261802
"Sparland village, Illinois",184,164,20,17,71422,10.869565217391305
"Iroquois village, Illinois",94,87,7,17,37712,7.446808510638298
"Joppa village, Illinois",136,110,26,17,38674,19.11764705882353
"Wauconda village, Illinois",5498,5185,313,17,79267,5.692979265187341
"Stonington village, Illinois",433,378,55,17,72949,12.702078521939955
"Capron village, Illinois",484,464,20,17,11124,4.132231404958678
"Alsey village, Illinois",94,72,22,17,00997,23.404255319148938
"New Grand Chain village, Illinois",102,65,37,17,52467,36.27450980392157
"Heyworth village, Illinois",1212,1153,59,17,34449,4.867986798679868
"Ellisville village, Illinois",39,32,7,17,23529,17.94871794871795
"West Point village, Illinois",63,52,11,17,80762,17.46031746031746
"Berlin village, Illinois",94,91,3,17,05443,3.1914893617021276
"St. Peter village, Illinois",179,171,8,17,67132,4.4692737430167595
"Williamson village, Illinois",94,70,24,17,81815,25.53191489361702
"Campus village, Illinois",76,71,5,17,10916,6.578947368421052
"Shabbona village, Illinois",474,439,35,17,68822,7.383966244725738
"Elsah village, Illinois",141,81,60,17,23776,42.5531914893617
"Streator city, Illinois",6161,5459,702,17,73170,11.394254179516313
"Pinckneyville city, Illinois",1556,1423,133,17,59884,8.547557840616966
"Chillicothe city, Illinois",2861,2494,367,17,14117,12.827682628451589
"Peoria city, Illinois",53731,46280,7451,17,59000,13.867227485064488
"Fairview Heights city, Illinois",8004,6957,1047,17,25141,13.08095952023988
"New Athens village, Illinois",932,832,100,17,52116,10.72961373390558
"Albers village, Illinois",443,422,21,17,00555,4.740406320541761
"Aviston village, Illinois",793,779,14,17,03181,1.7654476670870116
"Beckemeyer village, Illinois",456,426,30,17,04533,6.578947368421052
"Riverside village, Illinois",3324,3190,134,17,64421,4.031287605294826
"South Chicago Heights village, Illinois",1667,1481,186,17,70629,11.157768446310738
"Stickney village, Illinois",2477,2260,217,17,72676,8.760597496972142
"Summit village, Illinois",3750,3268,482,17,73638,12.853333333333333
"Simpson village, Illinois",29,20,9,17,70005,31.03448275862069
"Banner village, Illinois",108,100,8,17,03571,7.4074074074074066
"Bryant village, Illinois",138,112,26,17,09161,18.84057971014493
"Lewistown city, Illinois",1162,929,233,17,43055,20.051635111876077
"Liverpool village, Illinois",63,61,2,17,44121,3.1746031746031744
"Lawrenceville city, Illinois",2230,1945,285,17,42405,12.780269058295964
"Hopewell village, Illinois",183,174,9,17,36150,4.918032786885246
"Toluca city, Illinois",693,616,77,17,75653,11.11111111111111
"Eldorado city, Illinois",2082,1812,270,17,23009,12.968299711815561
"Wenona city, Illinois",488,448,40,17,79813,8.19672131147541
"Oregon city, Illinois",1887,1644,243,17,56484,12.87758346581876
"Rochelle city, Illinois",4238,3847,391,17,64746,9.226050023596036
"Du Bois village, Illinois",103,75,28,17,20890,27.184466019417474
"Burnham village, Illinois",1635,1457,178,17,09798,10.886850152905199
"Crestwood village, Illinois",5702,4988,714,17,17497,12.52192213258506
"Golf village, Illinois",165,153,12,17,30328,7.2727272727272725
"Hometown city, Illinois",1861,1718,143,17,35866,7.684040838259
"Palos Park village, Illinois",2076,1972,104,17,57407,5.009633911368015
"Alexis village, Illinois",407,363,44,17,00672,10.81081081081081
"Virginia city, Illinois",627,544,83,17,78201,13.237639553429027
"Lyons village, Illinois",4143,3858,285,17,45434,6.879073135409124
"Indian Head Park village, Illinois",1722,1658,64,17,37257,3.7166085946573753
"La Grange village, Illinois",5662,5306,356,17,40767,6.2875309078064285
"Lynwood village, Illinois",3703,3252,451,17,45421,12.179314069673238
"Midlothian village, Illinois",5908,5385,523,17,48892,8.852403520649966
"Morton Grove village, Illinois",9012,8336,676,17,50647,7.501109631602308
"Mill Shoals village, Illinois",104,90,14,17,49347,13.461538461538462
"Williamsfield village, Illinois",261,218,43,17,81802,16.47509578544061
"Carlinville city, Illinois",2435,2032,403,17,11202,16.550308008213552
"Eagarville village, Illinois",57,54,3,17,21410,5.263157894736842
"Owaneco village, Illinois",111,87,24,17,57043,21.62162162162162
"Henning village, Illinois",106,87,19,17,34137,17.92452830188679
"Allerton village, Illinois",131,114,17,17,00880,12.977099236641221
"Parkersburg village, Illinois",83,78,5,17,57693,6.024096385542169
"Belgium village, Illinois",176,167,9,17,04689,5.113636363636364
"Rankin village, Illinois",243,195,48,17,62744,19.753086419753085
"Toulon city, Illinois",598,500,98,17,75783,16.387959866220736
"Eddyville village, Illinois",66,42,24,17,22398,36.36363636363637
"Bushnell city, Illinois",1333,1120,213,17,10110,15.978994748687173
"Industry village, Illinois",184,163,21,17,37439,11.41304347826087
"Cherry Valley village, Illinois",1336,1272,64,17,13074,4.790419161676647
"Rock Island Arsenal CDP, Illinois",20,3,17,17,65104,85.0
"Morrisonville village, Illinois",527,449,78,17,50543,14.800759013282732
"New Berlin village, Illinois",609,584,25,17,52168,4.105090311986864
"Millington village, Illinois",305,244,61,17,49308,20.0
"Bunker Hill city, Illinois",844,749,95,17,09577,11.255924170616113
"Prospect Heights city, Illinois",6019,5847,172,17,62016,2.8576175444425984
"Buncombe village, Illinois",86,67,19,17,09551,22.093023255813954
"Tennessee village, Illinois",80,61,19,17,74665,23.75
"Mendon village, Illinois",392,355,37,17,48307,9.438775510204081
"Savoy village, Illinois",3707,3523,184,17,67860,4.963582411653628
"Manchester village, Illinois",112,102,10,17,46331,8.928571428571429
"Lisle village, Illinois",10317,9857,460,17,43939,4.458660463312978
"Princeton city, Illinois",3916,3483,433,17,61899,11.05720122574055
"Sugar Grove village, Illinois",3375,3335,40,17,73391,1.1851851851851851
"Belle Prairie City town, Illinois",30,30,0,17,04793,0.0
"Fairbury city, Illinois",1663,1602,61,17,24764,3.668069753457607
"Kingston Mines village, Illinois",137,126,11,17,40091,8.02919708029197
"Sheldon village, Illinois",549,512,37,17,69212,6.739526411657559
"Ivesdale village, Illinois",129,110,19,17,37998,14.728682170542637
"Wyanet village, Illinois",430,382,48,17,83622,11.162790697674419
"Metamora village, Illinois",1612,1485,127,17,48606,7.878411910669975
"Fairmont CDP, Illinois",949,820,129,17,24920,13.593256059009484
"Rock Falls city, Illinois",4107,3669,438,17,64928,10.66471877282688
"Carol Stream village, Illinois",14591,14119,472,17,11332,3.234870810773765
"Humboldt village, Illinois",227,216,11,17,36542,4.845814977973569
"Sherman village, Illinois",1754,1717,37,17,69342,2.1094640820980617
"Plainfield village, Illinois",12757,12521,236,17,60287,1.849964725248883
"Franklin Grove village, Illinois",410,378,32,17,27689,7.804878048780488
"Palmer village, Illinois",98,89,9,17,57303,9.183673469387756
"Cantrall village, Illinois",78,67,11,17,11033,14.102564102564102
"Fairfield city, Illinois",2728,2443,285,17,24816,10.447214076246334
"Beecher City village, Illinois",196,163,33,17,04598,16.83673469387755
"Gulf Port village, Illinois",24,11,13,17,31992,54.166666666666664
"Brocton village, Illinois",173,155,18,17,08524,10.404624277456648
"Hainesville village, Illinois",1354,1334,20,17,32200,1.4771048744460855
"Deer Grove village, Illinois",23,23,0,17,19031,0.0
"Beecher village, Illinois",1809,1679,130,17,04585,7.186290768380321
"Preston Heights CDP, Illinois",951,863,88,17,61860,9.253417455310199
"Enfield village, Illinois",256,224,32,17,24179,12.5
"Hillsboro city, Illinois",1997,1871,126,17,35047,6.309464196294441
"Deer Creek village, Illinois",280,257,23,17,18940,8.214285714285714
"Mark village, Illinois",233,219,14,17,46981,6.008583690987124
"Bardolph village, Illinois",151,117,34,17,03675,22.516556291390728
"South Beloit city, Illinois",3144,2820,324,17,70590,10.305343511450381
"Hamburg village, Illinois",93,29,64,17,32395,68.81720430107528
"St. Johns village, Illinois",138,113,25,17,66924,18.115942028985508
"Belleville city, Illinois",20888,17647,3241,17,04845,15.516085790884718
"Savanna city, Illinois",1704,1411,293,17,67821,17.194835680751176
"Braceville village, Illinois",356,298,58,17,07640,16.292134831460675
"Blue Mound village, Illinois",488,407,81,17,06756,16.598360655737704
"Plano city, Illinois",3669,3641,28,17,60352,0.7631507222676479
"Yorkville city, Illinois",6458,6175,283,17,84038,4.382161659956643
"Harristown village, Illinois",542,498,44,17,33227,8.118081180811808
"Macon city, Illinois",556,473,83,17,45941,14.928057553956833
"Warrensburg village, Illinois",578,534,44,17,78916,7.612456747404845
"Alto Pass village, Illinois",156,123,33,17,01205,21.153846153846153
"Flora city, Illinois",2344,2078,266,17,26454,11.348122866894197
"Andover village, Illinois",232,203,29,17,01491,12.5
"Annawan town, Illinois",448,431,17,17,01569,3.7946428571428568
"Deerfield village, Illinois",7415,7013,402,17,18992,5.421443020903574
"Bethalto village, Illinois",4313,3822,491,17,05599,11.38418734059819
"East Alton village, Illinois",3184,2672,512,17,21553,16.08040201005025
"State Center city, Iowa",610,583,27,19,75135,4.426229508196721
"Mount Auburn village, Illinois",276,240,36,17,50829,13.043478260869565
"Rapids City village, Illinois",403,387,16,17,62822,3.970223325062035
"Alhambra village, Illinois",256,237,19,17,00737,7.421875
"Green Oaks village, Illinois",1193,1161,32,17,31446,2.682313495389774
"Mount Morris village, Illinois",1433,1293,140,17,50998,9.769713886950454
"Harrisburg city, Illinois",4445,3751,694,17,33136,15.61304836895388
"New Minden village, Illinois",105,87,18,17,52714,17.142857142857142
"Wamac city, Illinois",642,467,175,17,78721,27.258566978193144
"Clay City village, Illinois",457,360,97,17,14715,21.2253829321663
"Bingham village, Illinois",49,33,16,17,06028,32.6530612244898
"Alpha village, Illinois",254,231,23,17,00971,9.05511811023622
"Atkinson town, Illinois",484,480,4,17,02726,0.8264462809917356
"Cambridge village, Illinois",933,833,100,17,10643,10.718113612004288
"Woodhull village, Illinois",387,356,31,17,83063,8.010335917312661
"Barrington village, Illinois",4258,3868,390,17,03844,9.159229685298262
"Mahomet village, Illinois",3081,2940,141,17,46136,4.576436222005842
"Oak Brook village, Illinois",3405,3154,251,17,54534,7.371512481644641
"Sadorus village, Illinois",155,144,11,17,66534,7.096774193548387
"Burr Ridge village, Illinois",4489,4299,190,17,09980,4.232568500779683
"Downers Grove village, Illinois",21241,20268,973,17,20591,4.580763617532131
"McCook village, Illinois",108,96,12,17,45564,11.11111111111111
"Mount Prospect village, Illinois",21798,20665,1133,17,51089,5.197724561886412
"Oak Forest city, Illinois",10517,10223,294,17,54638,2.7954739944851195
"Olympia Fields village, Illinois",2241,1983,258,17,55938,11.512717536813923
"Palos Heights city, Illinois",4928,4710,218,17,57381,4.423701298701299
"South Barrington village, Illinois",1492,1467,25,17,70564,1.675603217158177
"Western Springs village, Illinois",4586,4401,185,17,80242,4.0340165721761885
"Willow Springs village, Illinois",2223,2091,132,17,82049,5.937921727395412
"Hindsboro village, Illinois",219,170,49,17,35281,22.37442922374429
"Rockford city, Illinois",66668,59403,7265,17,65000,10.897282054358913
"Bradford village, Illinois",338,281,57,17,07692,16.86390532544379
"Valmeyer village, Illinois",493,475,18,17,77265,3.6511156186612577
"Pecatonica village, Illinois",1042,944,98,17,58408,9.404990403071018
"Bondville village, Illinois",221,199,22,17,07211,9.95475113122172
"Ogden village, Illinois",360,315,45,17,55275,12.5
"Philo village, Illinois",563,526,37,17,59533,6.571936056838366
"St. Joseph village, Illinois",1672,1672,0,17,66950,0.0
"Thomasboro village, Illinois",537,485,52,17,75107,9.683426443202979
"East Brooklyn village, Illinois",53,39,14,17,21579,26.41509433962264
"Georgetown city, Illinois",1668,1448,220,17,28963,13.189448441247004
"Sidell village, Illinois",184,163,21,17,69836,11.41304347826087
"Westville village, Illinois",1289,1256,33,17,80931,2.560124127230411
"Kinsman village, Illinois",63,49,14,17,40143,22.22222222222222
"Crystal Lake city, Illinois",15506,14701,805,17,17887,5.191538759189991
"Lakewood village, Illinois",1330,1274,56,17,41651,4.2105263157894735
"Fillmore village, Illinois",149,125,24,17,26077,16.10738255033557
"Raymond village, Illinois",410,358,52,17,62965,12.682926829268293
"Karnak village, Illinois",237,170,67,17,39077,28.270042194092827
"Freeport city, Illinois",12289,10969,1320,17,27884,10.741313369680201
"Germantown Hills village, Illinois",1281,1265,16,17,29080,1.249024199843872
"Stewardson village, Illinois",364,316,48,17,72650,13.186813186813188
"Strasburg village, Illinois",240,214,26,17,73040,10.833333333333334
"Lakewood Shores CDP, Illinois",633,577,56,17,41716,8.846761453396525
"Minooka village, Illinois",3699,3515,184,17,49607,4.974317383076507
"Orland Park village, Illinois",23202,22307,895,17,56640,3.8574260839582792
"Rockdale village, Illinois",801,729,72,17,64902,8.98876404494382
"Symerton village, Illinois",34,34,0,17,74275,0.0
"Tinley Park village, Illinois",22385,21351,1034,17,75484,4.61916461916462
"Wilmington city, Illinois",2393,2289,104,17,82101,4.346009193480986
"McHenry city, Illinois",10669,10192,477,17,45694,4.470896991283157
"Lake Bluff village, Illinois",2071,1988,83,17,40910,4.007725736359246
"Lake Villa village, Illinois",3049,2915,134,17,41586,4.394883568383076
"Lincolnshire village, Illinois",3269,3097,172,17,43666,5.261547873967574
"Lindenhurst village, Illinois",5300,5145,155,17,43770,2.9245283018867925
"Oakland city, Illinois",505,464,41,17,54781,8.118811881188119
"Orient city, Illinois",222,202,20,17,56536,9.00900900900901
"Royalton village, Illinois",578,501,77,17,66209,13.321799307958477
"Ava city, Illinois",336,275,61,17,03103,18.154761904761905
"Elkville village, Illinois",402,348,54,17,23373,13.432835820895523
"Dana village, Illinois",60,45,15,17,18485,25.0
"Kangley village, Illinois",130,93,37,17,38921,28.46153846153846
"Alma village, Illinois",160,146,14,17,00919,8.75
"Marissa village, Illinois",885,708,177,17,46955,20.0
"Sullivan city, Illinois",2155,1939,216,17,73495,10.023201856148493
"Brooklyn village, Illinois",288,213,75,17,08667,26.041666666666668
"Madison city, Illinois",2093,1626,467,17,45993,22.312470138557096
"Chester city, Illinois",2355,1980,375,17,13139,15.92356687898089
"Hinckley village, Illinois",870,816,54,17,35268,6.206896551724138
"Boulder Hill CDP, Illinois",3144,3022,122,17,07419,3.880407124681934
"Niantic village, Illinois",252,215,37,17,52961,14.682539682539684
"Evansville village, Illinois",317,273,44,17,24608,13.880126182965299
"Ruma village, Illinois",124,110,14,17,66287,11.29032258064516
"Tamms village, Illinois",295,234,61,17,74457,20.677966101694913
"Hooppole village, Illinois",92,77,15,17,36074,16.304347826086957
"Kewanee city, Illinois",5862,5006,856,17,39727,14.602524735585124
"Antioch village, Illinois",5451,5035,416,17,01595,7.631627224362503
"Arlington Heights village, Illinois",32563,31070,1493,17,02154,4.584958388354881
"Channel Lake CDP, Illinois",869,602,267,17,12489,30.724971231300348
"Deer Park village, Illinois",1356,1229,127,17,19083,9.365781710914455
"Long Lake CDP, Illinois",1447,1123,324,17,44550,22.39115411195577
"Smithboro village, Illinois",73,72,1,17,70213,1.36986301369863
"Breese city, Illinois",1957,1904,53,17,07913,2.708226877874297
"Westfield village, Illinois",332,298,34,17,80281,10.240963855421686
"Altamont city, Illinois",1023,936,87,17,01049,8.504398826979472
"Lisbon village, Illinois",133,126,7,17,43900,5.263157894736842
"Montgomery village, Illinois",6212,5970,242,17,50218,3.895685769478429
"Amboy city, Illinois",1066,996,70,17,01270,6.566604127579738
"Ina village, Illinois",207,169,38,17,37179,18.357487922705314
"Waltonville village, Illinois",188,179,9,17,78708,4.787234042553192
"Woodlawn village, Illinois",245,228,17,17,83206,6.938775510204081
"Ashton village, Illinois",462,438,24,17,02583,5.194805194805195
"Princeville village, Illinois",790,716,74,17,61925,9.367088607594937
"Decatur city, Illinois",36319,31062,5257,17,18823,14.474517470194664
"Oreana village, Illinois",326,298,28,17,56471,8.588957055214724
"Hanna City village, Illinois",631,585,46,17,32668,7.290015847860539
"Naplate village, Illinois",259,228,31,17,51648,11.96911196911197
"Auburn city, Illinois",1876,1748,128,17,02921,6.823027718550106
"Dawson village, Illinois",301,279,22,17,18745,7.308970099667775
"Mechanicsburg village, Illinois",291,266,25,17,48021,8.59106529209622
"Ottawa city, Illinois",8823,7893,930,17,56926,10.540632437946277
"Basco village, Illinois",50,37,13,17,04052,26.0
"Bismarck village, Illinois",250,229,21,17,06184,8.4
"Gillespie city, Illinois",1615,1331,284,17,29236,17.58513931888545
"Nilwood town, Illinois",105,97,8,17,53039,7.6190476190476195
"Palmyra village, Illinois",309,289,20,17,57329,6.472491909385113
"Harwood Heights village, Illinois",3895,3538,357,17,33435,9.165596919127086
"Chicago Heights city, Illinois",11817,10037,1780,17,14026,15.063044766015063
"Chicago Ridge village, Illinois",5560,5159,401,17,14065,7.212230215827338
"Elmwood Park village, Illinois",9871,9232,639,17,23724,6.473508256508966
"Homewood village, Illinois",7872,7604,268,17,35879,3.404471544715447
"Roseville village, Illinois",466,388,78,17,65845,16.738197424892704
"Spring Grove village, Illinois",2002,2002,0,17,72052,0.0
"Woodstock city, Illinois",10123,9485,638,17,83349,6.302479502123877
"Witt city, Illinois",424,366,58,17,82725,13.679245283018867
"Mound City city, Illinois",305,258,47,17,50751,15.40983606557377
"Mounds city, Illinois",498,373,125,17,50777,25.100401606425706
"Pulaski village, Illinois",119,82,37,17,62211,31.092436974789916
"Benson village, Illinois",223,210,13,17,05261,5.829596412556054
"Dixon city, Illinois",6127,5626,501,17,20162,8.176921821446058
"Orangeville village, Illinois",414,378,36,17,56341,8.695652173913043
"Winslow village, Illinois",151,126,25,17,82543,16.55629139072848
"Compton village, Illinois",133,121,12,17,15989,9.022556390977442
"Divernon village, Illinois",557,504,53,17,20045,9.515260323159785
"Keenes village, Illinois",41,33,8,17,39233,19.51219512195122
"Mount Erie village, Illinois",41,36,5,17,50933,12.195121951219512
"Leland Grove city, Illinois",733,702,31,17,42769,4.229195088676671
"Prairie City village, Illinois",152,134,18,17,61548,11.842105263157894
"La Fayette village, Illinois",94,89,5,17,40676,5.319148936170213
"Apple River village, Illinois",213,167,46,17,01673,21.5962441314554
"Hanover village, Illinois",461,354,107,17,32707,23.210412147505423
"Findlay village, Illinois",380,335,45,17,26116,11.842105263157894
"Florence village, Illinois",34,29,5,17,26480,14.705882352941178
"New Canton town, Illinois",180,159,21,17,52311,11.666666666666666
"Arlington village, Illinois",92,83,9,17,02102,9.782608695652174
"La Moille village, Illinois",326,287,39,17,41794,11.96319018404908
"Manlius village, Illinois",173,154,19,17,46422,10.982658959537572
"Neponset village, Illinois",249,205,44,17,51999,17.670682730923694
"Jewett village, Illinois",112,104,8,17,38427,7.142857142857142
"Old Shawneetown village, Illinois",65,49,16,17,55756,24.615384615384617
"Omaha village, Illinois",126,117,9,17,56003,7.142857142857142
"Clayton village, Illinois",365,305,60,17,14767,16.43835616438356
"Coatsburg village, Illinois",76,70,6,17,15261,7.894736842105263
"Norris village, Illinois",83,66,17,17,53390,20.481927710843372
"Carrier Mills village, Illinois",863,755,108,17,11397,12.514484356894554
"Bridgeview village, Illinois",5900,5535,365,17,08225,6.186440677966102
"Glenview village, Illinois",18435,17482,953,17,29938,5.169514510442093
"Chatsworth town, Illinois",560,475,85,17,12710,15.178571428571427
"Allendale village, Illinois",252,238,14,17,00815,5.555555555555555
"Greenup village, Illinois",742,689,53,17,31524,7.142857142857142
"Potomac village, Illinois",323,300,23,17,61366,7.120743034055728
"Sauk Village village, Illinois",4105,3336,769,17,67769,18.733252131546895
"Galesburg city, Illinois",14298,12568,1730,17,28326,12.09959434885998
"Brighton village, Illinois",961,869,92,17,08264,9.573361082206034
"Kaskaskia village, Illinois",11,4,7,17,39129,63.63636363636363
"Ransom village, Illinois",155,151,4,17,62757,2.5806451612903225
"Topeka village, Illinois",61,47,14,17,75757,22.950819672131146
"Bluffs village, Illinois",314,273,41,17,06899,13.05732484076433
"Abingdon city, Illinois",1420,1319,101,17,00113,7.112676056338028
"Catlin village, Illinois",949,889,60,17,11774,6.322444678609063
"Table Grove village, Illinois",205,183,22,17,74301,10.731707317073171
"Winnebago village, Illinois",1310,1284,26,17,82491,1.984732824427481
"Creston village, Illinois",312,281,31,17,17471,9.935897435897436
"Ripley village, Illinois",36,30,6,17,64174,16.666666666666664
"Addieville village, Illinois",144,123,21,17,00230,14.583333333333334
"Dixmoor village, Illinois",1522,1221,301,17,20149,19.776609724047304
"Oakwood village, Illinois",748,696,52,17,55002,6.951871657754011
"Sleepy Hollow village, Illinois",1231,1218,13,17,70161,1.0560519902518277
"Schram City village, Illinois",379,304,75,17,68120,19.788918205804748
"Tower Hill village, Illinois",295,252,43,17,75848,14.576271186440678
"Winthrop Harbor village, Illinois",2870,2610,260,17,82686,9.059233449477352
"Villa Grove city, Illinois",1076,931,145,17,77941,13.475836431226766
"Rockton village, Illinois",3110,2927,183,17,65156,5.884244372990353
"Flat Rock village, Illinois",187,159,28,17,26350,14.973262032085561
"Stoy village, Illinois",52,41,11,17,73027,21.153846153846153
"Orland Hills village, Illinois",2457,2363,94,17,56627,3.825803825803826
"Wheeler village, Illinois",69,59,10,17,81074,14.492753623188406
"La Rose village, Illinois",75,60,15,17,42171,20.0
"Northbrook village, Illinois",13878,12945,933,17,53481,6.722870730652832
"Sesser city, Illinois",899,737,162,17,68705,18.020022246941046
"Ferris village, Illinois",60,49,11,17,25895,18.333333333333332
"Belvidere city, Illinois",9679,8992,687,17,05092,7.097840686021282
"Poplar Grove village, Illinois",1448,1419,29,17,61145,2.0027624309392267
"De Soto village, Illinois",744,630,114,17,19616,15.32258064516129
"Makanda village, Illinois",259,222,37,17,46214,14.285714285714285
"Lee village, Illinois",141,127,14,17,42587,9.929078014184398
"Sublette village, Illinois",245,211,34,17,73287,13.877551020408163
"Buffalo village, Illinois",251,234,17,17,09434,6.772908366533864
"Chatham village, Illinois",5054,4772,282,17,12684,5.5797388207360505
"Rochester village, Illinois",1437,1405,32,17,64759,2.2268615170494086
"Cisne village, Illinois",308,273,35,17,14455,11.363636363636363
"Cedar Point village, Illinois",139,127,12,17,11982,8.633093525179856
"Lostant village, Illinois",196,180,16,17,44823,8.16326530612245
"Central City village, Illinois",653,525,128,17,12151,19.60183767228178
"Sandoval village, Illinois",587,513,74,17,67444,12.60647359454855
"Sims village, Illinois",91,58,33,17,70031,36.26373626373626
"Oneida city, Illinois",325,287,38,17,56159,11.692307692307692
"Girard city, Illinois",892,744,148,17,29392,16.591928251121075
"Mount Clare village, Illinois",160,137,23,17,50920,14.374999999999998
"Shipman town, Illinois",259,243,16,17,69563,6.177606177606178
"Wilmette village, Illinois",10328,9643,685,17,82075,6.632455460883037
"Palatine village, Illinois",28362,26881,1481,17,57225,5.221775615259855
"Rosemont village, Illinois",1836,1604,232,17,65819,12.636165577342048
"South Holland village, Illinois",7790,7219,571,17,70850,7.329910141206675
"Cherry village, Illinois",205,190,15,17,12970,7.317073170731707
"De Pue village, Illinois",676,571,105,17,19499,15.532544378698224
"Mineral village, Illinois",110,106,4,17,49516,3.6363636363636362
"Harvey city, Illinois",11531,8743,2788,17,33383,24.178301968606366
"Justice village, Illinois",5409,4740,669,17,38830,12.368275097060454
"Kenilworth village, Illinois",853,794,59,17,39519,6.916764361078546
"Lincolnwood village, Illinois",4543,4260,283,17,43744,6.2293638564825
"Maeystown village, Illinois",60,44,16,17,46058,26.666666666666668
"Waterloo city, Illinois",4373,4271,102,17,79150,2.3324948547907614
"Wyoming city, Illinois",700,596,104,17,83687,14.857142857142858
"Lake Summerset CDP, Illinois",1459,875,584,17,41456,40.027416038382455
"Roscoe village, Illinois",3847,3693,154,17,65611,4.003119313750974
"Avon village, Illinois",386,325,61,17,03207,15.803108808290157
"Farmington city, Illinois",1191,992,199,17,25531,16.70864819479429
"Lacon city, Illinois",886,738,148,17,40559,16.70428893905192
"Adeline village, Illinois",52,48,4,17,00295,7.6923076923076925
"Stillman Valley village, Illinois",458,425,33,17,72702,7.20524017467249
"Galatia village, Illinois",451,358,93,17,28261,20.620842572062084
"Hoyleton village, Illinois",210,199,11,17,36347,5.238095238095238
"Kirkwood village, Illinois",319,288,31,17,40182,9.717868338557993
"Oblong village, Illinois",697,621,76,17,55106,10.9038737446198
"Canton city, Illinois",5794,5104,690,17,11007,11.908871246116673
"Dunfermline village, Illinois",164,145,19,17,21098,11.585365853658537
"Ipava village, Illinois",240,225,15,17,37647,6.25
"Rose Hill village, Illinois",45,33,12,17,65754,26.666666666666668
"Russellville village, Illinois",80,64,16,17,66404,20.0
"Forreston village, Illinois",722,668,54,17,27065,7.479224376731302
"East Moline city, Illinois",8936,8285,651,17,22073,7.285138764547897
"Muddy village, Illinois",20,20,0,17,51271,0.0
"Ashley city, Illinois",301,240,61,17,02531,20.26578073089701
"Knox city, Indiana",1778,1408,370,18,40374,20.80989876265467
"Tilden village, Illinois",443,364,79,17,75263,17.83295711060948
"Riverdale village, Illinois",6003,4913,1090,17,64278,18.157587872730304
"South Wilmington village, Illinois",403,372,31,17,71370,7.6923076923076925
"Du Quoin city, Illinois",3128,2663,465,17,21267,14.865728900255753
"Hecker village, Illinois",211,204,7,17,33877,3.3175355450236967
"Arenzville village, Illinois",194,181,13,17,01946,6.701030927835052
"Bellwood village, Illinois",6848,6240,608,17,04975,8.878504672897195
"Carbondale city, Illinois",13110,10162,2948,17,11163,22.48665141113654
"Walnut Hill village, Illinois",63,53,10,17,78604,15.873015873015872
"O'Fallon city, Illinois",11458,10804,654,17,55249,5.707802408797347
"Fults village, Illinois",8,8,0,17,28170,0.0
"Darien city, Illinois",9278,8933,345,17,18628,3.7184738090105625
"Lake Zurich village, Illinois",6961,6658,303,17,41742,4.352822870277259
"Lomax village, Illinois",219,179,40,17,44381,18.2648401826484
"Percy village, Illinois",444,344,100,17,59104,22.52252252252252
"Orion village, Illinois",862,827,35,17,56601,4.060324825986079
"Calumet Park village, Illinois",3738,3303,435,17,10513,11.637239165329053
"East Hazel Crest village, Illinois",704,642,62,17,21904,8.806818181818182
"Evanston city, Illinois",31716,28524,3192,17,24582,10.064320847521756
"Evergreen Park village, Illinois",7298,6998,300,17,24634,4.110715264456015
"Forest Park village, Illinois",7574,7115,459,17,26935,6.060205967784526
"Hillside village, Illinois",3220,2953,267,17,35086,8.29192546583851
"Hodgkins village, Illinois",733,688,45,17,35385,6.139154160982264
"Lansing village, Illinois",12222,11127,1095,17,42028,8.95925380461463
"La Grange Park village, Illinois",5391,5094,297,17,40793,5.509181969949917
"Maywood village, Illinois",8935,7690,1245,17,47774,13.933967543368775
"Norridge village, Illinois",5691,5362,329,17,53377,5.781057810578106
"Northfield village, Illinois",2535,2323,212,17,53663,8.362919132149901
"North Riverside village, Illinois",2713,2657,56,17,54144,2.0641356431994105
"River Forest village, Illinois",4291,3965,326,17,64304,7.597296667443485
"Rolling Meadows city, Illinois",9263,8847,416,17,65338,4.490985641800712
"Skokie village, Illinois",24118,22446,1672,17,70122,6.932581474417447
"Streamwood village, Illinois",13755,13193,562,17,73157,4.085786986550345
"Winnetka village, Illinois",4483,4134,349,17,82530,7.784965424938657
"Golconda city, Illinois",427,291,136,17,30133,31.85011709601874
"Camargo village, Illinois",232,214,18,17,10591,7.758620689655173
"Belknap village, Illinois",74,45,29,17,04715,39.189189189189186
"Vienna city, Illinois",808,666,142,17,77863,17.574257425742573
"Blandinsville village, Illinois",344,290,54,17,06470,15.69767441860465
"Sciota village, Illinois",40,33,7,17,68198,17.5
"Loves Park city, Illinois",10652,9799,853,17,45031,8.007885843034172
"Prophetstown city, Illinois",950,847,103,17,61977,10.842105263157894
"La Prairie village, Illinois",44,30,14,17,42080,31.818181818181817
"Little York village, Illinois",155,137,18,17,44082,11.612903225806452
"Kingston village, Illinois",441,406,35,17,40065,7.936507936507936
"Shorewood village, Illinois",5954,5816,138,17,69758,2.317769566677864
"Cisco village, Illinois",115,115,0,17,14442,0.0
"Hammond village, Illinois",266,206,60,17,32499,22.55639097744361
"Brussels village, Illinois",92,49,43,17,09148,46.73913043478261
"Hardin village, Illinois",474,275,199,17,32850,41.983122362869196
"Cullom village, Illinois",349,267,82,17,18030,23.49570200573066
"Brookport city, Illinois",534,460,74,17,08706,13.857677902621724
"Chadwick village, Illinois",285,268,17,17,12294,5.964912280701754
"Tamaroa village, Illinois",333,286,47,17,74444,14.114114114114114
"Littleton village, Illinois",68,63,5,17,44056,7.352941176470589
"Rushville city, Illinois",1656,1392,264,17,66339,15.942028985507244
"Xenia village, Illinois",188,158,30,17,83739,15.957446808510639
"Bluford village, Illinois",288,249,39,17,06964,13.541666666666666
"Dix village, Illinois",235,202,33,17,20123,14.042553191489363
"Rio village, Illinois",97,75,22,17,64148,22.68041237113402
"North Judson town, Indiana",875,766,109,18,54900,12.457142857142857
"Moores Hill town, Indiana",285,249,36,18,50958,12.631578947368421
"Campbellsburg town, Indiana",239,216,23,18,10000,9.623430962343097
"Little York town, Indiana",82,73,9,18,44370,10.975609756097562
"Livonia town, Indiana",43,32,11,18,44424,25.581395348837212
"Harmony town, Indiana",367,355,12,18,31486,3.2697547683923704
"Roanoke town, Indiana",870,754,116,18,65016,13.333333333333334
"Lagrange town, Indiana",1196,1107,89,18,40860,7.441471571906355
"Topeka town, Indiana",408,362,46,18,76184,11.27450980392157
"Knightsville town, Indiana",337,276,61,18,40302,18.100890207715135
"Staunton town, Indiana",212,175,37,18,72782,17.452830188679243
"Laurel town, Indiana",265,224,41,18,42372,15.471698113207546
"Clayton town, Indiana",393,362,31,18,13366,7.888040712468193
"Claypool town, Indiana",204,187,17,18,13312,8.333333333333332
"Cannelton city, Indiana",882,717,165,18,10108,18.70748299319728
"Cynthiana town, Indiana",295,265,30,18,16534,10.16949152542373
"Hartford City city, Indiana",2874,2549,325,18,32242,11.308281141266527
"Dunlap CDP, Indiana",2118,2076,42,18,19072,1.9830028328611897
"La Porte city, Indiana",10318,9214,1104,18,42246,10.699748013180848
"Long Beach town, Indiana",1012,554,458,18,44784,45.25691699604743
"Indianapolis city (balance), Indiana",384955,335373,49582,18,36003,12.879947006793003
"Spring Hill town, Indiana",52,48,4,18,72232,7.6923076923076925
"Alton town, Indiana",52,15,37,18,01270,71.15384615384616
"English town, Indiana",305,282,23,18,21214,7.540983606557377
"Clifford town, Indiana",112,87,25,18,13582,22.321428571428573
"Hartsville town, Indiana",175,153,22,18,32332,12.571428571428573
"Altona town, Indiana",118,104,14,18,01288,11.864406779661017
"Garrett city, Indiana",2838,2731,107,18,26386,3.770260747004933
"Waterloo town, Indiana",867,842,25,18,81278,2.883506343713956
"Dupont town, Indiana",154,118,36,18,19180,23.376623376623375
"New Carlisle town, Indiana",752,681,71,18,52704,9.441489361702128
"South Bend city, Indiana",46660,38601,8059,18,71000,17.2717531075868
"Yorktown town, Indiana",4805,4436,369,18,86084,7.679500520291363
"Andrews town, Indiana",523,442,81,18,01612,15.487571701720842
"Michigantown town, Indiana",214,190,24,18,48816,11.214953271028037
"Bloomingdale town, Indiana",125,116,9,18,05788,7.199999999999999
"Patriot town, Indiana",164,131,33,18,58392,20.121951219512198
"Kirklin town, Indiana",358,309,49,18,39942,13.687150837988826
"Dunkirk city, Indiana",1174,924,250,18,19054,21.29471890971039
"Dale town, Indiana",684,586,98,18,16624,14.327485380116958
"Bloomington city, Indiana",33953,30897,3056,18,05860,9.0006774070038
"Mulberry town, Indiana",467,443,24,18,51840,5.139186295503212
"Rossville town, Indiana",699,632,67,18,66150,9.585121602288984
"Hope town, Indiana",950,865,85,18,34744,8.947368421052632
"Jonesville town, Indiana",82,82,0,18,38916,0.0
"Sandborn town, Indiana",226,186,40,18,67698,17.699115044247787
"Griffith town, Indiana",7050,6620,430,18,30042,6.0992907801418434
"Culver town, Indiana",942,535,407,18,16300,43.20594479830149
"Macy town, Indiana",85,66,19,18,45864,22.35294117647059
"Mexico CDP, Indiana",362,362,0,18,48636,0.0
"Winslow town, Indiana",435,343,92,18,84968,21.149425287356323
"Warsaw city, Indiana",6551,6029,522,18,80306,7.968249122271409
"Wheatland town, Indiana",226,198,28,18,83564,12.389380530973451
"Tell City city, Indiana",3421,3095,326,18,75248,9.529377375036539
"Mount Vernon city, Indiana",3209,2733,476,18,51732,14.833281396073545
"Vernon town, Indiana",215,175,40,18,78902,18.6046511627907
"Flora town, Indiana",966,800,166,18,23692,17.184265010351968
"North Vernon city, Indiana",3002,2640,362,18,55116,12.058627581612258
"Lebanon city, Indiana",7391,6783,608,18,42624,8.226221079691516
"Thorntown town, Indiana",668,589,79,18,75626,11.826347305389222
"Ulen town, Indiana",84,76,8,18,77066,9.523809523809524
"Argos town, Indiana",754,664,90,18,02044,11.936339522546419
"Victoria village, Illinois",133,128,5,17,77811,3.7593984962406015
"Wataga village, Illinois",396,356,40,17,79124,10.1010101010101
"Emington village, Illinois",58,48,10,17,24062,17.24137931034483
"South Pekin village, Illinois",374,374,0,17,71175,0.0
"Champaign city, Illinois",38347,34463,3884,17,12385,10.12856286019767
"Foosland village, Illinois",44,38,6,17,26662,13.636363636363635
"Delavan city, Illinois",780,691,89,17,19226,11.41025641025641
"Green Valley village, Illinois",318,293,25,17,31563,7.861635220125786
"North Pekin village, Illinois",609,562,47,17,54092,7.717569786535304
"Bureau Junction village, Illinois",122,76,46,17,09681,37.704918032786885
"Junction village, Illinois",48,35,13,17,38778,27.083333333333332
"Shawneetown city, Illinois",627,536,91,17,69082,14.513556618819775
"Hartsburg village, Illinois",147,134,13,17,33318,8.843537414965986
"Latham village, Illinois",214,191,23,17,42249,10.74766355140187
"Aledo city, Illinois",1751,1559,192,17,00646,10.96516276413478
"Oakbrook Terrace city, Illinois",1393,1260,133,17,54560,9.547738693467336
"Villa Park village, Illinois",8459,8101,358,17,77993,4.232178744532451
"Buckingham village, Illinois",98,79,19,17,09304,19.387755102040817
"Cave-In-Rock village, Illinois",157,75,82,17,11826,52.22929936305732
"East Dubuque city, Illinois",828,731,97,17,21683,11.71497584541063
"Elizabeth village, Illinois",478,425,53,17,23165,11.08786610878661
"Atlanta city, Illinois",813,758,55,17,02752,6.765067650676507
"Lincoln city, Illinois",6398,5714,684,17,43536,10.69084088777743
"El Dara village, Illinois",42,34,8,17,22957,19.047619047619047
"Dover village, Illinois",63,51,12,17,20526,19.047619047619047
"Malden village, Illinois",145,127,18,17,46240,12.413793103448276
"Tiskilwa village, Illinois",356,336,20,17,75549,5.617977528089887
"Elizabethtown village, Illinois",191,117,74,17,23191,38.7434554973822
"Hopkins Park village, Illinois",269,179,90,17,36190,33.457249070631974
"Arrowsmith village, Illinois",116,107,9,17,02342,7.758620689655173
"St. Anne village, Illinois",573,495,78,17,66638,13.612565445026178
"Carlock village, Illinois",197,183,14,17,11215,7.1065989847715745
"Danvers village, Illinois",424,421,3,17,18537,0.7075471698113208
"Thompsonville village, Illinois",252,220,32,17,75159,12.698412698412698
"Mattoon city, Illinois",8422,7678,744,17,47553,8.83400617430539
"Buckner village, Illinois",236,195,41,17,09330,17.372881355932204
"Ewing village, Illinois",151,122,29,17,24673,19.205298013245034
"Valier village, Illinois",278,236,42,17,77148,15.107913669064748
"Gorham village, Illinois",98,72,26,17,30588,26.53061224489796
"Leland village, Illinois",412,336,76,17,42756,18.446601941747574
"North Utica village, Illinois",641,560,81,17,54222,12.636505460218409
"Oglesby city, Illinois",1846,1568,278,17,55353,15.059588299024917
"Peru city, Illinois",5005,4347,658,17,59234,13.146853146853147
"Cleveland village, Illinois",103,103,0,17,14923,0.0
"Wood Dale city, Illinois",5481,5059,422,17,82985,7.699324940704251
"Barrington Hills village, Illinois",1749,1441,308,17,03883,17.61006289308176
"Virgil village, Illinois",142,127,15,17,78175,10.56338028169014
"Mackinaw village, Illinois",815,769,46,17,45785,5.644171779141105
"Morton village, Illinois",7418,7051,367,17,50621,4.947425181989755
"West Dundee village, Illinois",3277,3156,121,17,80125,3.6924015868172106
"Harvard city, Illinois",3282,2952,330,17,33331,10.054844606946983
"Huntley village, Illinois",11712,10992,720,17,36750,6.147540983606557
"Lake in the Hills village, Illinois",9766,9601,165,17,41183,1.689535121851321
"Pistakee Highlands CDP, Illinois",1365,1299,66,17,60144,4.835164835164836
"Richmond village, Illinois",889,776,113,17,63641,12.710911136107987
"Menominee village, Illinois",92,86,6,17,48359,6.521739130434782
"New Holland village, Illinois",139,116,23,17,52545,16.546762589928058
"Keithsburg city, Illinois",318,269,49,17,39298,15.40880503144654
"Time village, Illinois",7,7,0,17,75419,0.0
"Valley City village, Illinois",15,4,11,17,77187,73.33333333333333
"Plymouth city, Indiana",4456,3839,617,18,60822,13.846499102333931
"Bunker Hill town, Indiana",277,217,60,18,09136,21.660649819494584
"Versailles town, Indiana",952,810,142,18,78974,14.915966386554622
"Wheatfield town, Indiana",392,350,42,18,83528,10.714285714285714
"Washington city, Indiana",5322,4643,679,18,80504,12.75836151822623
"Huntingburg city, Indiana",2572,2456,116,18,35284,4.5101088646967336
"Gaston town, Indiana",419,339,80,18,27072,19.09307875894988
"Selma town, Indiana",403,343,60,18,68706,14.888337468982629
"Fulton town, Indiana",162,135,27,18,26152,16.666666666666664
"Markle town, Indiana",570,536,34,18,47160,5.964912280701754
"Poneto town, Indiana",72,68,4,18,61020,5.555555555555555
"Kempton town, Indiana",192,150,42,18,39366,21.875
"Ambia town, Indiana",99,72,27,18,01342,27.27272727272727
"Franklin city, Indiana",9993,9234,759,18,25450,7.595316721705194
"New Whiteland town, Indiana",2210,2210,0,18,53874,0.0
"Summitville town, Indiana",411,348,63,18,74132,15.328467153284672
"Rockport city, Indiana",1089,946,143,18,65484,13.131313131313133
"Santa Claus town, Indiana",1056,945,111,18,68022,10.511363636363637
"Battle Ground town, Indiana",611,578,33,18,03718,5.400981996726677
"Otterbein town, Indiana",527,439,88,18,57258,16.698292220113853
"Elberfeld town, Indiana",300,281,19,18,20638,6.333333333333334
"Linton city, Indiana",2670,2298,372,18,44190,13.93258426966292
"Newberry town, Indiana",121,74,47,18,52524,38.84297520661157
"Medaryville town, Indiana",272,241,31,18,48186,11.397058823529411
"Star City CDP, Indiana",119,119,0,18,72638,0.0
"Palmyra town, Indiana",662,609,53,18,57726,8.006042296072508
"Waveland town, Indiana",179,161,18,18,81458,10.05586592178771
"Vevay town, Indiana",840,715,125,18,79010,14.880952380952381
"Wabash city, Indiana",5037,4548,489,18,79370,9.708159618820726
"Francisco town, Indiana",274,235,39,18,25306,14.233576642335766
"Sunman town, Indiana",504,429,75,18,74168,14.880952380952381
"Ashley town, Indiana",506,437,69,18,02458,13.636363636363635
"Clear Lake town, Indiana",649,215,434,18,13438,66.87211093990754
"Boston town, Indiana",78,71,7,18,06652,8.974358974358974
"Merrillville town, Indiana",14989,13884,1105,18,48528,7.372072853425846
"North Terre Haute CDP, Indiana",2054,1812,242,18,55098,11.781888997078871
"Seelyville town, Indiana",389,326,63,18,68652,16.195372750642672
"Greens Fork town, Indiana",199,175,24,18,29754,12.060301507537687
"Zionsville town, Indiana",10067,9346,721,18,86372,7.162014502831032
"Goshen city, Indiana",13068,12295,773,18,28386,5.915212733394552
"Wakarusa town, Indiana",677,645,32,18,79478,4.726735598227474
"Trail Creek town, Indiana",992,883,109,18,76328,10.987903225806452
"Corydon town, Indiana",1640,1294,346,18,15256,21.097560975609756
"Amboy town, Indiana",168,145,23,18,01360,13.690476190476192
"Monticello city, Indiana",2347,2130,217,18,50760,9.245845760545377
"Greenville town, Indiana",290,261,29,18,29844,10.0
"Crawfordsville city, Indiana",7292,6595,697,18,15742,9.55842018650576
"Wolcottville town, Indiana",430,359,71,18,85076,16.511627906976745
"Melody Hill CDP, Indiana",1505,1434,71,18,48330,4.717607973421927
"Meridian Hills town, Indiana",675,658,17,18,48456,2.5185185185185186
"Rocky Ripple town, Indiana",287,261,26,18,65556,9.059233449477352
"Osceola town, Indiana",950,869,81,18,57114,8.526315789473685
"Logansport city, Indiana",7758,6851,907,18,44658,11.691157514823407
"Onward town, Indiana",53,48,5,18,56664,9.433962264150944
"Walton town, Indiana",490,464,26,18,79964,5.3061224489795915
"Cambridge City town, Indiana",859,749,110,18,09874,12.805587892898721
"Mitchell city, Indiana",1943,1713,230,18,49950,11.837364899639732
"Mount Ayr town, Indiana",58,47,11,18,51336,18.96551724137931
"Paoli town, Indiana",1659,1480,179,18,57780,10.789632308619652
"Bainbridge town, Indiana",361,316,45,18,03142,12.465373961218837
"Cicero town, Indiana",2111,2064,47,18,12628,2.226432970156324
"Sheridan town, Indiana",1344,1196,148,18,69354,11.011904761904761
"Bolingbrook village, Illinois",23919,22483,1436,17,07133,6.003595468037962
"Elwood village, Illinois",941,894,47,17,23945,4.994686503719448
"Godley village, Illinois",261,223,38,17,30120,14.559386973180077
"Matteson village, Illinois",7906,7224,682,17,47540,8.62635972678978
"University Park village, Illinois",3041,2584,457,17,76935,15.02795133179875
"Joliet city, Illinois",50988,47360,3628,17,38570,7.115399701890642
"Lemont village, Illinois",6282,5993,289,17,42795,4.600445717924228
"Hume village, Illinois",192,164,28,17,36568,14.583333333333334
"Kansas village, Illinois",433,313,120,17,38986,27.713625866050805
"Paris city, Illinois",4440,3722,718,17,57628,16.171171171171174
"Bulpitt village, Illinois",86,69,17,17,09538,19.767441860465116
"Tovey village, Illinois",224,203,21,17,75809,9.375
"Augusta village, Illinois",249,212,37,17,02986,14.859437751004014
"Caledonia village, Illinois",92,87,5,17,10422,5.434782608695652
"Waterman village, Illinois",627,567,60,17,79163,9.569377990430622
"Warsaw city, Illinois",772,606,166,17,78942,21.502590673575128
"Timberlane village, Illinois",316,316,0,17,75360,0.0
"Lerna village, Illinois",136,110,26,17,42938,19.11764705882353
"Grand Ridge village, Illinois",252,235,17,17,30757,6.746031746031746
"Rutland village, Illinois",159,119,40,17,66443,25.157232704402517
"Somonauk village, Illinois",827,770,57,17,70460,6.892382103990327
"Tonica village, Illinois",331,312,19,17,75718,5.740181268882175
"Kell village, Illinois",74,61,13,17,39324,17.56756756756757
"Odin village, Illinois",445,415,30,17,55210,6.741573033707865
"Arthur village, Illinois",1080,1043,37,17,02414,3.425925925925926
"Mitchell CDP, Illinois",522,513,9,17,49698,1.7241379310344827
"Mulkeytown CDP, Illinois",63,63,0,17,51310,0.0
"Oak Run CDP, Illinois",604,273,331,17,54924,54.80132450331126
"Olive Branch CDP, Illinois",351,161,190,17,55847,54.131054131054135
"Olivet CDP, Illinois",170,144,26,17,55886,15.294117647058824
"Opdyke CDP, Illinois",115,105,10,17,56198,8.695652173913043
"Paderborn CDP, Illinois",34,34,0,17,57160,0.0
"Penfield CDP, Illinois",80,80,0,17,58577,0.0
"Prestbury CDP, Illinois",765,765,0,17,61821,0.0
"Rentchler CDP, Illinois",6,6,0,17,63355,0.0
"Seymour CDP, Illinois",105,95,10,17,68809,9.523809523809524
"The Galena Territory CDP, Illinois",2307,693,1614,17,74970,69.96098829648895
"West York CDP, Illinois",41,35,6,17,80957,14.634146341463413
"Twin Grove CDP, Illinois",632,632,0,17,76511,0.0
"Westervelt CDP, Illinois",47,47,0,17,80255,0.0
"West Union CDP, Illinois",188,152,36,17,80879,19.148936170212767
"White Heath CDP, Illinois",164,112,52,17,81295,31.70731707317073
"St. Rose village, Illinois",188,183,5,17,67158,2.6595744680851063
"Garden Prairie CDP, Illinois",108,108,0,17,28612,0.0
"Candlewick Lake CDP, Illinois",1766,1628,138,17,10936,7.814269535673839
"Whiteash CDP, Illinois",107,86,21,17,81165,19.626168224299064
"Secor village, Illinois",156,142,14,17,68510,8.974358974358974
"Perry village, Illinois",218,156,62,17,59156,28.440366972477065
"Pleasant Hill village, Illinois",526,441,85,17,60534,16.159695817490494
"Ohlman village, Illinois",56,51,5,17,55418,8.928571428571429
"Pearl City village, Illinois",330,299,31,17,58369,9.393939393939393
"Peoria Heights village, Illinois",3081,2659,422,17,59026,13.696851671535216
"Spring Bay village, Illinois",219,204,15,17,71604,6.8493150684931505
"Coleta village, Illinois",80,72,8,17,15469,10.0
"Erie village, Illinois",634,603,31,17,24374,4.889589905362776
"Longview village, Illinois",68,56,12,17,44602,17.647058823529413
"Tolono village, Illinois",1114,1114,0,17,75614,0.0
"Urbana city, Illinois",18873,16581,2292,17,77005,12.144333174376094
"Aroma Park village, Illinois",321,281,40,17,02258,12.461059190031152
"Bloomingdale village, Illinois",8834,8581,253,17,06587,2.8639347973737834
"Lombard village, Illinois",18350,17246,1104,17,44407,6.016348773841962
"Millhousen town, Indiana",54,54,0,18,49662,0.0
"Homecroft town, Indiana",273,261,12,18,34420,4.395604395604396
"Crothersville town, Indiana",804,650,154,18,16084,19.154228855721392
"Sullivan city, Indiana",2157,1846,311,18,74006,14.418173388966157
"Clay City town, Indiana",438,389,49,18,13276,11.187214611872145
"Brookville town, Indiana",1385,1193,192,18,08182,13.862815884476534
"Cedar Grove town, Indiana",75,70,5,18,11044,6.666666666666667
"Mount Carmel town, Indiana",21,17,4,18,51354,19.047619047619047
"North Salem town, Indiana",264,223,41,18,55080,15.530303030303031
"Pittsboro town, Indiana",1230,1157,73,18,60192,5.934959349593496
"Silver Lake town, Indiana",495,369,126,18,69768,25.454545454545453
"Terre Haute city, Indiana",26276,23186,3090,18,75428,11.759780788552291
"Milton town, Indiana",172,140,32,18,49860,18.6046511627907
"Cloverdale town, Indiana",928,786,142,18,13852,15.301724137931034
"Carthage town, Indiana",436,363,73,18,10612,16.743119266055047
"Berne city, Indiana",1752,1626,126,18,04888,7.191780821917808
"Monroeville town, Indiana",559,495,64,18,50562,11.449016100178891
"Kokomo city, Indiana",29204,25477,3727,18,40392,12.761950417750992
"Spiceland town, Indiana",331,288,43,18,72008,12.990936555891238
"Beech Grove city, Indiana",6473,5862,611,18,04204,9.439209022091767
"Cumberland town, Indiana",2304,2073,231,18,16336,10.026041666666668
"Wynnedale town, Indiana",81,76,5,18,85742,6.172839506172839
"Leavenworth town, Indiana",156,108,48,18,42606,30.76923076923077
"Colfax town, Indiana",333,251,82,18,14284,24.624624624624623
"Auburn city, Indiana",5949,5705,244,18,02674,4.101529668851908
"Fremont town, Indiana",1061,1022,39,18,25882,3.6757775683317626
"Orland town, Indiana",187,171,16,18,57006,8.55614973262032
"Owensville town, Indiana",648,523,125,18,57528,19.290123456790123
"Batesville city, Indiana",2849,2718,131,18,03664,4.598104598104598
"St. Paul town, Indiana",531,453,78,18,67212,14.689265536723164
"Mackey town, Indiana",56,46,10,18,45774,17.857142857142858
"Oakland City city, Indiana",1150,996,154,18,55710,13.391304347826086
"Rockville town, Indiana",1425,1159,266,18,65520,18.666666666666668
"Williams Creek town, Indiana",137,136,1,18,84374,0.7299270072992701
"Morristown town, Indiana",529,505,24,18,51192,4.536862003780719
"Dana town, Indiana",267,221,46,18,16732,17.228464419475657
"Southport city, Indiana",682,593,89,18,71486,13.049853372434017
"Frankfort city, Indiana",6702,6034,668,18,25324,9.967173977917039
"Wilkinson town, Indiana",165,156,9,18,84302,5.454545454545454
"Shelbyville city, Indiana",8533,7710,823,18,69318,9.644908004218914
"Perrysville town, Indiana",192,179,13,18,59238,6.770833333333333
"Cayuga town, Indiana",550,460,90,18,10954,16.363636363636363
"Newport town, Indiana",207,168,39,18,53496,18.84057971014493
"Earl Park town, Indiana",175,163,12,18,19450,6.857142857142858
"Shadeland town, Indiana",813,731,82,18,68868,10.08610086100861
"Pennville town, Indiana",367,296,71,18,58788,19.346049046321525
"Ellettsville town, Indiana",2953,2742,211,18,20800,7.145275990518117
"Country Club Heights town, Indiana",41,41,0,18,15364,0.0
"Lapel town, Indiana",1090,1041,49,18,42228,4.495412844036697
"River Forest town, Indiana",8,8,0,18,64728,0.0
"Woodlawn Heights town, Indiana",28,27,1,18,85400,3.571428571428571
"Boonville city, Indiana",2803,2610,193,18,06616,6.88547984302533
"Lynnville town, Indiana",412,384,28,18,45486,6.796116504854369
"Attica city, Indiana",1578,1422,156,18,02620,9.885931558935361
"Jonesboro city, Indiana",704,573,131,18,38862,18.607954545454543
"Van Buren town, Indiana",430,362,68,18,78470,15.813953488372093
"Monterey town, Indiana",106,101,5,18,50616,4.716981132075472
"Milltown town, Indiana",456,375,81,18,49716,17.763157894736842
"Ladoga town, Indiana",517,466,51,18,40698,9.864603481624759
"Linden town, Indiana",319,299,20,18,44082,6.269592476489027
"Paragon town, Indiana",259,219,40,18,57870,15.444015444015443
"North Manchester town, Indiana",2378,2211,167,18,54954,7.022708158116064
"Westmont village, Illinois",11398,10711,687,17,80645,6.027373223372521
"Wheaton city, Illinois",20228,19195,1033,17,81048,5.106782677476765
"Manteno village, Illinois",3737,3513,224,17,46500,5.994112924805995
"Anchor village, Illinois",73,65,8,17,01361,10.95890410958904
"Hudson village, Illinois",748,698,50,17,36438,6.684491978609626
"Meredosia village, Illinois",416,357,59,17,48424,14.182692307692307
"Waverly city, Illinois",609,538,71,17,79358,11.658456486042693
"McNabb village, Illinois",137,119,18,17,45850,13.138686131386862
"Armington village, Illinois",171,150,21,17,02206,12.280701754385964
"Minier village, Illinois",538,489,49,17,49555,9.107806691449815
"East Dundee village, Illinois",1407,1351,56,17,21696,3.9800995024875623
"Elburn village, Illinois",1830,1830,0,17,22931,0.0
"Hampshire village, Illinois",1844,1733,111,17,32525,6.019522776572668
"Equality village, Illinois",334,283,51,17,24348,15.269461077844312
"New Haven village, Illinois",196,161,35,17,52506,17.857142857142858
"Island Lake village, Illinois",3268,3149,119,17,37894,3.6413708690330475
"Matherville village, Illinois",404,339,65,17,47527,16.08910891089109
"Viola village, Illinois",402,381,21,17,78123,5.223880597014925
"Hull village, Illinois",245,223,22,17,36516,8.979591836734693
"Kinderhook village, Illinois",133,118,15,17,39922,11.278195488721805
"Milton village, Illinois",146,109,37,17,49477,25.34246575342466
"Golden Gate village, Illinois",41,31,10,17,30250,24.390243902439025
"Dalzell village, Illinois",356,317,39,17,18459,10.955056179775282
"Marseilles city, Illinois",2304,1980,324,17,47150,14.0625
"Morrison city, Illinois",1821,1630,191,17,50530,10.488742449203734
"Sterling city, Illinois",7121,6334,787,17,72546,11.051818564808313
"Golden village, Illinois",300,281,19,17,30159,6.333333333333334
"Royal village, Illinois",146,135,11,17,66157,7.534246575342466
"Hanover Park village, Illinois",11442,11171,271,17,32746,2.3684670512148225
"Bonfield village, Illinois",156,149,7,17,07237,4.487179487179487
"Chicago city, Illinois",1208839,1056118,152721,17,14000,12.63369232792787
"River Grove village, Illinois",4019,3765,254,17,64343,6.319980094550884
"Park Ridge city, Illinois",15193,14245,948,17,57875,6.239715658526953
"Posen village, Illinois",2078,1905,173,17,61314,8.325312800769971
"Ashland village, Illinois",635,551,84,17,02505,13.228346456692913
"Garrett village, Illinois",80,62,18,17,28742,22.5
"Tuscola city, Illinois",2264,2061,203,17,76407,8.96643109540636
"Dahlgren village, Illinois",277,231,46,17,18303,16.60649819494585
"Goreville village, Illinois",494,447,47,17,30575,9.51417004048583
"Neoga city, Illinois",703,684,19,17,51986,2.7027027027027026
"North City village, Illinois",301,273,28,17,53585,9.30232558139535
"West Frankfort city, Illinois",3868,3391,477,17,80333,12.33195449844881
"Walnut village, Illinois",619,568,51,17,78526,8.239095315024231
"Ridgway village, Illinois",483,398,85,17,64018,17.598343685300208
"Eureka city, Illinois",2263,2227,36,17,24543,1.5908086610693768
"Kappa village, Illinois",94,89,5,17,39038,5.319148936170213
"Dorchester village, Illinois",64,58,6,17,20370,9.375
"Hettick village, Illinois",74,51,23,17,34423,31.08108108108108
"Mount Olive city, Illinois",901,774,127,17,51024,14.095449500554938
"Staunton city, Illinois",2359,2214,145,17,72403,6.146672318779143
"Calhoun village, Illinois",103,80,23,17,10448,22.330097087378643
"Henderson village, Illinois",122,117,5,17,34007,4.098360655737705
"Chesterfield village, Illinois",96,69,27,17,13165,28.125
"Scottville village, Illinois",66,46,20,17,68406,30.303030303030305
"Danville city, Illinois",14645,12248,2397,17,18563,16.367360874018434
"Sigel town, Illinois",161,147,14,17,69914,8.695652173913043
"Coal City village, Illinois",2350,2215,135,17,15170,5.74468085106383
"Crest Hill city, Illinois",7464,6967,497,17,17458,6.658628081457664
"Diamond village, Illinois",1045,1029,16,17,19837,1.5311004784688995
"Frankfort Square CDP, Illinois",3049,2837,212,17,27644,6.953099376844866
"Naperville city, Illinois",54613,51951,2662,17,51622,4.874297328474905
"Roann town, Indiana",192,176,16,18,64998,8.333333333333332
"Fort Branch town, Indiana",1260,1182,78,18,24250,6.190476190476191
"Osgood town, Indiana",765,653,112,18,57132,14.640522875816995
"Eaton town, Indiana",852,736,116,18,20080,13.615023474178404
"Kewanna town, Indiana",319,253,66,18,39618,20.689655172413794
"Rochester city, Indiana",3199,2485,714,18,65214,22.319474835886215
"Mecca town, Indiana",138,121,17,18,48132,12.318840579710146
"New Amsterdam town, Indiana",13,9,4,18,52398,30.76923076923077
"Martinsville city, Indiana",4969,4349,620,18,47448,12.477359629704166
"Morgantown town, Indiana",432,381,51,18,51102,11.805555555555555
"South Whitley town, Indiana",895,794,101,18,71612,11.28491620111732
"Tri-Lakes CDP, Indiana",927,627,300,18,76526,32.362459546925564
"Charlestown city, Indiana",3448,3054,394,18,12124,11.42691415313225
"Henryville CDP, Indiana",834,764,70,18,33142,8.393285371702639
"Sellersburg town, Indiana",3415,3206,209,18,68670,6.120058565153733
"Hanover town, Indiana",1116,1049,67,18,31216,6.003584229390681
"Indian Village town, Indiana",64,57,7,18,36306,10.9375
"North Liberty town, Indiana",744,699,45,18,54918,6.048387096774194
"Noblesville city, Indiana",23774,22532,1242,18,54180,5.224194498191301
"Mellott town, Indiana",84,75,9,18,48294,10.714285714285714
"Wallace town, Indiana",61,51,10,18,79730,16.39344262295082
"Lyons town, Indiana",307,267,40,18,45504,13.029315960912053
"Anderson city, Indiana",27867,23086,4781,18,01468,17.15649334338106
"Orestes town, Indiana",265,209,56,18,56952,21.132075471698116
"Koontz Lake CDP, Indiana",1075,643,432,18,40464,40.18604651162791
"Pendleton town, Indiana",1930,1736,194,18,58662,10.05181347150259
"Gentryville town, Indiana",163,127,36,18,27270,22.085889570552148
"Grandview town, Indiana",380,340,40,18,28692,10.526315789473683
"Edgewood town, Indiana",1004,920,84,18,20332,8.366533864541832
"Mount Etna town, Indiana",50,47,3,18,51408,6.0
"Kennard town, Indiana",153,135,18,18,39438,11.76470588235294
"Springport town, Indiana",89,69,20,18,72332,22.47191011235955
"Nashville town, Indiana",682,619,63,18,52038,9.237536656891496
"Salamonia town, Indiana",82,77,5,18,67302,6.097560975609756
"Frankton town, Indiana",857,772,85,18,25702,9.918319719953326
"Rising Sun city, Indiana",1108,967,141,18,64674,12.725631768953068
"Monrovia town, Indiana",487,487,0,18,50580,0.0
"Mishawaka city, Indiana",24775,21141,3634,18,49932,14.668012108980827
"Walkerton town, Indiana",952,900,52,18,79694,5.46218487394958
"Liberty town, Indiana",830,703,127,18,43434,15.301204819277109
"Haubstadt town, Indiana",706,656,50,18,32512,7.0821529745042495
"Hazleton town, Indiana",199,182,17,18,32728,8.542713567839195
"Somerville town, Indiana",125,108,17,18,70542,13.600000000000001
"Atlanta town, Indiana",370,299,71,18,02602,19.18918918918919
"Carmel city, Indiana",35991,33738,2253,18,10342,6.259898307910311
"St. Leon town, Indiana",297,280,17,18,66978,5.723905723905724
"Lawrenceburg city, Indiana",2420,2098,322,18,42462,13.305785123966944
"Westport town, Indiana",641,529,112,18,83276,17.472698907956318
"Hardinsburg town, Indiana",106,76,30,18,31396,28.30188679245283
"New Pekin town, Indiana",717,592,125,18,53388,17.433751743375176
"Salem city, Indiana",2902,2687,215,18,67464,7.408683666436939
"Saltillo town, Indiana",50,39,11,18,67626,22.0
"Spring Grove town, Indiana",139,129,10,18,72206,7.194244604316546
"Whitewater town, Indiana",26,26,0,18,84086,0.0
"Brook town, Indiana",452,397,55,18,07966,12.168141592920353
"Kentland town, Indiana",804,742,62,18,39546,7.711442786069651
"Roselawn CDP, Indiana",1600,1590,10,18,66006,0.625
"West Baden Springs town, Indiana",288,253,35,18,82376,12.152777777777777
"Roachdale town, Indiana",438,385,53,18,64980,12.100456621004566
"Bright CDP, Indiana",2113,2021,92,18,07624,4.353999053478467
"Dillsboro town, Indiana",651,531,120,18,18190,18.433179723502306
"Greendale city, Indiana",2075,1798,277,18,29448,13.349397590361445
"Romeoville village, Illinois",12378,11541,837,17,65442,6.761997091614154
"Woodridge village, Illinois",13802,13104,698,17,83245,5.057238081437473
"Batavia city, Illinois",10209,9748,461,17,04078,4.515623469487707
"Geneva city, Illinois",8406,8048,358,17,28872,4.258862717106828
"Cary village, Illinois",6485,6278,207,17,11592,3.191981495759445
"Wayne village, Illinois",987,857,130,17,79397,13.171225937183383
"Fox Lake village, Illinois",5307,4551,756,17,27442,14.245336348219334
"Prairie Grove village, Illinois",710,662,48,17,61678,6.760563380281689
"Butler village, Illinois",94,77,17,17,10149,18.085106382978726
"Litchfield city, Illinois",3600,3130,470,17,43965,13.055555555555557
"Elmwood city, Illinois",1036,881,155,17,23698,14.961389961389962
"Greenview village, Illinois",400,351,49,17,31576,12.25
"Old Ripley village, Illinois",57,36,21,17,55717,36.84210526315789
"Exeter village, Illinois",43,32,11,17,24699,25.581395348837212
"Damiansville village, Illinois",217,212,5,17,18472,2.3041474654377883
"Kempton village, Illinois",125,97,28,17,39441,22.400000000000002
"Bush village, Illinois",126,103,23,17,10084,18.253968253968253
"Milford village, Illinois",655,589,66,17,49048,10.076335877862595
"Onarga village, Illinois",427,386,41,17,56081,9.601873536299765
"Sheridan village, Illinois",358,334,24,17,69277,6.70391061452514
"Mundelein village, Illinois",11533,10842,691,17,51349,5.991502644585103
"Park City city, Illinois",2293,2274,19,17,57654,0.8286088094199738
"Tower Lakes village, Illinois",451,401,50,17,75874,11.086474501108649
"Troy Grove village, Illinois",116,103,13,17,76225,11.206896551724139
"Farina village, Illinois",273,241,32,17,25375,11.72161172161172
"Iuka village, Illinois",222,194,28,17,37933,12.612612612612612
"Patoka village, Illinois",253,226,27,17,58057,10.67193675889328
"Allenville village, Illinois",94,65,29,17,00867,30.851063829787233
"Alorton village, Illinois",859,712,147,17,00958,17.112922002328286
"Fayetteville village, Illinois",177,151,26,17,25713,14.689265536723164
"London Mills village, Illinois",189,156,33,17,44446,17.46031746031746
"Maquon village, Illinois",136,123,13,17,46695,9.558823529411764
"St. Augustine village, Illinois",68,63,5,17,66677,7.352941176470589
"Benld city, Illinois",794,659,135,17,05209,17.002518891687657
"East Gillespie village, Illinois",107,101,6,17,21852,5.607476635514018
"Modesto village, Illinois",108,97,11,17,49802,10.185185185185185
"Sawyerville village, Illinois",131,106,25,17,67873,19.083969465648856
"White City village, Illinois",132,107,25,17,81191,18.939393939393938
"Fairmount village, Illinois",280,253,27,17,24985,9.642857142857144
"Marshall city, Illinois",1629,1535,94,17,47163,5.770411295273173
"Dieterich village, Illinois",251,242,9,17,19915,3.5856573705179287
"Biggsville village, Illinois",161,139,22,17,05898,13.664596273291925
"Coulterville village, Illinois",487,372,115,17,16613,23.613963039014372
"Earlville city, Illinois",833,731,102,17,21540,12.244897959183673
"Prairie du Rocher village, Illinois",278,243,35,17,61639,12.589928057553957
"Hanaford village, Illinois",200,185,15,17,32616,7.5
"Campbell Hill village, Illinois",151,130,21,17,10773,13.90728476821192
"Dalton City village, Illinois",199,165,34,17,18446,17.08542713567839
"Gays village, Illinois",108,103,5,17,28807,4.62962962962963
"Caseyville village, Illinois",1774,1544,230,17,11644,12.965050732807216
"Farmer City city, Illinois",1030,860,170,17,25414,16.50485436893204
"Waynesville village, Illinois",194,178,16,17,79449,8.24742268041237
"Weldon village, Illinois",216,182,34,17,79683,15.74074074074074
"Gardner village, Illinois",663,579,84,17,28638,12.669683257918551
"Morris city, Illinois",6205,5932,273,17,50491,4.399677679290894
"Bull Valley village, Illinois",495,465,30,17,09531,6.0606060606060606
"Burlington village, Illinois",263,239,24,17,09759,9.125475285171103
"Hoffman Estates village, Illinois",18449,17603,846,17,35411,4.585614396444251
"Lily Lake village, Illinois",372,365,7,17,43406,1.881720430107527
"Standard village, Illinois",150,130,20,17,72221,13.333333333333334
"Winchester city, Indiana",2387,2176,211,18,84752,8.839547549224969
"Brownstown town, Indiana",1224,1099,125,18,08470,10.212418300653594
"Cromwell town, Indiana",208,177,31,18,15994,14.903846153846153
"Burnettsville town, Indiana",178,169,9,18,09316,5.056179775280898
"Cadiz town, Indiana",61,61,0,18,09712,0.0
"New Castle city, Indiana",9031,7308,1723,18,52740,19.078728822943194
"Hudson town, Indiana",202,182,20,18,35086,9.900990099009901
"Milan town, Indiana",813,727,86,18,49266,10.57810578105781
"Edinburgh town, Indiana",1984,1841,143,18,20404,7.207661290322581
"Clinton city, Indiana",2364,2147,217,18,13780,9.179357021996616
"Clarksville town, Indiana",10082,8795,1287,18,12934,12.765324340408648
"Sulphur Springs town, Indiana",138,109,29,18,74060,21.014492753623188
"Lowell town, Indiana",3666,3510,156,18,45144,4.25531914893617
"Butler city, Indiana",1095,934,161,18,09532,14.703196347031962
"Fortville town, Indiana",1866,1793,73,18,24286,3.912111468381565
"Milford town, Indiana",651,569,82,18,49320,12.59600614439324
"New Point town, Indiana",146,129,17,18,53478,11.643835616438356
"Hamilton town, Indiana",1089,659,430,18,30594,39.48576675849403
"Pottawattamie Park town, Indiana",114,110,4,18,61470,3.508771929824561
"Fairland town, Indiana",294,285,9,18,22396,3.061224489795918
"Richland town, Indiana",215,171,44,18,64206,20.46511627906977
"Aberdeen CDP, Indiana",683,659,24,18,00140,3.513909224011713
"Americus CDP, Indiana",147,147,0,18,01396,0.0
"Arlington CDP, Indiana",244,215,29,18,02116,11.885245901639344
"Austin city, Indiana",1864,1453,411,18,02800,22.049356223175963
"Avoca CDP, Indiana",330,330,0,18,02890,0.0
"Blanford CDP, Indiana",192,106,86,18,05662,44.79166666666667
"Buck Creek CDP, Indiana",87,87,0,18,08812,0.0
"Burns City CDP, Indiana",55,55,0,18,09352,0.0
"Butlerville CDP, Indiana",141,141,0,18,09622,0.0
"Canaan CDP, Indiana",67,67,0,18,10036,0.0
"Clarksburg CDP, Indiana",58,58,0,18,12880,0.0
"Coalmont CDP, Indiana",156,133,23,18,14032,14.743589743589745
"Colburn CDP, Indiana",197,159,38,18,14176,19.289340101522843
"Cedar Lake town, Indiana",5088,4448,640,18,11062,12.578616352201259
"Dyer town, Indiana",6157,6042,115,18,19270,1.867792756212441
"Westville town, Indiana",1040,859,181,18,83420,17.403846153846153
"Millersburg town, Indiana",304,271,33,18,49536,10.855263157894738
"Simonton Lake CDP, Indiana",2095,1898,197,18,69840,9.403341288782817
"Kingsford Heights town, Indiana",562,486,76,18,39852,13.523131672597867
"Bourbon town, Indiana",769,690,79,18,06760,10.273081924577374
"Reynolds town, Indiana",244,230,14,18,63918,5.737704918032787
"Decatur city, Indiana",4722,4437,285,18,17074,6.035578144853875
"Geneva town, Indiana",601,568,33,18,27216,5.490848585690515
"Huntertown town, Indiana",2436,2312,124,18,35266,5.0903119868637114
"Shirley town, Indiana",377,320,57,18,69516,15.119363395225463
"Straughn town, Indiana",105,94,11,18,73664,10.476190476190476
"Avon town, Indiana",6250,5946,304,18,02908,4.864
"Plainfield town, Indiana",12761,11936,825,18,60246,6.4650105791082195
"North Webster town, Indiana",735,553,182,18,55134,24.761904761904763
"Decker town, Indiana",113,101,12,18,17110,10.619469026548673
"Petersburg city, Indiana",1157,993,164,18,59364,14.174589455488332
"Griffin town, Indiana",69,60,9,18,30024,13.043478260869565
"New Paris CDP, Indiana",537,513,24,18,53370,4.4692737430167595
"Wanatah town, Indiana",532,502,30,18,80018,5.639097744360902
"Bremen town, Indiana",1935,1836,99,18,07318,5.116279069767442
"Converse town, Indiana",564,502,62,18,14986,10.99290780141844
"Rome City town, Indiana",915,538,377,18,65808,41.202185792349724
"Rushville city, Indiana",2971,2557,414,18,66438,13.93470212049815
"Monroe town, Indiana",307,276,31,18,50202,10.097719869706841
"Fort Wayne city, Indiana",116658,105174,11484,18,25000,9.84415985187471
"Farmland town, Indiana",586,529,57,18,22792,9.726962457337883
"Rolfe city, Iowa",299,257,42,19,68520,14.046822742474916
"Goldfield city, Iowa",313,274,39,19,31530,12.460063897763577
"Arcadia city, Iowa",204,195,9,19,02485,4.411764705882353
"Glidden city, Iowa",513,487,26,19,31395,5.0682261208577
"Manning city, Iowa",694,636,58,19,48945,8.357348703170029
"Templeton city, Iowa",203,158,45,19,77340,22.167487684729064
"Bloomfield city, Iowa",1325,1148,177,19,07030,13.358490566037737
"Griswold city, Iowa",528,458,70,19,33150,13.257575757575758
"Everly city, Iowa",312,272,40,19,26175,12.82051282051282
"Royal city, Iowa",181,157,24,19,69105,13.259668508287293
"Nodaway city, Iowa",66,43,23,19,56865,34.84848484848485
"Guttenberg city, Iowa",1114,955,159,19,33465,14.272890484739678
"Pomeroy city, Iowa",361,283,78,19,64065,21.60664819944598
"Rockwell City city, Iowa",920,756,164,19,68295,17.82608695652174
"Sioux Rapids city, Iowa",380,331,49,19,73425,12.894736842105264
"Bouton city, Iowa",59,50,9,19,07660,15.254237288135593
"Greene city, Iowa",600,500,100,19,32745,16.666666666666664
"Plainfield city, Iowa",220,216,4,19,63210,1.8181818181818181
"Tripoli city, Iowa",574,528,46,19,78915,8.013937282229964
"Woodward city, Iowa",504,482,22,19,86970,4.365079365079365
"Mystic city, Iowa",204,167,37,19,55200,18.137254901960784
"Carroll city, Iowa",4823,4434,389,19,11080,8.065519386274103
"Lidderdale city, Iowa",81,77,4,19,45030,4.938271604938271
"Postville city, Iowa",881,810,71,19,64290,8.059023836549375
"Brandon city, Iowa",141,119,22,19,08155,15.602836879432624
"Rowley city, Iowa",113,111,2,19,69060,1.7699115044247788
"Norway city, Iowa",260,242,18,19,57720,6.923076923076923
"Clarion city, Iowa",1373,1218,155,19,13620,11.289147851420248
"Orleans city, Iowa",553,224,329,19,59655,59.49367088607595
"Hawarden city, Iowa",1143,1016,127,19,35265,11.11111111111111
"Wilton city, Iowa",1277,1196,81,19,86070,6.342991386061081
"Leando CDP, Iowa",42,42,0,19,43950,0.0
"Rock Rapids city, Iowa",1249,1028,221,19,68160,17.69415532425941
"Low Moor city, Iowa",119,111,8,19,47010,6.722689075630252
"Harper city, Iowa",44,28,16,19,34545,36.36363636363637
"Lorimor city, Iowa",196,149,47,19,46515,23.97959183673469
"Afton city, Iowa",418,383,35,19,00595,8.373205741626794
"Windsor Heights city, Iowa",2319,2160,159,19,86250,6.85640362225097
"Maloy city, Iowa",9,8,1,19,48675,11.11111111111111
"Lineville city, Iowa",107,92,15,19,45435,14.018691588785046
"Crystal Lake city, Iowa",160,128,32,19,17670,20.0
"Deep River city, Iowa",137,110,27,19,19495,19.708029197080293
"Stacyville city, Iowa",258,245,13,19,74820,5.038759689922481
"Ringsted city, Iowa",265,235,30,19,67170,11.320754716981133
"Westphalia city, Iowa",56,56,0,19,84540,0.0
"Graf city, Iowa",26,23,3,19,31845,11.538461538461538
"Van Meter city, Iowa",484,461,23,19,80445,4.75206611570248
"Springville city, Iowa",496,433,63,19,74775,12.701612903225806
"Morley city, Iowa",42,42,0,19,54030,0.0
"Lanesboro city, Iowa",78,59,19,19,43140,24.358974358974358
"Pacific Junction city, Iowa",193,181,12,19,60825,6.217616580310881
"Newton city, Iowa",7375,6366,1009,19,56505,13.68135593220339
"Gillett Grove city, Iowa",25,21,4,19,30810,16.0
"Greenville city, Iowa",33,33,0,19,32970,0.0
"Atkins city, Iowa",723,700,23,19,03475,3.18118948824343
"Lake City city, Iowa",865,792,73,19,42465,8.439306358381502
"Yetter city, Iowa",26,15,11,19,87375,42.30769230769231
"Belmond city, Iowa",1146,1111,35,19,05680,3.054101221640489
"Woolstock city, Iowa",109,93,16,19,87015,14.678899082568808
"Waverly city, Iowa",3899,3649,250,19,82875,6.411900487304437
"Dexter city, Iowa",251,251,0,19,21225,0.0
"Pulaski city, Iowa",135,121,14,19,65055,10.37037037037037
"Earlham city, Iowa",601,571,30,19,23340,4.9916805324459235
"Lost Nation city, Iowa",232,215,17,19,46605,7.327586206896551
"Ridgeville town, Indiana",275,218,57,18,64422,20.727272727272727
"Collegeville CDP, Indiana",15,15,0,18,14464,0.0
"Modoc town, Indiana",88,75,13,18,50058,14.772727272727273
"Medora town, Indiana",315,251,64,18,48240,20.317460317460316
"Jasper city, Indiana",6888,6427,461,18,37782,6.692799070847852
"Akron town, Indiana",425,377,48,18,00748,11.294117647058824
"Hebron town, Indiana",1319,1319,0,18,32818,0.0
"Leo-Cedarville town, Indiana",1271,1245,26,18,42861,2.0456333595594023
"Greensboro town, Indiana",54,44,10,18,29682,18.51851851851852
"Montgomery town, Indiana",176,170,6,18,50688,3.4090909090909087
"De Motte town, Indiana",1893,1753,140,18,17722,7.3956682514527206
"Holland town, Indiana",291,279,12,18,34294,4.123711340206185
"Hammond city, Indiana",31955,28301,3654,18,31000,11.434830230010954
"Dublin town, Indiana",358,299,59,18,18766,16.480446927374302
"Danville town, Indiana",3797,3633,164,18,16804,4.319199367922043
"Pierceton town, Indiana",476,398,78,18,59598,16.386554621848738
"West Lebanon town, Indiana",324,284,40,18,82934,12.345679012345679
"Clarks Hill town, Indiana",299,280,19,18,12898,6.354515050167224
"Georgetown town, Indiana",1162,1083,79,18,27324,6.798623063683305
"Kingman town, Indiana",285,232,53,18,39798,18.596491228070175
"Chesterfield town, Indiana",1184,993,191,18,12376,16.131756756756758
"Tennyson town, Indiana",131,118,13,18,75302,9.923664122137405
"Kingsbury town, Indiana",79,73,6,18,39816,7.59493670886076
"Avilla town, Indiana",917,854,63,18,02872,6.870229007633588
"Greentown town, Indiana",1226,1055,171,18,29772,13.947797716150081
"Leesburg town, Indiana",254,239,15,18,42678,5.905511811023622
"Monon town, Indiana",713,642,71,18,50148,9.957924263674615
"Lynn town, Indiana",499,446,53,18,45468,10.62124248496994
"Merom town, Indiana",124,95,29,18,48474,23.387096774193548
"Crown Point city, Indiana",11535,11184,351,18,16138,3.042912873862159
"Brownsburg town, Indiana",9757,9332,425,18,08416,4.355847084144717
"Whitestown town, Indiana",2728,2652,76,18,84014,2.785923753665689
"Larwill town, Indiana",136,128,8,18,42282,5.88235294117647
"Holton town, Indiana",211,183,28,18,34366,13.270142180094787
"Riley town, Indiana",124,108,16,18,64512,12.903225806451612
"Bristol town, Indiana",783,669,114,18,07750,14.559386973180077
"Norway CDP, Indiana",287,262,25,18,55350,8.710801393728223
"Darmstadt town, Indiana",553,527,26,18,16858,4.701627486437613
"Arcadia town, Indiana",653,557,96,18,01954,14.701378254211333
"Fairview Park town, Indiana",661,577,84,18,22576,12.708018154311649
"Universal town, Indiana",152,129,23,18,77912,15.131578947368421
"Newburgh town, Indiana",1459,1408,51,18,52650,3.495544893762851
"Windfall City town, Indiana",343,290,53,18,84806,15.451895043731778
"Ingalls town, Indiana",857,835,22,18,36342,2.5670945157526255
"Wingate town, Indiana",141,102,39,18,84914,27.659574468085108
"Clermont town, Indiana",597,548,49,18,13492,8.207705192629817
"Elizabeth town, Indiana",68,59,9,18,20674,13.23529411764706
"Aurora city, Indiana",1727,1504,223,18,02782,12.912565141864505
"Hidden Valley CDP, Indiana",1956,1775,181,18,33392,9.25357873210634
"Francesville town, Indiana",416,389,27,18,25288,6.490384615384616
"New Albany city, Indiana",17469,15158,2311,18,52326,13.229148777835023
"Crandall town, Indiana",81,51,30,18,15634,37.03703703703704
"Alamo town, Indiana",24,17,7,18,00784,29.166666666666668
"New Ross town, Indiana",182,174,8,18,53550,4.395604395604396
"Brooklyn town, Indiana",615,566,49,18,08038,7.967479674796748
"Cordry Sweetwater Lakes CDP, Indiana",1403,484,919,18,15115,65.50249465431219
"Country Squire Lakes CDP, Indiana",1694,1175,519,18,15409,30.637544273907913
"Deputy CDP, Indiana",30,30,0,18,17812,0.0
"Dover Hill CDP, Indiana",13,13,0,18,18550,0.0
"Dresser CDP, Indiana",18,18,0,18,18658,0.0
"Dubois CDP, Indiana",113,113,0,18,18784,0.0
"East Enterprise CDP, Indiana",94,94,0,18,19576,0.0
"Lockridge city, Iowa",125,116,9,19,46065,7.199999999999999
"Derby city, Iowa",66,51,15,19,20125,22.727272727272727
"Mount Auburn city, Iowa",56,47,9,19,54435,16.071428571428573
"Bevington city, Iowa",23,17,6,19,06490,26.08695652173913
"Decorah city, Iowa",2838,2729,109,19,19405,3.8407329105003525
"Early city, Iowa",334,291,43,19,23475,12.874251497005988
"Jolley city, Iowa",24,11,13,19,39900,54.166666666666664
"Defiance city, Iowa",118,100,18,19,19585,15.254237288135593
"Earling city, Iowa",161,153,8,19,23385,4.968944099378882
"Elk Horn city, Iowa",250,209,41,19,24780,16.400000000000002
"Portsmouth city, Iowa",77,67,10,19,64200,12.987012987012985
"Sioux Center city, Iowa",2490,2366,124,19,73290,4.979919678714859
"Carson city, Iowa",331,292,39,19,11170,11.782477341389729
"Gladbrook city, Iowa",490,429,61,19,31035,12.448979591836734
"Neola city, Iowa",389,371,18,19,55560,4.627249357326478
"Delhi city, Iowa",251,233,18,19,19675,7.171314741035857
"Burt city, Iowa",244,205,39,19,09685,15.983606557377051
"Traer city, Iowa",781,711,70,19,78735,8.962868117797695
"Stanley city, Iowa",64,50,14,19,74955,21.875
"Fertile city, Iowa",166,150,16,19,27390,9.63855421686747
"Fairbank city, Iowa",492,457,35,19,26355,7.113821138211382
"Fayette city, Iowa",467,361,106,19,27165,22.698072805139187
"Larchwood city, Iowa",385,371,14,19,43410,3.6363636363636362
"Varina city, Iowa",28,23,5,19,80535,17.857142857142858
"Mechanicsville city, Iowa",478,429,49,19,50700,10.251046025104603
"Le Roy city, Iowa",2,2,0,19,44580,0.0
"Randall city, Iowa",71,71,0,19,65595,0.0
"Coon Rapids city, Iowa",622,531,91,19,16050,14.630225080385854
"Walford city, Iowa",534,511,23,19,81840,4.307116104868914
"Pierson city, Iowa",184,151,33,19,62760,17.934782608695652
"Atalissa city, Iowa",132,126,6,19,03385,4.545454545454546
"Brunsville city, Iowa",61,61,0,19,08875,0.0
"Cushing city, Iowa",116,94,22,19,17940,18.96551724137931
"Salix city, Iowa",188,159,29,19,70320,15.425531914893616
"Oxford Junction city, Iowa",244,189,55,19,60690,22.540983606557376
"Hubbard city, Iowa",385,318,67,19,37425,17.402597402597404
"Paton city, Iowa",121,95,26,19,61815,21.487603305785125
"Rippey city, Iowa",127,102,25,19,67215,19.68503937007874
"Eldora city, Iowa",1243,1007,236,19,24465,18.98632341110217
"Bancroft city, Iowa",324,279,45,19,04420,13.88888888888889
"Dysart city, Iowa",634,558,76,19,23160,11.987381703470032
"Lincoln city, Iowa",86,59,27,19,45255,31.3953488372093
"Grandview city, Iowa",254,211,43,19,32115,16.92913385826772
"Wapello city, Iowa",867,783,84,19,82200,9.688581314878892
"Primghar city, Iowa",476,404,72,19,64650,15.126050420168067
"Garner city, Iowa",1353,1238,115,19,29955,8.499630450849963
"Delta city, Iowa",161,147,14,19,19855,8.695652173913043
"Keota city, Iowa",433,433,0,19,40980,0.0
"Ollie city, Iowa",94,91,3,19,59070,3.1914893617021276
"South English city, Iowa",129,114,15,19,74055,11.627906976744185
"Webster city, Iowa",63,56,7,19,83055,11.11111111111111
"What Cheer city, Iowa",368,317,51,19,84900,13.858695652173914
"Riceville city, Iowa",431,348,83,19,66585,19.25754060324826
"St. Ansgar city, Iowa",509,471,38,19,69735,7.465618860510806
"Des Moines city, Iowa",92014,84140,7874,19,21000,8.557393440128676
"Elkhart city, Iowa",330,317,13,19,24735,3.939393939393939
"Ocheyedan city, Iowa",256,231,25,19,58530,9.765625
"Cumming city, Iowa",143,136,7,19,17850,4.895104895104895
"Martensdale city, Iowa",207,192,15,19,49890,7.246376811594203
"St. Marys city, Iowa",75,66,9,19,70095,12.0
"Rake city, Iowa",114,95,19,19,65415,16.666666666666664
"Beattie city, Kansas",86,86,0,20,04900,0.0
"Calmar city, Iowa",490,426,64,19,10045,13.061224489795919
"Sac City city, Iowa",1170,987,183,19,69645,15.64102564102564
"Schaller city, Iowa",351,320,31,19,71085,8.831908831908832
"Emison CDP, Indiana",93,93,0,18,21124,0.0
"Fish Lake CDP, Indiana",839,612,227,18,23386,27.056019070321813
"Florence CDP, Indiana",14,14,0,18,23728,0.0
"Fontanet CDP, Indiana",170,144,26,18,23854,15.294117647058824
"Freelandville CDP, Indiana",309,302,7,18,25810,2.26537216828479
"Freetown CDP, Indiana",130,94,36,18,25864,27.692307692307693
"Hanna CDP, Indiana",155,155,0,18,31180,0.0
"Harlan CDP, Indiana",605,555,50,18,31432,8.264462809917356
"Harrodsburg CDP, Indiana",312,288,24,18,32170,7.6923076923076925
"Hatfield CDP, Indiana",355,276,79,18,32494,22.253521126760564
"Hayden CDP, Indiana",226,226,0,18,32584,0.0
"Herbst CDP, Indiana",43,43,0,18,33178,0.0
"Heritage Lake CDP, Indiana",1442,1254,188,18,33187,13.0374479889043
"Hoagland CDP, Indiana",407,362,45,18,34096,11.056511056511056
"Howe CDP, Indiana",180,180,0,18,34978,0.0
"Hudson Lake CDP, Indiana",700,658,42,18,35104,6.0
"Idaville CDP, Indiana",287,201,86,18,35536,29.965156794425084
"Jalapa CDP, Indiana",92,92,0,18,37674,0.0
"Kent CDP, Indiana",40,40,0,18,39510,0.0
"Kimmell CDP, Indiana",211,170,41,18,39744,19.431279620853083
"Lake Holiday CDP, Indiana",541,477,64,18,41211,11.829944547134936
"Lake Santee CDP, Indiana",541,374,167,18,41444,30.868761552680223
"Laketon CDP, Indiana",266,183,83,18,41562,31.203007518796994
"Landess CDP, Indiana",31,31,0,18,41994,0.0
"Manilla CDP, Indiana",132,132,0,18,46422,0.0
"Metamora CDP, Indiana",99,88,11,18,48563,11.11111111111111
"Mier CDP, Indiana",30,30,0,18,49212,0.0
"Milroy CDP, Indiana",265,255,10,18,49806,3.7735849056603774
"Montmorenci CDP, Indiana",97,97,0,18,50778,0.0
"New Goshen CDP, Indiana",229,198,31,18,52956,13.537117903930133
"New Salisbury CDP, Indiana",206,183,23,18,53586,11.165048543689322
"New Trenton CDP, Indiana",115,115,0,18,53712,0.0
"Notre Dame CDP, Indiana",179,138,41,18,55386,22.905027932960895
"Otwell CDP, Indiana",203,195,8,18,57384,3.9408866995073892
"Owensburg CDP, Indiana",244,233,11,18,57510,4.508196721311475
"Painted Hills CDP, Indiana",264,238,26,18,57632,9.848484848484848
"Parkers Settlement CDP, Indiana",285,238,47,18,58050,16.49122807017544
"Point Isabel CDP, Indiana",59,59,0,18,60894,0.0
"Raglesville CDP, Indiana",0,0,0,18,62712,
"Ragsdale CDP, Indiana",91,91,0,18,62730,0.0
"Rolling Prairie CDP, Indiana",175,175,0,18,65736,0.0
"St. Bernice CDP, Indiana",211,176,35,18,66762,16.587677725118482
"St. Mary of the Woods CDP, Indiana",288,255,33,18,67050,11.458333333333332
"St. Meinrad CDP, Indiana",285,285,0,18,67176,0.0
"Salt Creek Commons CDP, Indiana",634,634,0,18,67608,0.0
"Scipio CDP, Indiana",66,66,0,18,68328,0.0
"Scotland CDP, Indiana",129,52,77,18,68382,59.68992248062015
"Shelby CDP, Indiana",159,159,0,18,69246,0.0
"Shepardsville CDP, Indiana",93,93,0,18,69336,0.0
"Shorewood Forest CDP, Indiana",1068,1007,61,18,69642,5.711610486891386
"Sims CDP, Indiana",35,35,0,18,69894,0.0
"Smithville-Sanders CDP, Indiana",2048,1431,617,18,70330,30.126953125
"Somerset CDP, Indiana",321,226,95,18,70524,29.595015576323984
"Stockwell CDP, Indiana",185,185,0,18,73340,0.0
"Van Bibber Lake CDP, Indiana",519,375,144,18,78380,27.74566473988439
"Tecumseh CDP, Indiana",304,276,28,18,75176,9.210526315789473
"Toad Hop CDP, Indiana",51,51,0,18,76022,0.0
"Vallonia CDP, Indiana",188,162,26,18,78290,13.829787234042554
"Waldron CDP, Indiana",259,242,17,18,79568,6.563706563706563
"Westphalia CDP, Indiana",68,47,21,18,83204,30.88235294117647
"West Point CDP, Indiana",183,166,17,18,83222,9.289617486338798
"Wheeler CDP, Indiana",222,153,69,18,83600,31.08108108108108
"Elk Run Heights city, Iowa",461,442,19,19,24870,4.121475054229935
"Evansdale city, Iowa",2042,1977,65,19,25995,3.1831537708129285
"Iowa Falls city, Iowa",2496,2203,293,19,38640,11.738782051282051
"Whitten city, Iowa",63,62,1,19,85305,1.5873015873015872
"Titonka city, Iowa",246,216,30,19,78330,12.195121951219512
"Wesley city, Iowa",178,160,18,19,83415,10.112359550561797
"Spragueville city, Iowa",60,49,11,19,74460,18.333333333333332
"Clarinda city, Iowa",2246,2043,203,19,13575,9.038290293855745
"Donnellson city, Iowa",485,386,99,19,21810,20.412371134020617
"Delmar city, Iowa",222,203,19,19,19720,8.558558558558559
"Rockford city, Iowa",440,372,68,19,68070,15.454545454545453
"Libertyville city, Iowa",168,159,9,19,44985,5.357142857142857
"Braddyville city, Iowa",71,57,14,19,07930,19.718309859154928
"College Springs city, Iowa",99,94,5,19,15105,5.05050505050505
"Mount Pleasant city, Iowa",3440,3150,290,19,54705,8.430232558139535
"Rome city, Iowa",32,30,2,19,68565,6.25
"Westwood city, Iowa",45,45,0,19,84835,0.0
"Cedar Rapids city, Iowa",58845,54431,4414,19,12000,7.501062112329
"Center Point city, Iowa",915,869,46,19,12270,5.027322404371585
"Hiawatha city, Iowa",3402,3096,306,19,35940,8.994708994708994
"Reasnor city, Iowa",56,56,0,19,65955,0.0
"Inwood city, Iowa",422,382,40,19,38415,9.47867298578199
"Lester city, Iowa",121,112,9,19,44670,7.43801652892562
"Tipton city, Iowa",1449,1305,144,19,78285,9.937888198757763
"Williams city, Iowa",193,159,34,19,85800,17.616580310880828
"Centerville city, Iowa",2980,2521,459,19,12315,15.40268456375839
"Udell city, Iowa",28,24,4,19,79410,14.285714285714285
"Nora Springs city, Iowa",728,636,92,19,56910,12.637362637362637
"Crawfordsville city, Iowa",150,125,25,19,17130,16.666666666666664
"East Peru city, Iowa",44,42,2,19,23790,4.545454545454546
"Ainsworth city, Iowa",225,206,19,19,00730,8.444444444444445
"Muscatine city, Iowa",10292,9382,910,19,55110,8.841818888457054
"Stockport city, Iowa",116,109,7,19,75405,6.0344827586206895
"Remsen city, Iowa",718,689,29,19,66405,4.03899721448468
"Dayton city, Iowa",367,308,59,19,19180,16.076294277929154
"Arion city, Iowa",57,50,7,19,02755,12.280701754385964
"Charter Oak city, Iowa",315,258,57,19,12900,18.095238095238095
"Latimer city, Iowa",230,216,14,19,43590,6.086956521739131
"Millerton city, Iowa",61,60,1,19,52275,1.639344262295082
"Sharpsburg city, Iowa",42,38,4,19,72075,9.523809523809524
"Dolliver city, Iowa",35,31,4,19,21675,11.428571428571429
"Randolph city, Iowa",91,70,21,19,65640,23.076923076923077
"Hedrick city, Iowa",298,246,52,19,35670,17.449664429530202
"Keswick city, Iowa",103,92,11,19,41070,10.679611650485436
"Beaman city, Iowa",92,87,5,19,05140,5.434782608695652
"Holland city, Iowa",107,102,5,19,36705,4.672897196261682
"Pisgah city, Iowa",174,149,25,19,63075,14.367816091954023
"Keokuk city, Iowa",5023,4312,711,19,40845,14.154887517419867
"Villisca city, Iowa",699,592,107,19,80985,15.30758226037196
"Vail city, Iowa",225,220,5,19,80130,2.2222222222222223
"Geneva city, Iowa",89,56,33,19,30135,37.07865168539326
"Hills city, Iowa",397,367,30,19,36345,7.5566750629722925
"Kimballton city, Iowa",179,163,16,19,41295,8.938547486033519
"Hampton city, Iowa",1931,1734,197,19,33960,10.20196789228379
"Hansell city, Iowa",49,40,9,19,34365,18.367346938775512
"Pella city, Iowa",4118,3958,160,19,62040,3.885381253035454
"Promise City city, Iowa",56,44,12,19,64875,21.428571428571427
"Manson city, Iowa",941,861,80,19,48990,8.501594048884167
"Truro city, Iowa",214,194,20,19,79140,9.345794392523365
"Keystone city, Iowa",270,247,23,19,41115,8.518518518518519
"Luzerne city, Iowa",48,41,7,19,47505,14.583333333333334
"Shellsburg city, Iowa",418,393,25,19,72480,5.980861244019139
"Orient city, Iowa",203,166,37,19,59565,18.226600985221676
"Fredericksburg city, Iowa",566,489,77,19,28965,13.604240282685511
"Williams CDP, Indiana",165,165,0,18,84338,0.0
"Fishers city, Indiana",33130,32017,1113,18,23278,3.3594929067310595
"Westfield city, Indiana",14170,13368,802,18,82700,5.65984474241355
"Fredericksburg CDP, Indiana",42,39,3,18,25720,7.142857142857142
"Royal Center town, Indiana",379,328,51,18,66222,13.456464379947231
"Memphis CDP, Indiana",331,320,11,18,48384,3.3232628398791544
"Madison city, Indiana",5670,4936,734,18,45990,12.94532627865961
"New Haven city, Indiana",6582,6193,389,18,52992,5.91005773321179
"Lewisville town, Indiana",163,149,14,18,43074,8.588957055214724
"Mount Summit town, Indiana",219,184,35,18,51714,15.981735159817351
"Center Point town, Indiana",138,123,15,18,11746,10.869565217391305
"Amo town, Indiana",168,158,10,18,01450,5.952380952380952
"Burket town, Indiana",88,60,28,18,09226,31.818181818181817
"Etna Green town, Indiana",234,228,6,18,21502,2.564102564102564
"Delphi city, Indiana",1416,1202,214,18,17614,15.112994350282486
"Vincennes city, Indiana",8227,7087,1140,18,79208,13.856812933025402
"Poseyville town, Indiana",478,449,29,18,61416,6.066945606694561
"Montpelier city, Indiana",950,806,144,18,50796,15.157894736842106
"Yeoman town, Indiana",52,45,7,18,85886,13.461538461538462
"Advance town, Indiana",194,175,19,18,00640,9.793814432989691
"Elkhart city, Indiana",22888,20018,2870,18,20728,12.539321915414192
"Michiana Shores town, Indiana",346,128,218,18,48744,63.005780346820806
"Evansville city, Indiana",59121,51660,7461,18,22000,12.619881260465823
"Denver town, Indiana",201,184,17,18,17776,8.45771144278607
"Albion town, Indiana",1016,902,114,18,00820,11.220472440944881
"Orleans town, Indiana",1079,945,134,18,57024,12.418906394810008
"Fillmore town, Indiana",312,288,24,18,23188,7.6923076923076925
"San Pierre CDP, Indiana",34,34,0,18,68004,0.0
"North Crows Nest town, Indiana",18,18,0,18,54612,0.0
"Granger CDP, Indiana",10973,10577,396,18,28800,3.608858106260822
"Beverly Shores town, Indiana",556,299,257,18,05158,46.223021582733814
"Portage city, Indiana",15394,14570,824,18,61092,5.35273483175263
"Covington city, Indiana",1143,1065,78,18,15490,6.824146981627297
"Hillsboro town, Indiana",239,220,19,18,33862,7.949790794979079
"Jasonville city, Indiana",829,627,202,18,37764,24.36670687575392
"Carbon town, Indiana",184,166,18,18,10198,9.782608695652174
"Oldenburg town, Indiana",244,204,40,18,56286,16.39344262295082
"Burlington town, Indiana",300,244,56,18,09244,18.666666666666668
"Grissom AFB CDP, Indiana",876,784,92,18,30060,10.50228310502283
"Peru city, Indiana",5332,4751,581,18,59328,10.896474118529632
"New Chicago town, Indiana",797,684,113,18,52776,14.178168130489336
"Gary city, Indiana",43619,31389,12230,18,27000,28.038240216419453
"Hobart city, Indiana",11792,10922,870,18,34114,7.377883310719131
"Munster town, Indiana",9228,8697,531,18,51912,5.754226267880364
"Lawrence city, Indiana",19678,18113,1565,18,42426,7.953044008537454
"Spring Lake town, Indiana",114,110,4,18,72296,3.508771929824561
"Marengo town, Indiana",338,289,49,18,46746,14.497041420118343
"Taylorsville CDP, Indiana",276,276,0,18,75104,0.0
"St. Joe town, Indiana",175,130,45,18,66834,25.71428571428571
"Galveston town, Indiana",599,525,74,18,26242,12.353923205342237
"Borden town, Indiana",512,416,96,18,06634,18.75
"Utica town, Indiana",307,246,61,18,78110,19.86970684039088
"Schererville town, Indiana",12422,11734,688,18,68220,5.53856061825793
"Schneider town, Indiana",90,78,12,18,68238,13.333333333333334
"Winfield town, Indiana",1877,1841,36,18,84878,1.9179541822056474
"Richmond city, Indiana",17865,14418,3447,18,64260,19.29471032745592
"Goodland town, Indiana",489,430,59,18,28332,12.065439672801636
"Hamlet town, Indiana",292,245,47,18,30708,16.095890410958905
"Connersville city, Indiana",6597,5665,932,18,14932,14.127633772927087
"Albany town, Indiana",939,858,81,18,00802,8.626198083067091
"Edwardsport town, Indiana",159,137,22,18,20458,13.836477987421384
"Syracuse town, Indiana",1517,1211,306,18,74744,20.17139090309822
"Lawler city, Iowa",199,179,20,19,43815,10.050251256281408
"Nashua city, Iowa",762,682,80,19,55335,10.498687664041995
"North Washington city, Iowa",57,54,3,19,57495,5.263157894736842
"Arnolds Park city, Iowa",1663,641,1022,19,03025,61.45520144317499
"Spirit Lake city, Iowa",2966,2535,431,19,74415,14.531355360755228
"Walnut city, Iowa",401,340,61,19,82065,15.211970074812967
"Andrew city, Iowa",174,167,7,19,02125,4.022988505747127
"Quimby city, Iowa",199,181,18,19,65280,9.045226130653267
"Galva city, Iowa",191,183,8,19,29595,4.18848167539267
"Ida Grove city, Iowa",1123,1001,122,19,38010,10.863757791629563
"Lacona city, Iowa",170,170,0,19,42285,0.0
"Spillville city, Iowa",234,212,22,19,74370,9.401709401709402
"Scarville city, Iowa",41,40,1,19,71040,2.4390243902439024
"Castalia city, Iowa",98,87,11,19,11485,11.224489795918368
"Ridgeway city, Iowa",133,121,12,19,67035,9.022556390977442
"Auburn city, Iowa",156,126,30,19,03610,19.230769230769234
"Odebolt city, Iowa",505,431,74,19,58575,14.653465346534652
"Wall Lake city, Iowa",351,306,45,19,82020,12.82051282051282
"Eddyville city, Iowa",466,435,31,19,23970,6.652360515021459
"Holy Cross city, Iowa",160,160,0,19,36885,0.0
"New Vienna city, Iowa",182,172,10,19,56550,5.4945054945054945
"Battle Creek city, Iowa",357,298,59,19,04870,16.5266106442577
"Winthrop city, Iowa",362,343,19,19,86565,5.248618784530387
"Marathon city, Iowa",120,107,13,19,49260,10.833333333333334
"Garber city, Iowa",67,48,19,19,29685,28.35820895522388
"Marquette city, Iowa",247,216,31,19,49620,12.550607287449392
"Osterdock city, Iowa",40,33,7,19,60015,17.5
"Granger city, Iowa",730,716,14,19,32160,1.9178082191780823
"Waukee city, Iowa",7848,7603,245,19,82695,3.121814475025484
"Breda city, Iowa",215,188,27,19,08290,12.558139534883722
"Willey city, Iowa",40,38,2,19,85710,5.0
"Berkley city, Iowa",9,9,0,19,06040,0.0
"Luther city, Iowa",79,73,6,19,47280,7.59493670886076
"Ionia city, Iowa",156,134,22,19,38460,14.102564102564102
"Alta Vista city, Iowa",158,138,20,19,01540,12.658227848101266
"Lake Park city, Iowa",623,533,90,19,42600,14.446227929373997
"Menlo city, Iowa",171,154,17,19,51105,9.941520467836257
"Wayland city, Iowa",447,405,42,19,82965,9.395973154362416
"Mount Vernon city, Iowa",1264,1243,21,19,54840,1.661392405063291
"Palo city, Iowa",452,434,18,19,61230,3.982300884955752
"New London city, Iowa",875,825,50,19,56325,5.714285714285714
"Olds city, Iowa",102,92,10,19,58890,9.803921568627452
"Cantril city, Iowa",124,99,25,19,10450,20.161290322580644
"Ely city, Iowa",733,718,15,19,25365,2.046384720327422
"Marion city, Iowa",16821,15805,1016,19,49485,6.040068961417276
"West Liberty city, Iowa",1491,1286,205,19,84315,13.74916163648558
"Camanche city, Iowa",2039,1981,58,19,10135,2.8445316331535064
"Grand Mound city, Iowa",246,227,19,19,32025,7.723577235772358
"Floyd city, Iowa",132,132,0,19,28020,0.0
"Le Mars city, Iowa",4390,4142,248,19,44400,5.649202733485194
"Fenton city, Iowa",162,129,33,19,27210,20.37037037037037
"Elliott city, Iowa",225,202,23,19,24915,10.222222222222223
"Cromwell city, Iowa",45,43,2,19,17490,4.444444444444445
"Charlotte city, Iowa",156,136,20,19,12855,12.82051282051282
"Wheatland city, Iowa",305,267,38,19,84945,12.459016393442624
"Marble Rock city, Iowa",151,140,11,19,49305,7.28476821192053
"Batavia city, Iowa",265,230,35,19,04825,13.20754716981132
"Patterson city, Iowa",96,91,5,19,61860,5.208333333333334
"Shenandoah city, Iowa",2607,2168,439,19,72525,16.839278864595318
"West Chester city, Iowa",67,52,15,19,83775,22.388059701492537
"Corning city, Iowa",850,696,154,19,16500,18.11764705882353
"Cincinnati city, Iowa",177,159,18,19,13395,10.16949152542373
"Plano city, Iowa",34,29,5,19,63345,14.705882352941178
"Allison city, Iowa",513,458,55,19,01315,10.721247563352826
"Winona Lake town, Indiana",1971,1703,268,18,84950,13.597158802638255
"Oaktown town, Indiana",264,223,41,18,55800,15.530303030303031
"Wolcott town, Indiana",455,440,15,18,85058,3.296703296703297
"Highland CDP, Indiana",1782,1698,84,18,33484,4.713804713804714
"Buffalo CDP, Indiana",518,349,169,18,08992,32.625482625482626
"Chalmers town, Indiana",220,206,14,18,11944,6.363636363636363
"West College Corner town, Indiana",374,276,98,18,82556,26.203208556149733
"McCordsville town, Indiana",2265,2237,28,18,45648,1.2362030905077264
"Lakeville town, Indiana",473,345,128,18,41670,27.061310782241016
"Roseland town, Indiana",374,222,152,18,65988,40.64171122994652
"South Haven CDP, Indiana",1937,1876,61,18,71288,3.1491997934950957
"Mooresville town, Indiana",3986,3779,207,18,50976,5.193176116407426
"Churubusco town, Indiana",827,742,85,18,12610,10.278113663845224
"Lagro town, Indiana",202,177,25,18,40896,12.376237623762377
"Kouts town, Indiana",879,816,63,18,40518,7.167235494880546
"Town of Pines town, Indiana",345,284,61,18,76256,17.681159420289855
"Valparaiso city, Indiana",14085,13129,956,18,78326,6.787362442314519
"Gas City city, Indiana",2920,2452,468,18,27054,16.027397260273972
"Marion city, Indiana",13258,10953,2305,18,46908,17.385729370945842
"Bethany town, Indiana",28,24,4,18,04978,14.285714285714285
"Swayzee town, Indiana",445,405,40,18,74510,8.98876404494382
"New Middletown town, Indiana",38,30,8,18,53298,21.052631578947366
"New Market town, Indiana",250,237,13,18,53262,5.2
"Scottsburg city, Indiana",3118,2637,481,18,68526,15.426555484284798
"Angola city, Indiana",3503,3304,199,18,01666,5.6808449900085645
"New Richmond town, Indiana",126,108,18,18,53532,14.285714285714285
"Waynetown town, Indiana",459,403,56,18,82052,12.200435729847495
"Columbia City city, Indiana",4051,3896,155,18,14716,3.826215749197729
"La Fontaine town, Indiana",429,376,53,18,40842,12.354312354312354
"Napoleon town, Indiana",108,104,4,18,52002,3.7037037037037033
"Upland town, Indiana",951,839,112,18,77966,11.77707676130389
"Bass Lake CDP, Indiana",1195,484,711,18,03610,59.49790794979079
"Union City city, Indiana",1805,1484,321,18,77768,17.78393351800554
"Shelburn town, Indiana",594,479,115,18,69192,19.36026936026936
"Alfordsville town, Indiana",45,35,10,18,00964,22.22222222222222
"Odon town, Indiana",723,679,44,18,56052,6.085753803596127
"Seymour city, Indiana",8448,7671,777,18,68832,9.197443181818182
"Ferdinand town, Indiana",896,808,88,18,22990,9.821428571428571
"Daleville town, Indiana",706,652,54,18,16642,7.64872521246459
"Losantville town, Indiana",126,105,21,18,45000,16.666666666666664
"Farmersburg town, Indiana",627,537,90,18,22738,14.354066985645932
"Elnora town, Indiana",300,253,47,18,20998,15.666666666666668
"Plainville town, Indiana",200,180,20,18,60264,10.0
"Huntington city, Indiana",7540,6821,719,18,35302,9.53580901856764
"Warren town, Indiana",703,624,79,18,80108,11.2375533428165
"Shipshewana town, Indiana",365,343,22,18,69480,6.027397260273973
"Warren Park town, Indiana",1007,869,138,18,80234,13.704071499503476
"Sharpsville town, Indiana",361,317,44,18,69048,12.18836565096953
"Fowler town, Indiana",1175,1022,153,18,25180,13.02127659574468
"Portland city, Indiana",2864,2543,321,18,61236,11.208100558659218
"Princes Lakes town, Indiana",889,697,192,18,62028,21.597300337457817
"Speedway town, Indiana",6005,5186,819,18,71828,13.638634471273939
"Bicknell city, Indiana",1600,1264,336,18,05176,21.0
"Monroe City town, Indiana",283,233,50,18,50526,17.6678445229682
"Troy town, Indiana",248,194,54,18,76634,21.774193548387096
"New Harmony town, Indiana",412,275,137,18,52974,33.25242718446602
"Loogootee city, Indiana",1391,1248,143,18,44910,10.2803738317757
"Crane town, Indiana",143,100,43,18,15652,30.069930069930066
"Shoals town, Indiana",394,357,37,18,69552,9.390862944162437
"La Crosse town, Indiana",270,249,21,18,40662,7.777777777777778
"Michigan City city, Indiana",14755,12439,2316,18,48798,15.696374110471027
"La Paz town, Indiana",313,231,82,18,42192,26.198083067092654
"Parkersburg city, Iowa",919,814,105,19,61590,11.425462459194776
"Wadena city, Iowa",109,104,5,19,81570,4.587155963302752
"Kellogg city, Iowa",268,257,11,19,40440,4.104477611940299
"Sully city, Iowa",343,341,2,19,76035,0.5830903790087464
"Andover city, Iowa",37,37,0,19,02080,0.0
"Toronto city, Iowa",51,39,12,19,78600,23.52941176470588
"Colwell city, Iowa",26,26,0,19,15465,0.0
"Pleasant Plain city, Iowa",33,28,5,19,63615,15.151515151515152
"Brighton city, Iowa",318,270,48,19,08470,15.09433962264151
"St. Charles city, Iowa",306,287,19,19,69915,6.209150326797386
"Blanchard city, Iowa",15,11,4,19,06895,26.666666666666668
"Hepburn city, Iowa",6,6,0,19,35760,0.0
"Shambaugh city, Iowa",66,65,1,19,71895,1.5151515151515151
"Yorktown city, Iowa",24,24,0,19,87420,0.0
"Coppock city, Iowa",20,16,4,19,16140,20.0
"Wellman city, Iowa",598,518,80,19,83280,13.377926421404682
"Dakota City city, Iowa",366,347,19,19,18075,5.191256830601093
"Ottosen city, Iowa",31,22,9,19,60420,29.03225806451613
"Aplington city, Iowa",500,462,38,19,02395,7.6
"Packwood city, Iowa",129,129,0,19,60915,0.0
"Washington city, Iowa",3392,3062,330,19,82335,9.72877358490566
"Bode city, Iowa",183,135,48,19,07210,26.229508196721312
"Lewis city, Iowa",217,203,14,19,44805,6.451612903225806
"Marne city, Iowa",51,51,0,19,49575,0.0
"Dickens city, Iowa",91,82,9,19,21360,9.89010989010989
"Moulton city, Iowa",270,233,37,19,54390,13.703703703703704
"Unionville city, Iowa",61,50,11,19,79680,18.0327868852459
"Clinton city, Iowa",12473,10890,1583,19,14430,12.691413453058606
"Goose Lake city, Iowa",96,94,2,19,31665,2.083333333333333
"Welton city, Iowa",67,60,7,19,83370,10.44776119402985
"Charles City city, Iowa",3705,3318,387,19,12765,10.445344129554655
"Rudd city, Iowa",253,216,37,19,69195,14.624505928853754
"Fairfield city, Iowa",4314,3840,474,19,26445,10.987482614742698
"Jamaica city, Iowa",121,109,12,19,39225,9.917355371900827
"New Hartford city, Iowa",265,231,34,19,56145,12.830188679245284
"Malvern city, Iowa",429,397,32,19,48720,7.459207459207459
"Adair city, Iowa",420,354,66,19,00370,15.714285714285714
"Barnum city, Iowa",89,84,5,19,04645,5.617977528089887
"Steamboat Rock city, Iowa",157,142,15,19,75180,9.554140127388536
"Union city, Iowa",199,166,33,19,79545,16.582914572864322
"Lakota city, Iowa",150,119,31,19,42825,20.666666666666668
"Ledyard city, Iowa",71,55,16,19,44130,22.535211267605636
"Swea City city, Iowa",337,267,70,19,76755,20.77151335311573
"Melbourne city, Iowa",390,340,50,19,50880,12.82051282051282
"Rhodes city, Iowa",129,108,21,19,66540,16.27906976744186
"Davenport city, Iowa",45075,40273,4802,19,19000,10.653355518580145
"Soldier city, Iowa",138,106,32,19,73785,23.18840579710145
"Turin city, Iowa",46,46,0,19,79185,0.0
"Whiting city, Iowa",379,357,22,19,85215,5.804749340369393
"Churdan city, Iowa",236,219,17,19,13350,7.203389830508475
"Masonville city, Iowa",51,47,4,19,50205,7.8431372549019605
"Jefferson city, Iowa",2102,1764,338,19,39450,16.079923882017127
"Stanhope city, Iowa",220,184,36,19,74910,16.363636363636363
"Mingo city, Iowa",131,117,14,19,52815,10.687022900763358
"Blairsburg city, Iowa",79,69,10,19,06760,12.658227848101266
"Kamrar city, Iowa",74,62,12,19,40215,16.216216216216218
"Bridgewater city, Iowa",96,71,25,19,08425,26.041666666666668
"Boxholm city, Iowa",97,85,12,19,07750,12.371134020618557
"Madrid city, Iowa",1097,1039,58,19,48450,5.28714676390155
"Ogden city, Iowa",987,896,91,19,58665,9.219858156028367
"Bassett city, Iowa",27,24,3,19,04780,11.11111111111111
"Panora city, Iowa",568,460,108,19,61320,19.014084507042252
"Winfield city, Iowa",458,404,54,19,86385,11.790393013100436
"Archer city, Iowa",75,63,12,19,02530,16.0
"Vining city, Iowa",37,35,2,19,81120,5.405405405405405
"Kendallville city, Indiana",4655,4205,450,18,39402,9.66702470461869
"Ligonier city, Indiana",1604,1534,70,18,43686,4.364089775561098
"Brookston town, Indiana",673,636,37,18,08146,5.49777117384844
"Glenwood town, Indiana",133,88,45,18,28062,33.83458646616541
"Russiaville town, Indiana",506,441,65,18,66546,12.845849802371543
"Blountsville town, Indiana",56,45,11,18,05896,19.642857142857142
"Knightstown town, Indiana",1069,888,181,18,40266,16.931711880261926
"Mooreland town, Indiana",144,115,29,18,50940,20.13888888888889
"Carlisle town, Indiana",337,289,48,18,10270,14.243323442136498
"Woodburn city, Indiana",664,617,47,18,85184,7.078313253012049
"Parker City town, Indiana",640,556,84,18,57978,13.125
"Saratoga town, Indiana",164,121,43,18,68058,26.21951219512195
"Remington town, Indiana",702,629,73,18,63756,10.3988603988604
"Dugger town, Indiana",393,311,82,18,18892,20.865139949109416
"Cannelburg town, Indiana",73,68,5,18,10090,6.8493150684931505
"Columbus city, Indiana",20027,18716,1311,18,14734,6.546162680381486
"Elizabethtown town, Indiana",193,165,28,18,20692,14.507772020725387
"Corunna town, Indiana",110,96,14,18,15220,12.727272727272727
"Greenfield city, Indiana",9544,8965,579,18,29520,6.06663872590109
"New Palestine town, Indiana",903,852,51,18,53352,5.647840531561462
"Jeffersonville city, Indiana",21055,18457,2598,18,38358,12.339111849916884
"New Washington CDP, Indiana",260,250,10,18,53820,3.8461538461538463
"Brooksburg town, Indiana",55,50,5,18,08092,9.090909090909092
"Whiting city, Indiana",2133,1798,335,18,84122,15.705578996718236
"Dune Acres town, Indiana",147,83,64,18,18982,43.53741496598639
"Porter town, Indiana",1724,1580,144,18,61164,8.352668213457076
"Vera Cruz town, Indiana",45,45,0,18,78776,0.0
"Bloomfield town, Indiana",1243,1033,210,18,05716,16.894609814963797
"Fairmount town, Indiana",1266,1111,155,18,22432,12.243285939968404
"Birdseye town, Indiana",241,217,24,18,05374,9.95850622406639
"State Line City town, Indiana",108,91,17,18,72764,15.74074074074074
"Boswell town, Indiana",334,282,52,18,06706,15.568862275449103
"Grabill town, Indiana",545,523,22,18,28494,4.036697247706423
"Lake Dalecarlia CDP, Indiana",714,570,144,18,41058,20.168067226890756
"Dunreith town, Indiana",75,68,7,18,19162,9.333333333333334
"Middletown town, Indiana",1072,1026,46,18,49014,4.291044776119403
"Highland town, Indiana",9884,9473,411,18,33466,4.158235532173209
"Lake Station city, Indiana",4724,4086,638,18,41535,13.50550381033023
"St. John town, Indiana",5800,5684,116,18,66852,2.0
"East Germantown town, Indiana",190,154,36,18,19756,18.947368421052634
"Fountain City town, Indiana",351,299,52,18,25090,14.814814814814813
"Mount Auburn town, Indiana",43,43,0,18,51318,0.0
"Oolitic town, Indiana",564,497,67,18,56682,11.879432624113475
"Coatesville town, Indiana",221,209,12,18,14050,5.429864253393665
"Jamestown town, Indiana",427,400,27,18,37692,6.323185011709602
"Stilesville town, Indiana",162,130,32,18,73178,19.753086419753085
"Mentone town, Indiana",462,416,46,18,48402,9.956709956709958
"Nappanee city, Indiana",2928,2694,234,18,52020,7.991803278688526
"Middlebury town, Indiana",1279,1254,25,18,48924,1.9546520719311962
"Sidney town, Indiana",35,32,3,18,69678,8.571428571428571
"Bruceville town, Indiana",207,163,44,18,08578,21.256038647342994
"Brazil city, Indiana",3513,3208,305,18,07174,8.682038144036436
"Lizton town, Indiana",217,199,18,18,44442,8.294930875576037
"Spurgeon town, Indiana",88,77,11,18,72440,12.5
"Shamrock Lakes town, Indiana",110,108,2,18,68976,1.8181818181818181
"Camden town, Indiana",291,236,55,18,09910,18.900343642611684
"Gosport town, Indiana",383,341,42,18,28440,10.966057441253264
"Rosedale town, Indiana",360,296,64,18,65934,17.77777777777778
"Lakes of the Four Seasons CDP, Indiana",2728,2582,146,18,41530,5.351906158357771
"Ogden Dunes town, Indiana",608,498,110,18,56088,18.092105263157894
"Newtown town, Indiana",129,121,8,18,53694,6.2015503875969
"Veedersburg town, Indiana",1018,886,132,18,78740,12.966601178781925
"Elma city, Iowa",292,245,47,19,25095,16.095890410958905
"Fredonia city, Iowa",99,99,0,19,29055,0.0
"Eldon city, Iowa",561,488,73,19,24420,13.01247771836007
"Linn Grove city, Iowa",100,88,12,19,45480,12.0
"Clayton city, Iowa",78,32,46,19,13845,58.97435897435898
"Elkport city, Iowa",5,5,0,19,24825,0.0
"Luana city, Iowa",119,111,8,19,47055,6.722689075630252
"McGregor city, Iowa",499,401,98,19,48000,19.639278557114228
"Buffalo Center city, Iowa",456,417,39,19,09280,8.552631578947368
"Chester city, Iowa",91,84,7,19,13125,7.6923076923076925
"Protivin city, Iowa",191,164,27,19,65010,14.136125654450263
"Letts city, Iowa",179,162,17,19,44715,9.497206703910614
"Blakesburg city, Iowa",202,174,28,19,06850,13.861386138613863
"Britt city, Iowa",983,886,97,19,08605,9.867751780264497
"Goodell city, Iowa",57,54,3,19,31575,5.263157894736842
"Ankeny city, Iowa",23748,22085,1663,19,02305,7.002694963786424
"Polk City city, Iowa",1511,1452,59,19,64020,3.9046988749172735
"Earlville city, Iowa",375,358,17,19,23430,4.533333333333333
"Greeley city, Iowa",115,101,14,19,32610,12.173913043478262
"Manchester city, Iowa",2334,2151,183,19,48810,7.840616966580977
"Bradgate city, Iowa",38,30,8,19,08065,21.052631578947366
"Humboldt city, Iowa",2287,2100,187,19,37560,8.176650634018365
"Ames city, Iowa",26754,25243,1511,19,01855,5.64775360693728
"Anamosa city, Iowa",2280,2080,200,19,01990,8.771929824561402
"Hastings city, Iowa",69,55,14,19,34995,20.28985507246377
"Mallard city, Iowa",144,113,31,19,48585,21.52777777777778
"St. Anthony city, Iowa",39,25,14,19,69780,35.8974358974359
"Dixon city, Iowa",104,90,14,19,21540,13.461538461538462
"New Liberty city, Iowa",71,71,0,19,56280,0.0
"Castana city, Iowa",76,58,18,19,11530,23.684210526315788
"Melrose city, Iowa",88,71,17,19,50970,19.318181818181817
"Clear Lake city, Iowa",4453,3445,1008,19,14025,22.636424882101956
"Meservey city, Iowa",118,93,25,19,51420,21.1864406779661
"Bellevue city, Iowa",1085,960,125,19,05635,11.52073732718894
"St. Donatus city, Iowa",66,56,10,19,69960,15.151515151515152
"Chariton city, Iowa",2220,1877,343,19,12720,15.45045045045045
"Melvin city, Iowa",128,110,18,19,51060,14.0625
"Sibley city, Iowa",1163,1097,66,19,72975,5.674978503869303
"Indianola city, Iowa",6308,6108,200,19,38280,3.1705770450221937
"Duncombe city, Iowa",156,148,8,19,22755,5.128205128205128
"Lehigh city, Iowa",227,206,21,19,44265,9.251101321585903
"Wallingford city, Iowa",100,90,10,19,81975,10.0
"Imogene city, Iowa",17,12,5,19,38055,29.411764705882355
"Woden city, Iowa",126,101,25,19,86700,19.841269841269842
"Gibson city, Iowa",28,27,1,19,30540,3.571428571428571
"Kinross city, Iowa",33,28,5,19,41475,15.151515151515152
"Richland city, Iowa",288,258,30,19,66720,10.416666666666668
"Searsboro city, Iowa",80,76,4,19,71355,5.0
"Emmetsburg city, Iowa",1935,1590,345,19,25590,17.829457364341085
"Grant city, Iowa",61,58,3,19,32295,4.918032786885246
"Diagonal city, Iowa",142,118,24,19,21270,16.901408450704224
"Kellerton city, Iowa",151,126,25,19,40350,16.55629139072848
"Collins city, Iowa",193,167,26,19,15195,13.471502590673575
"Persia city, Iowa",115,112,3,19,62445,2.608695652173913
"Franklin city, Iowa",72,66,6,19,28740,8.333333333333332
"Badger city, Iowa",242,219,23,19,04195,9.50413223140496
"Colo city, Iowa",360,354,6,19,15240,1.6666666666666667
"Gilbert city, Iowa",352,339,13,19,30630,3.6931818181818183
"Ferguson city, Iowa",80,80,0,19,27255,0.0
"Liscomb city, Iowa",128,120,8,19,45660,6.25
"Maharishi Vedic City city, Iowa",218,181,37,19,48500,16.972477064220186
"Kent CDP, Iowa",6,6,0,19,40710,0.0
"Lake Panorama CDP, Iowa",1049,421,628,19,42575,59.86653956148713
"Little Cedar CDP, Iowa",25,25,0,19,45705,0.0
"Switz City town, Indiana",139,100,39,18,74582,28.05755395683453
"Worthington town, Indiana",708,578,130,18,85598,18.361581920903955
"Fowlerton town, Indiana",125,101,24,18,25198,19.2
"Matthews town, Indiana",291,271,20,18,47592,6.872852233676976
"Sweetser town, Indiana",689,635,54,18,74546,7.837445573294629
"Laconia town, Indiana",63,58,5,18,40644,7.936507936507936
"Mauckport town, Indiana",60,26,34,18,47628,56.666666666666664
"Muncie city, Indiana",32728,27481,5247,18,51876,16.03214373013933
"Spencer town, Indiana",1131,1021,110,18,71972,9.725906277630415
"Marshall town, Indiana",121,98,23,18,47322,19.00826446280992
"Montezuma town, Indiana",455,380,75,18,50652,16.483516483516482
"Bluffton city, Indiana",4667,4155,512,18,06220,10.970644953931862
"Ossian town, Indiana",1377,1266,111,18,57168,8.061002178649238
"Uniondale town, Indiana",135,122,13,18,77786,9.62962962962963
"Zanesville town, Indiana",255,241,14,18,86318,5.490196078431373
"Elwood city, Indiana",4133,3433,700,18,21070,16.936849745947256
"Oxford town, Indiana",523,460,63,18,57546,12.045889101338432
"Chrisney town, Indiana",281,257,24,18,12574,8.540925266903916
"Bryant town, Indiana",86,75,11,18,08704,12.790697674418606
"Redkey town, Indiana",726,668,58,18,63450,7.988980716253444
"Bargersville town, Indiana",2706,2492,214,18,03394,7.908351810790835
"Galena CDP, Indiana",601,545,56,18,26206,9.317803660565724
"Lanesville town, Indiana",274,257,17,18,42048,6.204379562043796
"Darlington town, Indiana",410,340,70,18,16840,17.073170731707318
"Trafalgar town, Indiana",465,453,12,18,76310,2.5806451612903225
"Markleville town, Indiana",203,191,12,18,47178,5.911330049261084
"Dayton town, Indiana",632,580,52,18,17002,8.227848101265822
"West Lafayette city, Indiana",15579,13834,1745,18,82862,11.200975672379485
"Chandler town, Indiana",1482,1311,171,18,12034,11.538461538461538
"Burns Harbor town, Indiana",663,633,30,18,09370,4.524886877828054
"Chesterton town, Indiana",5674,5437,237,18,12412,4.176947479732111
"Rensselaer city, Indiana",2548,2351,197,18,63792,7.731554160125589
"Hymera town, Indiana",369,324,45,18,35500,12.195121951219512
"Crows Nest town, Indiana",36,28,8,18,16156,22.22222222222222
"Greenwood city, Indiana",23925,21793,2132,18,29898,8.911180773249738
"Tipton city, Indiana",2387,2155,232,18,75986,9.719312945119398
"Pine Village town, Indiana",115,105,10,18,60084,8.695652173913043
"Williamsport town, Indiana",811,739,72,18,84410,8.877928483353884
"Whiteland town, Indiana",1637,1510,127,18,83816,7.758094074526572
"Stinesville town, Indiana",101,86,15,18,73232,14.85148514851485
"Alexandria city, Indiana",2354,1987,367,18,00910,15.590484282073067
"East Chicago city, Indiana",13430,10160,3270,18,19486,24.348473566641847
"Winamac town, Indiana",1209,1065,144,18,84734,11.910669975186105
"Lafayette city, Indiana",33787,30942,2845,18,40788,8.420398378074408
"Hagerstown town, Indiana",797,723,74,18,30402,9.284818067754077
"West Terre Haute town, Indiana",974,878,96,18,83384,9.856262833675565
"Centerville town, Indiana",1107,1000,107,18,11836,9.66576332429991
"Economy town, Indiana",71,56,15,18,20152,21.12676056338028
"Bedford city, Indiana",6602,5653,949,18,04114,14.374431990305968
"Lake Village CDP, Indiana",311,265,46,18,41652,14.790996784565916
"Morocco town, Indiana",521,416,105,18,51138,20.153550863723606
"French Lick town, Indiana",921,748,173,18,25972,18.783930510314875
"Greencastle city, Indiana",4009,3675,334,18,29358,8.331254676976803
"Russellville town, Indiana",163,128,35,18,66510,21.472392638036812
"Patoka town, Indiana",532,483,49,18,58320,9.210526315789473
"Princeton city, Indiana",3944,3386,558,18,62046,14.148073022312374
"West Harrison town, Indiana",171,124,47,18,82790,27.485380116959064
"Henderson city, Iowa",79,64,15,19,35715,18.9873417721519
"Manly city, Iowa",657,614,43,19,48900,6.54490106544901
"Northwood city, Iowa",987,919,68,19,57630,6.889564336372847
"Arlington city, Iowa",229,209,20,19,02845,8.73362445414847
"Clermont city, Iowa",326,271,55,19,14250,16.87116564417178
"Loveland CDP, Iowa",0,0,0,19,46785,
"Meyer CDP, Iowa",6,6,0,19,51510,0.0
"Middle Amana CDP, Iowa",268,268,0,19,51600,0.0
"Miller CDP, Iowa",11,11,0,19,52140,0.0
"Mineola CDP, Iowa",66,66,0,19,52635,0.0
"Mona CDP, Iowa",61,34,27,19,53085,44.26229508196721
"New Haven CDP, Iowa",22,22,0,19,56190,0.0
"Otranto CDP, Iowa",0,0,0,19,60285,
"Percival CDP, Iowa",38,38,0,19,62175,0.0
"Portland CDP, Iowa",28,28,0,19,64155,0.0
"River Sioux CDP, Iowa",39,39,0,19,67530,0.0
"Rochester CDP, Iowa",73,73,0,19,67890,0.0
"Roseville CDP, Iowa",0,0,0,19,68800,
"South Amana CDP, Iowa",65,65,0,19,73965,0.0
"St. Benedict CDP, Iowa",24,22,2,19,69825,8.333333333333332
"St. Joseph CDP, Iowa",25,25,0,19,70005,0.0
"Sexton CDP, Iowa",0,0,0,19,71715,
"Stone City CDP, Iowa",91,91,0,19,75540,0.0
"Sun Valley Lake CDP, Iowa",461,132,329,19,76415,71.36659436008676
"Toeterville CDP, Iowa",38,38,0,19,78465,0.0
"Twin Lakes CDP, Iowa",281,96,185,19,79335,65.83629893238434
"Washburn CDP, Iowa",338,338,0,19,82290,0.0
"Watkins CDP, Iowa",61,61,0,19,82515,0.0
"West Amana CDP, Iowa",118,99,19,19,83505,16.101694915254235
"Weston CDP, Iowa",64,46,18,19,84495,28.125
"Amana CDP, Iowa",179,150,29,19,01720,16.201117318435752
"Anderson CDP, Iowa",11,11,0,19,02035,0.0
"Athelstan CDP, Iowa",10,10,0,19,03430,0.0
"Bartlett CDP, Iowa",21,5,16,19,04735,76.19047619047619
"Beaverdale CDP, Iowa",449,387,62,19,05200,13.808463251670378
"Bentley CDP, Iowa",50,43,7,19,05870,14.000000000000002
"Bolan CDP, Iowa",8,8,0,19,07255,0.0
"Bradford CDP, Iowa",61,34,27,19,08020,44.26229508196721
"Burchinal CDP, Iowa",21,6,15,19,09415,71.42857142857143
"Burr Oak CDP, Iowa",73,73,0,19,09640,0.0
"California Junction CDP, Iowa",27,27,0,19,09910,0.0
"Chapin CDP, Iowa",56,56,0,19,12675,0.0
"Climbing Hill CDP, Iowa",57,57,0,19,14385,0.0
"Conroy CDP, Iowa",164,144,20,19,15870,12.195121951219512
"Corley CDP, Iowa",11,11,0,19,16320,0.0
"Denmark CDP, Iowa",188,188,0,19,19990,0.0
"Diamondhead Lake CDP, Iowa",231,145,86,19,21320,37.22943722943723
"Duncan CDP, Iowa",30,30,0,19,22710,0.0
"East Amana CDP, Iowa",24,24,0,19,23520,0.0
"Frytown CDP, Iowa",16,16,0,19,29325,0.0
"Garden City CDP, Iowa",61,48,13,19,29730,21.311475409836063
"Green Mountain CDP, Iowa",71,71,0,19,32925,0.0
"Hayfield CDP, Iowa",58,34,24,19,35490,41.37931034482759
"High Amana CDP, Iowa",50,31,19,19,36030,38.0
"Holiday Lake CDP, Iowa",535,244,291,19,36660,54.39252336448598
"Homestead CDP, Iowa",73,73,0,19,36975,0.0
"Buffalo city, Iowa",550,503,47,19,09235,8.545454545454545
"McCausland city, Iowa",119,107,12,19,47820,10.084033613445378
"Maysville city, Iowa",82,74,8,19,50655,9.75609756097561
"Panorama Park city, Iowa",53,44,9,19,61365,16.9811320754717
"Blencoe city, Iowa",112,104,8,19,06940,7.142857142857142
"Albia city, Iowa",1912,1639,273,19,00910,14.278242677824268
"Guernsey city, Iowa",24,24,0,19,33285,0.0
"Montezuma city, Iowa",689,557,132,19,53490,19.15820029027576
"Victor city, Iowa",457,395,62,19,80805,13.566739606126916
"Lime Springs city, Iowa",288,239,49,19,45165,17.01388888888889
"Morning Sun city, Iowa",342,312,30,19,54120,8.771929824561402
"Agency city, Iowa",326,301,25,19,00640,7.668711656441718
"Mason City city, Iowa",13535,12370,1165,19,50160,8.607314370151459
"Maynard city, Iowa",255,218,37,19,50610,14.50980392156863
"Colfax city, Iowa",822,760,62,19,15060,7.542579075425791
"Lambs Grove city, Iowa",95,90,5,19,42870,5.263157894736842
"Lynnville city, Iowa",208,183,25,19,47595,12.01923076923077
"Valeria city, Iowa",20,15,5,19,80175,25.0
"Laurens city, Iowa",765,626,139,19,43725,18.169934640522875
"Bennett city, Iowa",171,155,16,19,05770,9.35672514619883
"Fort Dodge city, Iowa",11101,9903,1198,19,28515,10.791820556706604
"Shannon City city, Iowa",47,36,11,19,71940,23.404255319148938
"Gowrie city, Iowa",443,435,8,19,31710,1.805869074492099
"Nevada city, Iowa",2903,2759,144,19,55695,4.96038580778505
"Ellston city, Iowa",16,16,0,19,25005,0.0
"Maxwell city, Iowa",356,340,16,19,50520,4.49438202247191
"Albion city, Iowa",259,252,7,19,00955,2.7027027027027026
"Waterville city, Iowa",69,56,13,19,82470,18.84057971014493
"Danville city, Iowa",420,395,25,19,18435,5.952380952380952
"Mediapolis city, Iowa",706,662,44,19,50790,6.232294617563739
"Grundy Center city, Iowa",1257,1178,79,19,33195,6.284805091487669
"Magnolia city, Iowa",82,68,14,19,48495,17.073170731707318
"Modale city, Iowa",157,124,33,19,52995,21.019108280254777
"Osceola city, Iowa",2241,2085,156,19,59835,6.961178045515395
"Garden Grove city, Iowa",92,76,16,19,29775,17.391304347826086
"Lamoni city, Iowa",1044,870,174,19,42960,16.666666666666664
"Murray city, Iowa",369,309,60,19,55065,16.260162601626014
"Eagle Grove city, Iowa",1691,1562,129,19,23250,7.6286221170904795
"New Hampton city, Iowa",1698,1562,136,19,56100,8.00942285041225
"Milford city, Iowa",1394,1255,139,19,52095,9.971305595408895
"Okoboji city, Iowa",1233,438,795,19,58710,64.47688564476886
"Casey city, Iowa",182,155,27,19,11395,14.835164835164836
"Irwin city, Iowa",202,174,28,19,39000,13.861386138613863
"Tennant city, Iowa",43,30,13,19,77430,30.23255813953488
"Alton city, Iowa",529,484,45,19,01585,8.506616257088846
"Matlock city, Iowa",34,34,0,19,50385,0.0
"Macedonia city, Iowa",125,110,15,19,47955,12.0
"Millersburg city, Iowa",76,76,0,19,52230,0.0
"Cambridge city, Iowa",313,291,22,19,10225,7.0287539936102235
"Zearing city, Iowa",253,226,27,19,87555,10.67193675889328
"Clemons city, Iowa",70,60,10,19,14160,14.285714285714285
"Laurel city, Iowa",119,108,11,19,43680,9.243697478991598
"New Providence city, Iowa",114,104,10,19,56415,8.771929824561402
"Owasa city, Iowa",23,23,0,19,60555,0.0
"George city, Iowa",494,481,13,19,30225,2.631578947368421
"Havelock city, Iowa",80,60,20,19,35130,25.0
"Davis City city, Iowa",153,111,42,19,19090,27.450980392156865
"Grand River city, Iowa",122,90,32,19,32070,26.229508196721312
"Jewell Junction city, Iowa",558,488,70,19,39675,12.544802867383511
"Pilot Mound city, Iowa",130,114,16,19,62850,12.307692307692308
"Superior city, Iowa",81,79,2,19,76440,2.4691358024691357
"West Okoboji city, Iowa",413,167,246,19,84450,59.56416464891041
"Bayard city, Iowa",229,166,63,19,04960,27.510917030567683
"Guthrie Center city, Iowa",830,687,143,19,33420,17.2289156626506
"Winterset city, Iowa",2298,2136,162,19,86520,7.049608355091384
"Coin city, Iowa",93,71,22,19,14970,23.655913978494624
"Essex city, Iowa",408,361,47,19,25815,11.519607843137255
"Kalona city, Iowa",1086,1017,69,19,40170,6.353591160220995
"Riverside city, Iowa",486,444,42,19,67440,8.641975308641975
"Anita city, Iowa",588,512,76,19,02260,12.925170068027212
"Aredale city, Iowa",36,30,6,19,02620,16.666666666666664
"Shell Rock city, Iowa",627,597,30,19,72435,4.784688995215311
"Hardy city, Iowa",26,20,6,19,34455,23.076923076923077
"Glenwood city, Iowa",2114,1881,233,19,31350,11.021759697256387
"Elgin city, Iowa",359,313,46,19,24645,12.813370473537605
"Monroe city, Iowa",830,740,90,19,53355,10.843373493975903
"Plover city, Iowa",55,36,19,19,63840,34.54545454545455
"Dana city, Iowa",29,19,10,19,18345,34.48275862068966
"Colesburg city, Iowa",202,186,16,19,15015,7.920792079207921
"Alden city, Iowa",384,364,20,19,01045,5.208333333333334
"Sigourney city, Iowa",1017,862,155,19,73110,15.240904621435595
"Elberon city, Iowa",69,57,12,19,24375,17.391304347826086
"Sidney city, Iowa",604,447,157,19,73065,25.99337748344371
"Thurman city, Iowa",60,48,12,19,77970,20.0
"Orchard city, Iowa",46,33,13,19,59520,28.26086956521739
"Alleman city, Iowa",149,149,0,19,01180,0.0
"Mitchellville city, Iowa",686,576,110,19,52950,16.034985422740526
"West Des Moines city, Iowa",29696,27704,1992,19,83910,6.707974137931035
"Tingley city, Iowa",84,61,23,19,78195,27.380952380952383
"Rodman city, Iowa",23,15,8,19,68340,34.78260869565217
"Ruthven city, Iowa",367,324,43,19,69330,11.716621253405995
"Mount Ayr city, Iowa",933,828,105,19,54480,11.254019292604502
"Haverhill city, Iowa",83,73,10,19,35220,12.048192771084338
"Le Grand city, Iowa",402,367,35,19,44220,8.706467661691542
"Long Grove city, Iowa",349,335,14,19,46425,4.011461318051576
"Ute city, Iowa",222,184,38,19,79995,17.117117117117118
"Columbus Junction city, Iowa",909,812,97,19,15420,10.671067106710671
"Cotter city, Iowa",19,19,0,19,16725,0.0
"Oakville city, Iowa",73,68,5,19,58395,6.8493150684931505
"Hartley city, Iowa",876,763,113,19,34725,12.899543378995434
"Dougherty city, Iowa",48,28,20,19,22080,41.66666666666667
"Rock Falls city, Iowa",69,69,0,19,68025,0.0
"Dundee city, Iowa",89,85,4,19,22800,4.49438202247191
"Ryan city, Iowa",201,174,27,19,69465,13.432835820895523
"Clive city, Iowa",6931,6618,313,19,14520,4.51594286538739
"Pleasant Hill city, Iowa",3899,3652,247,19,63525,6.334957681456784
"Runnells city, Iowa",194,179,15,19,69240,7.731958762886598
"Saylorville CDP, Iowa",1348,1259,89,19,70995,6.602373887240357
"Urbandale city, Iowa",17372,16726,646,19,79950,3.7186276767211606
"Elkader city, Iowa",669,630,39,19,24690,5.829596412556054
"Garnavillo city, Iowa",387,373,14,19,29910,3.6175710594315245
"Kirkman city, Iowa",35,34,1,19,41520,2.857142857142857
"Hancock city, Iowa",108,91,17,19,34005,15.74074074074074
"Hutchins CDP, Iowa",7,7,0,19,37875,0.0
"Irvington CDP, Iowa",0,0,0,19,38955,
"Jacksonville CDP, Iowa",9,9,0,19,39180,0.0
"Center Junction CDP, Iowa",68,65,3,19,12225,4.411764705882353
"DeWitt city, Iowa",2200,1987,213,19,21180,9.681818181818182
"Mount Union CDP, Iowa",65,58,7,19,54795,10.76923076923077
"Mount Sterling CDP, Iowa",19,19,0,19,54750,0.0
"McClelland city, Iowa",65,65,0,19,47865,0.0
"Keomah Village city, Iowa",44,43,1,19,40890,2.272727272727273
"Marshalltown city, Iowa",11184,10231,953,19,49755,8.521101573676681
"Bettendorf city, Iowa",15074,13986,1088,19,06355,7.2177258856308875
"Blue Grass city, Iowa",627,605,22,19,07075,3.508771929824561
"Durant city, Iowa",781,720,61,19,22980,7.810499359795134
"Eldridge city, Iowa",2466,2349,117,19,24600,4.744525547445255
"Le Claire city, Iowa",1719,1484,235,19,44085,13.670738801628854
"Riverdale city, Iowa",170,165,5,19,67350,2.941176470588235
"Mapleton city, Iowa",663,559,104,19,49170,15.686274509803921
"Delaware city, Iowa",69,69,0,19,19630,0.0
"Parnell city, Iowa",133,116,17,19,61770,12.781954887218044
"Curlew city, Iowa",30,23,7,19,17895,23.333333333333332
"Cylinder city, Iowa",43,34,9,19,17985,20.930232558139537
"Benton city, Iowa",35,25,10,19,05905,28.57142857142857
"Delphos city, Iowa",21,17,4,19,19810,19.047619047619047
"Kelley city, Iowa",124,110,14,19,40395,11.29032258064516
"McCallsburg city, Iowa",166,152,14,19,47775,8.433734939759036
"Slater city, Iowa",615,585,30,19,73515,4.878048780487805
"Hoyt city, Kansas",266,253,13,20,33375,4.887218045112782
"Story City city, Iowa",1476,1391,85,19,75675,5.7588075880758804
"Gilman city, Iowa",223,203,20,19,30900,8.968609865470851
"Elgin city, Kansas",71,36,35,20,20125,49.29577464788733
"Susank city, Kansas",14,11,3,20,69525,21.428571428571427
"Mission Woods city, Kansas",80,78,2,20,47425,2.5
"Albert city, Kansas",78,68,10,20,00825,12.82051282051282
"Ellinwood city, Kansas",1089,927,162,20,20425,14.87603305785124
"St. George city, Kansas",315,299,16,20,62200,5.079365079365079
"Bison city, Kansas",119,74,45,20,06950,37.81512605042017
"Eudora city, Kansas",2323,2192,131,20,21675,5.6392595781317265
"Bonner Springs city, Kansas",3105,2910,195,20,07975,6.280193236714976
"Edwardsville city, Kansas",1687,1527,160,20,20000,9.48429164196799
"Hope city, Kansas",181,167,14,20,33075,7.734806629834254
"Bluff City city, Kansas",45,30,15,20,07775,33.33333333333333
"Onaga city, Kansas",388,323,65,20,52875,16.752577319587626
"Overland Park city, Kansas",81687,76988,4699,20,53775,5.752445309535177
"Lebanon city, Kansas",220,127,93,20,39100,42.27272727272727
"Sabetha city, Kansas",1249,1035,214,20,62025,17.133706965572458
"Baxter Springs city, Kansas",2110,1608,502,20,04625,23.791469194312796
"Tipton city, Kansas",118,98,20,20,70675,16.94915254237288
"North Newton city, Kansas",749,677,72,20,51225,9.612817089452603
"Liberal city, Kansas",7324,6553,771,20,39825,10.527034407427635
"Leon city, Kansas",321,258,63,20,39450,19.626168224299064
"Norton city, Kansas",1312,1093,219,20,51500,16.692073170731707
"Quinter city, Kansas",437,390,47,20,58250,10.755148741418765
"Robinson city, Kansas",112,85,27,20,60325,24.107142857142858
"Ozawkie city, Kansas",276,247,29,20,53925,10.507246376811594
"Bennington city, Kansas",299,280,19,20,06075,6.354515050167224
"Cuba city, Kansas",185,114,71,20,16625,38.37837837837838
"Cottonwood Falls city, Kansas",365,294,71,20,15900,19.45205479452055
"South Haven city, Kansas",173,138,35,20,66650,20.23121387283237
"Grainfield city, Kansas",169,144,25,20,27200,14.792899408284024
"Hunnewell city, Kansas",48,41,7,20,33500,14.583333333333334
"Matfield Green city, Kansas",34,17,17,20,45150,50.0
"Parsons city, Kansas",5207,3960,1247,20,54675,23.948530823890916
"Hanover city, Kansas",310,250,60,20,29875,19.35483870967742
"Iuka city, Kansas",79,67,12,20,34625,15.18987341772152
"Webber city, Kansas",32,16,16,20,76250,50.0
"Centralia city, Kansas",275,218,57,20,12425,20.727272727272727
"Scandia city, Kansas",250,214,36,20,63350,14.399999999999999
"Clay Center city, Kansas",2224,1764,460,20,13625,20.68345323741007
"Sterling city, Kansas",982,881,101,20,68200,10.285132382892057
"Mildred city, Kansas",14,4,10,20,46500,71.42857142857143
"La Cygne city, Kansas",594,483,111,20,37575,18.68686868686869
"Macksville city, Kansas",225,182,43,20,43850,19.11111111111111
"Linn Valley city, Kansas",553,356,197,20,41465,35.62386980108499
"Cunningham city, Kansas",204,166,38,20,16775,18.627450980392158
"Stafford city, Kansas",656,474,182,20,67775,27.743902439024392
"Winona city, Kansas",114,85,29,20,80075,25.438596491228072
"Circleville city, Kansas",102,84,18,20,13375,17.647058823529413
"Rexford city, Kansas",85,72,13,20,59125,15.294117647058824
"Gorham city, Kansas",180,157,23,20,27000,12.777777777777777
"Osborne city, Kansas",868,698,170,20,53325,19.5852534562212
"Milford city, Kansas",226,126,100,20,46525,44.24778761061947
"Denison city, Kansas",79,57,22,20,17625,27.848101265822784
"Zenda city, Kansas",64,40,24,20,80925,37.5
"Meade city, Kansas",732,639,93,20,45325,12.704918032786885
"Alta Vista city, Kansas",266,237,29,20,01575,10.902255639097744
"Kingman city, Kansas",1617,1327,290,20,36950,17.934446505875076
"Penalosa city, Kansas",8,1,7,20,55225,87.5
"Kismet city, Kansas",202,170,32,20,37325,15.841584158415841
"Norwich city, Kansas",194,178,16,20,51600,8.24742268041237
"Russell Springs city, Kansas",22,14,8,20,61875,36.36363636363637
"Nashville city, Kansas",50,17,33,20,49400,66.0
"Donahue city, Iowa",152,143,9,19,21720,5.921052631578947
"Emerson city, Iowa",235,197,38,19,25500,16.170212765957448
"Martelle city, Iowa",137,117,20,19,49845,14.5985401459854
"Onslow city, Iowa",106,88,18,19,59250,16.9811320754717
"Livermore city, Iowa",187,155,32,19,45975,17.11229946524064
"Grafton city, Iowa",110,104,6,19,31890,5.454545454545454
"Hawkeye city, Iowa",206,187,19,19,35310,9.223300970873787
"Oelwein city, Iowa",3030,2657,373,19,58620,12.31023102310231
"Westgate city, Iowa",104,95,9,19,84180,8.653846153846153
"Oakland Acres city, Iowa",57,57,0,19,58170,0.0
"Prairie City city, Iowa",863,808,55,19,64470,6.373117033603708
"Oskaloosa city, Iowa",5421,4812,609,19,59925,11.234089651355838
"Minden city, Iowa",247,233,14,19,52590,5.668016194331984
"Shelby city, Iowa",305,282,23,19,72300,7.540983606557377
"Leighton city, Iowa",77,77,0,19,44310,0.0
"Chelsea city, Iowa",106,87,19,19,12990,17.92452830188679
"Montour city, Iowa",151,121,30,19,53670,19.867549668874172
"Harlan city, Iowa",2560,2258,302,19,34500,11.796875
"Avoca city, Iowa",687,630,57,19,03970,8.296943231441048
"Crescent city, Iowa",234,221,13,19,17175,5.555555555555555
"Barnes City city, Iowa",101,89,12,19,04555,11.881188118811881
"Durango city, Iowa",6,3,3,19,22935,50.0
"Farley city, Iowa",682,672,10,19,26760,1.466275659824047
"Peosta city, Iowa",562,549,13,19,62130,2.3131672597864767
"Leland city, Iowa",117,113,4,19,44355,3.418803418803419
"Thompson city, Iowa",262,218,44,19,77745,16.793893129770993
"Fort Atkinson city, Iowa",163,143,20,19,28425,12.269938650306749
"Jackson Junction city, Iowa",12,12,0,19,39135,0.0
"Balltown city, Iowa",28,28,0,19,04375,0.0
"Rockwell city, Iowa",432,390,42,19,68250,9.722222222222223
"Edgewood city, Iowa",358,309,49,19,24060,13.687150837988826
"Williamson city, Iowa",66,52,14,19,85935,21.21212121212121
"Onawa city, Iowa",1457,1319,138,19,59115,9.471516815374056
"Swaledale city, Iowa",65,54,11,19,76620,16.923076923076923
"Ralston city, Iowa",45,39,6,19,65505,13.333333333333334
"Scranton city, Iowa",303,264,39,19,71310,12.871287128712872
"Buckeye city, Iowa",39,39,0,19,09100,0.0
"Lone Rock city, Iowa",80,69,11,19,46290,13.750000000000002
"Tama city, Iowa",1129,996,133,19,77115,11.780336581045173
"Hornick city, Iowa",109,102,7,19,37200,6.422018348623854
"Stuart city, Iowa",762,657,105,19,75990,13.779527559055119
"Yale city, Iowa",134,115,19,19,87285,14.17910447761194
"Hillsboro city, Iowa",108,76,32,19,36390,29.629629629629626
"Salem city, Iowa",230,205,25,19,70230,10.869565217391305
"Central City city, Iowa",585,546,39,19,12495,6.666666666666667
"Prairieburg city, Iowa",109,92,17,19,64425,15.59633027522936
"Birmingham city, Iowa",253,231,22,19,06625,8.695652173913043
"Milton city, Iowa",212,166,46,19,52500,21.69811320754717
"Kingsley city, Iowa",665,606,59,19,41385,8.87218045112782
"Merrill city, Iowa",345,341,4,19,51375,1.1594202898550725
"Sloan city, Iowa",442,423,19,19,73605,4.298642533936651
"Lawton city, Iowa",403,379,24,19,43905,5.955334987593052
"Stockton city, Iowa",77,62,15,19,75450,19.480519480519483
"Oto city, Iowa",66,48,18,19,60240,27.27272727272727
"Walker city, Iowa",308,301,7,19,81885,2.272727272727273
"Fruitland city, Iowa",362,356,6,19,29280,1.6574585635359116
"Douds CDP, Iowa",49,49,0,19,22035,0.0
"Rodney city, Iowa",28,28,0,19,68385,0.0
"Rose Hill city, Iowa",85,68,17,19,68700,20.0
"Bernard city, Iowa",66,62,4,19,06085,6.0606060606060606
"Centralia city, Iowa",57,57,0,19,12630,0.0
"Rickardsville city, Iowa",66,66,0,19,66810,0.0
"Worthington city, Iowa",180,174,6,19,87060,3.3333333333333335
"Denver city, Iowa",720,687,33,19,20035,4.583333333333333
"Adel city, Iowa",1730,1718,12,19,00505,0.6936416184971098
"Fontana city, Kansas",110,98,12,20,23650,10.909090909090908
"Osawatomie city, Kansas",1856,1605,251,20,53225,13.523706896551724
"Spring Hill city, Kansas",2162,2084,78,20,67625,3.6077705827937097
"Speed city, Kansas",31,17,14,20,67175,45.16129032258064
"Rose Hill city, Kansas",1473,1415,58,20,61250,3.9375424304141213
"Ellsworth city, Kansas",1144,1024,120,20,20500,10.48951048951049
"Neosho Rapids city, Kansas",115,97,18,20,49875,15.65217391304348
"Lenora city, Kansas",216,145,71,20,39400,32.870370370370374
"Hays city, Kansas",9644,8415,1229,20,31100,12.743674823724596
"Fort Scott city, Kansas",3962,3200,762,20,24000,19.232710752145383
"Fulton city, Kansas",77,41,36,20,24925,46.75324675324675
"Cimarron city, Kansas",864,788,76,20,13275,8.796296296296296
"Oskaloosa city, Kansas",638,553,85,20,53375,13.322884012539186
"Vermillion city, Kansas",57,40,17,20,73525,29.82456140350877
"Clyde city, Kansas",418,347,71,20,14475,16.985645933014354
"Eureka city, Kansas",1389,1060,329,20,21800,23.686105111591072
"Hamilton city, Kansas",156,125,31,20,29675,19.871794871794872
"Burlingame city, Kansas",508,428,80,20,09350,15.748031496062993
"Russell city, Kansas",2348,1903,445,20,61825,18.95229982964225
"Tescott city, Kansas",148,132,16,20,70250,10.81081081081081
"Severy city, Kansas",161,111,50,20,64050,31.05590062111801
"Liebenthal city, Kansas",90,67,23,20,40400,25.555555555555554
"Hugoton city, Kansas",1522,1336,186,20,33425,12.220762155059132
"Baldwin City city, Kansas",1694,1628,66,20,03900,3.896103896103896
"Lecompton city, Kansas",246,235,11,20,39150,4.471544715447155
"Green city, Kansas",84,64,20,20,28425,23.809523809523807
"Burns city, Kansas",126,107,19,20,09450,15.079365079365079
"Allen city, Kansas",99,80,19,20,01275,19.19191919191919
"Savonburg city, Kansas",51,23,28,20,63200,54.90196078431373
"Belpre city, Kansas",73,44,29,20,05825,39.726027397260275
"Offerle city, Kansas",105,90,15,20,52200,14.285714285714285
"Ransom city, Kansas",198,164,34,20,58500,17.17171717171717
"Manhattan city, Kansas",23440,20439,3001,20,44250,12.802901023890783
"Riley city, Kansas",591,539,52,20,59875,8.79864636209814
"Portis city, Kansas",66,36,30,20,57100,45.45454545454545
"Reserve city, Kansas",51,33,18,20,59050,35.294117647058826
"Hiawatha city, Kansas",1605,1316,289,20,31675,18.006230529595015
"Nickerson city, Kansas",467,411,56,20,50525,11.991434689507495
"Chapman city, Kansas",569,509,60,20,12550,10.54481546572935
"Labette city, Kansas",29,22,7,20,37375,24.137931034482758
"Bird City city, Kansas",312,237,75,20,06825,24.03846153846154
"Andover city, Kansas",4789,4433,356,20,01800,7.433702234286907
"Elbing city, Kansas",108,106,2,20,20050,1.8518518518518516
"Barnard city, Kansas",74,27,47,20,04225,63.51351351351351
"Harveyville city, Kansas",123,102,21,20,30575,17.073170731707318
"Oberlin city, Kansas",1032,862,170,20,52000,16.472868217054263
"Plains city, Kansas",454,400,54,20,56100,11.894273127753303
"Galesburg city, Kansas",60,51,9,20,25150,15.0
"Ford city, Kansas",135,110,25,20,23725,18.51851851851852
"Louisburg city, Kansas",1780,1645,135,20,42875,7.584269662921349
"Willard city, Kansas",42,41,1,20,79250,2.380952380952381
"Parkerfield city, Kansas",159,147,12,20,54560,7.547169811320755
"LeRoy city, Kansas",302,286,16,20,39650,5.298013245033113
"Ada CDP, Kansas",55,55,0,20,00225,0.0
"Asherville CDP, Kansas",0,0,0,20,02600,
"Baileyville CDP, Kansas",118,118,0,20,03675,0.0
"Parkerville city, Kansas",30,18,12,20,54575,40.0
"Chetopa city, Kansas",663,526,137,20,12950,20.66365007541478
"Oswego city, Kansas",849,720,129,20,53450,15.19434628975265
"Shawnee city, Kansas",25587,24510,1077,20,64500,4.209168718489858
"Westwood city, Kansas",751,684,67,20,77500,8.921438082556591
"Westwood Hills city, Kansas",182,170,12,20,77525,6.593406593406594
"Cheney city, Kansas",753,714,39,20,12775,5.179282868525896
"Dawson city, Iowa",71,53,18,19,19135,25.352112676056336
"Underwood city, Iowa",359,335,24,19,79500,6.685236768802229
"Beacon city, Iowa",254,241,13,19,05050,5.118110236220472
"Fairfax city, Iowa",958,937,21,19,26400,2.1920668058455117
"Lisbon city, Iowa",915,863,52,19,45615,5.683060109289618
"Renwick city, Iowa",142,124,18,19,66450,12.676056338028168
"Rutland city, Iowa",102,71,31,19,69375,30.392156862745097
"Thor city, Iowa",87,69,18,19,77790,20.689655172413794
"Monticello city, Iowa",1790,1688,102,19,53625,5.698324022346369
"Joice city, Iowa",105,95,10,19,39855,9.523809523809524
"St. Lucas city, Iowa",77,60,17,19,70050,22.07792207792208
"West Union city, Iowa",1284,1124,160,19,84765,12.461059190031152
"Baxter city, Iowa",466,437,29,19,04915,6.223175965665236
"Dows city, Iowa",306,259,47,19,22305,15.359477124183007
"Greenfield city, Iowa",1025,843,182,19,32790,17.756097560975608
"Stratford city, Iowa",320,258,62,19,75810,19.375
"Coalville CDP, Iowa",322,279,43,19,14835,13.354037267080745
"Farnhamville city, Iowa",212,187,25,19,26940,11.79245283018868
"Callender city, Iowa",199,189,10,19,09955,5.025125628140704
"Harcourt city, Iowa",148,125,23,19,34410,15.54054054054054
"Otho city, Iowa",271,241,30,19,60105,11.07011070110701
"Estherville city, Iowa",2719,2361,358,19,25860,13.166605369621184
"Gruver city, Iowa",30,29,1,19,33240,3.3333333333333335
"Ladora city, Iowa",140,116,24,19,42330,17.142857142857142
"Williamsburg city, Iowa",1422,1405,17,19,85845,1.1954992967651195
"West Burlington city, Iowa",1385,1248,137,19,83685,9.891696750902527
"Dike city, Iowa",578,540,38,19,21405,6.5743944636678195
"Dunlap city, Iowa",484,443,41,19,22890,8.47107438016529
"Little Sioux city, Iowa",102,69,33,19,45840,32.35294117647059
"Montrose city, Iowa",366,324,42,19,53760,11.475409836065573
"Coburg city, Iowa",11,11,0,19,14880,0.0
"Creston city, Iowa",3793,3299,494,19,17265,13.023991563406275
"Brayton city, Iowa",71,62,9,19,08200,12.676056338028168
"Gray city, Iowa",58,39,19,19,32565,32.758620689655174
"Aspinwall city, Iowa",9,9,0,19,03340,0.0
"Denison city, Iowa",2847,2693,154,19,19945,5.409202669476642
"Manilla city, Iowa",373,357,16,19,48855,4.289544235924933
"Alexander city, Iowa",71,61,10,19,01090,14.084507042253522
"Wyoming city, Iowa",233,200,33,19,87240,14.163090128755366
"Alvord city, Iowa",101,96,5,19,01675,4.9504950495049505
"Little Rock city, Iowa",232,206,26,19,45795,11.206896551724139
"Fonda city, Iowa",309,236,73,19,28245,23.624595469255663
"Clarence city, Iowa",468,427,41,19,13530,8.76068376068376
"Gilmore City city, Iowa",257,221,36,19,30945,14.007782101167315
"Palmer city, Iowa",106,90,16,19,61050,15.09433962264151
"Pocahontas city, Iowa",953,855,98,19,63975,10.283315844700944
"Decatur City city, Iowa",110,86,24,19,19360,21.818181818181817
"Weldon city, Iowa",106,90,16,19,83190,15.09433962264151
"Numa city, Iowa",44,33,11,19,57945,25.0
"Beaver city, Iowa",22,19,3,19,05185,13.636363636363635
"Fraser city, Iowa",58,53,5,19,28920,8.620689655172415
"Paullina city, Iowa",542,471,71,19,61905,13.099630996309964
"Sanborn city, Iowa",644,613,31,19,70410,4.813664596273292
"Kirkville city, Iowa",87,79,8,19,41565,9.195402298850574
"Baldwin city, Iowa",59,56,3,19,04330,5.084745762711865
"Newhall city, Iowa",420,393,27,19,56055,6.428571428571428
"Milo city, Iowa",334,314,20,19,52455,5.9880239520958085
"Hartford city, Iowa",299,270,29,19,34680,9.698996655518394
"Lake Mills city, Iowa",1076,985,91,19,42555,8.45724907063197
"Belle Plaine city, Iowa",1204,1055,149,19,05590,12.375415282392026
"Blairstown city, Iowa",314,292,22,19,06805,7.006369426751593
"Lohrville city, Iowa",200,162,38,19,46245,19.0
"Rinard city, Iowa",24,23,1,19,67125,4.166666666666666
"Cherokee city, Iowa",2427,2299,128,19,13080,5.274000824062629
"Arthur city, Iowa",133,117,16,19,03115,12.030075187969924
"Linn city, Kansas",190,170,20,20,41425,10.526315789473683
"Cherryvale city, Kansas",1054,872,182,20,12925,17.267552182163186
"Elk City city, Kansas",169,121,48,20,20250,28.402366863905325
"Cullison city, Kansas",22,21,1,20,16675,4.545454545454546
"Pratt city, Kansas",3133,2653,480,20,57625,15.320778806255985
"Richfield city, Kansas",25,13,12,20,59200,48.0
"Rolla city, Kansas",237,203,34,20,60900,14.345991561181433
"Jewell city, Kansas",311,233,78,20,35475,25.080385852090032
"Inman city, Kansas",632,553,79,20,34275,12.5
"Clearwater city, Kansas",977,928,49,20,13925,5.015353121801433
"Leavenworth city, Kansas",13900,12440,1460,20,39000,10.503597122302159
"Linwood city, Kansas",190,180,10,20,41475,5.263157894736842
"Bern city, Kansas",98,72,26,20,06275,26.53061224489796
"Corning city, Kansas",80,75,5,20,15725,6.25
"Goff city, Kansas",66,53,13,20,26775,19.696969696969695
"Oneida city, Kansas",52,46,6,20,52900,11.538461538461538
"Munden city, Kansas",81,54,27,20,49150,33.33333333333333
"Vining city, Kansas",37,32,5,20,73950,13.513513513513514
"Washington city, Kansas",575,474,101,20,75825,17.565217391304348
"Coffeyville city, Kansas",4901,3927,974,20,14600,19.873495205060195
"Sawyer city, Kansas",86,59,27,20,63275,31.3953488372093
"Oak Hill city, Kansas",30,23,7,20,51700,23.333333333333332
"Randall city, Kansas",60,32,28,20,58450,46.666666666666664
"Florence city, Kansas",317,225,92,20,23600,29.02208201892745
"Marion city, Kansas",989,806,183,20,44750,18.503538928210315
"Burr Oak city, Kansas",160,97,63,20,09525,39.375
"Assaria city, Kansas",190,165,25,20,02850,13.157894736842104
"Brookville city, Kansas",118,109,9,20,08575,7.627118644067797
"White City city, Kansas",297,241,56,20,77825,18.855218855218855
"Wilsey city, Kansas",78,64,14,20,79650,17.94871794871795
"Kinsley city, Kansas",856,717,139,20,37075,16.238317757009348
"Morganville city, Kansas",92,84,8,20,48225,8.695652173913043
"Wakefield city, Kansas",485,416,69,20,74525,14.22680412371134
"Durham city, Kansas",56,46,10,20,19050,17.857142857142858
"Lincolnville city, Kansas",138,88,50,20,41325,36.231884057971016
"Arkansas City city, Kansas",5611,4636,975,20,02300,17.376581714489394
"Rossville city, Kansas",429,412,17,20,61400,3.9627039627039626
"Cambridge city, Kansas",69,51,18,20,10125,26.08695652173913
"Minneapolis city, Kansas",879,771,108,20,47075,12.286689419795222
"Roseland city, Kansas",43,33,10,20,61275,23.25581395348837
"Enterprise city, Kansas",390,360,30,20,21425,7.6923076923076925
"Delphos city, Kansas",232,158,74,20,17600,31.896551724137932
"Concordia city, Kansas",2575,2173,402,20,15200,15.611650485436893
"Madison city, Kansas",481,366,115,20,44050,23.90852390852391
"Sharon Springs city, Kansas",441,355,86,20,64375,19.501133786848072
"Atlanta city, Kansas",128,89,39,20,03050,30.46875
"Freeport city, Kansas",3,0,3,20,24725,100.0
"Waldron city, Kansas",20,11,9,20,74625,45.0
"Hillsboro city, Kansas",1270,1073,197,20,32275,15.511811023622046
"La Crosse city, Kansas",685,546,139,20,37500,20.29197080291971
"Otis city, Kansas",179,126,53,20,53525,29.608938547486037
"Olivet city, Kansas",34,26,8,20,52700,23.52941176470588
"Quenemo city, Kansas",175,148,27,20,58100,15.428571428571427
"Lenexa city, Kansas",22565,21338,1227,20,39350,5.437624639929093
"Leoti city, Kansas",703,603,100,20,39550,14.224751066856332
"McDonald city, Kansas",102,87,15,20,43750,14.705882352941178
"Richmond city, Kansas",207,205,2,20,59675,0.966183574879227
"Lansing city, Kansas",3556,3290,266,20,38650,7.480314960629922
"Derby city, Kansas",9481,9024,457,20,17800,4.820166649087649
"Maize city, Kansas",1547,1547,0,20,44200,0.0
"Burrton city, Kansas",366,316,50,20,09575,13.661202185792352
"Yates Center city, Kansas",830,642,188,20,80700,22.650602409638555
"Agenda city, Kansas",50,22,28,20,00475,56.00000000000001
"Aurora city, Iowa",92,82,10,19,03835,10.869565217391305
"Lamont city, Iowa",236,213,23,19,43005,9.745762711864407
"Ackley city, Iowa",859,779,80,19,00190,9.31315483119907
"Radcliffe city, Iowa",286,251,35,19,65370,12.237762237762238
"Algona city, Iowa",2831,2573,258,19,01135,9.113387495584599
"Whittemore city, Iowa",262,233,29,19,85260,11.068702290076336
"Clutier city, Iowa",141,105,36,19,14655,25.53191489361702
"Toledo city, Iowa",1039,893,146,19,78510,14.051973051010588
"Albert City city, Iowa",300,268,32,19,00865,10.666666666666668
"Alta city, Iowa",908,834,74,19,01495,8.149779735682818
"North Buena Vista city, Iowa",126,48,78,19,57135,61.904761904761905
"St. Olaf city, Iowa",55,47,8,19,70140,14.545454545454545
"Cresco city, Iowa",1787,1634,153,19,17220,8.561835478455512
"Columbus City city, Iowa",159,144,15,19,15375,9.433962264150944
"Calumet city, Iowa",78,74,4,19,10090,5.128205128205128
"Sutherland city, Iowa",349,304,45,19,76485,12.893982808022923
"Treynor city, Iowa",379,366,13,19,78825,3.430079155672823
"Chatsworth city, Iowa",41,33,8,19,12945,19.51219512195122
"Hull city, Iowa",808,768,40,19,37515,4.9504950495049505
"Maurice city, Iowa",118,114,4,19,50430,3.389830508474576
"Council Bluffs city, Iowa",26866,24816,2050,19,16860,7.630462294349735
"Coulter city, Iowa",108,88,20,19,16815,18.51851851851852
"Popejoy city, Iowa",35,18,17,19,64110,48.57142857142857
"Iowa City city, Iowa",32340,29975,2365,19,38595,7.312925170068027
"Swisher city, Iowa",363,349,14,19,76890,3.8567493112947657
"Harvey city, Iowa",88,66,22,19,34860,25.0
"Seymour city, Iowa",367,280,87,19,71760,23.705722070844686
"Lenox city, Iowa",728,648,80,19,44490,10.989010989010989
"Burlington city, Iowa",12149,10948,1201,19,09550,9.885587291135073
"Morrison city, Iowa",57,54,3,19,54165,5.263157894736842
"Stout city, Iowa",77,70,7,19,75720,9.090909090909092
"Mondamin city, Iowa",197,146,51,19,53175,25.888324873096447
"Lansing city, Iowa",544,374,170,19,43275,31.25
"St. Paul city, Iowa",43,39,4,19,70185,9.30232558139535
"Stanton city, Iowa",278,246,32,19,75000,11.510791366906476
"Arispe city, Iowa",57,54,3,19,02800,5.263157894736842
"New Albin city, Iowa",281,269,12,19,55785,4.270462633451958
"Bedford city, Iowa",763,657,106,19,05365,13.892529488859765
"Blockton city, Iowa",110,76,34,19,06985,30.909090909090907
"Conway city, Iowa",28,11,17,19,15960,60.71428571428571
"Kiron city, Iowa",151,126,25,19,41610,16.55629139072848
"Westside city, Iowa",168,168,0,19,84630,0.0
"Sheffield city, Iowa",487,458,29,19,72210,5.95482546201232
"Coralville city, Iowa",8804,7976,828,19,16230,9.404815992730576
"Tiffin city, Iowa",1298,1190,108,19,78060,8.320493066255779
"University Heights city, Iowa",541,530,11,19,79770,2.033271719038817
"Knoxville city, Iowa",3586,3248,338,19,42015,9.425543781372001
"Pleasantville city, Iowa",816,754,62,19,63750,7.598039215686274
"Conrad city, Iowa",532,472,60,19,15825,11.278195488721805
"Wellsburg city, Iowa",397,343,54,19,83325,13.602015113350127
"Missouri Valley city, Iowa",1330,1222,108,19,52860,8.1203007518797
"Woodbine city, Iowa",738,668,70,19,86835,9.48509485094851
"Park View CDP, Iowa",844,787,57,19,61725,6.753554502369669
"Hartwick city, Iowa",57,45,12,19,34770,21.052631578947366
"Moorhead city, Iowa",124,109,15,19,53850,12.096774193548388
"Lovilia city, Iowa",273,267,6,19,46830,2.197802197802198
"Plymouth city, Iowa",171,155,16,19,63885,9.35672514619883
"Moville city, Iowa",735,684,51,19,54930,6.938775510204081
"Farmington city, Iowa",408,330,78,19,26895,19.11764705882353
"Keosauqua city, Iowa",510,443,67,19,40935,13.137254901960786
"Oyens city, Iowa",41,41,0,19,60780,0.0
"Sergeant Bluff city, Iowa",1796,1779,17,19,71625,0.9465478841870825
"Hinton city, Iowa",360,342,18,19,36480,5.0
"Smithland city, Iowa",94,73,21,19,73650,22.340425531914892
"Hollenberg city, Kansas",19,14,5,20,32650,26.31578947368421
"Dearing city, Kansas",248,227,21,20,17150,8.46774193548387
"Tyro city, Kansas",111,80,31,20,71925,27.927927927927925
"Byers city, Kansas",15,15,0,20,09800,0.0
"Columbus city, Kansas",1656,1286,370,20,15075,22.342995169082126
"Scammon city, Kansas",281,214,67,20,63325,23.843416370106763
"Mapleton city, Kansas",47,34,13,20,44550,27.659574468085108
"Humboldt city, Kansas",891,750,141,20,33450,15.824915824915825
"Edmond city, Kansas",50,39,11,20,19875,22.0
"Damar city, Kansas",92,70,22,20,16975,23.91304347826087
"Jetmore city, Kansas",480,350,130,20,35450,27.083333333333332
"Mound City city, Kansas",519,461,58,20,48750,11.175337186897881
"Manter city, Kansas",137,94,43,20,44375,31.386861313868614
"Oakley city, Kansas",1075,836,239,20,51825,22.232558139534884
"Hill City city, Kansas",797,716,81,20,32175,10.163111668757843
"Morland city, Kansas",105,79,26,20,48275,24.761904761904763
"Erie city, Kansas",546,465,81,20,21500,14.835164835164836
"Alden city, Kansas",66,43,23,20,00950,34.84848484848485
"Herington city, Kansas",1387,965,422,20,31400,30.4253785147801
"Leawood city, Kansas",13590,12953,637,20,39075,4.687270051508462
"Roeland Park city, Kansas",3302,3080,222,20,60825,6.723198061780739
"Dwight city, Kansas",119,83,36,20,19125,30.252100840336134
"Atwood city, Kansas",635,540,95,20,03150,14.960629921259844
"Andale city, Kansas",308,273,35,20,01775,11.363636363636363
"Muscotah city, Kansas",96,75,21,20,49325,21.875
"Glasco city, Kansas",282,214,68,20,26375,24.113475177304963
"Climax city, Kansas",46,17,29,20,14275,63.04347826086957
"Attica city, Kansas",347,275,72,20,03100,20.7492795389049
"Virgil city, Kansas",43,25,18,20,74075,41.86046511627907
"Belvue city, Kansas",92,84,8,20,05925,8.695652173913043
"St. Marys city, Kansas",834,784,50,20,62400,5.995203836930456
"Easton city, Kansas",111,84,27,20,19600,24.324324324324326
"Smith Center city, Kansas",916,740,176,20,65925,19.213973799126638
"Belleville city, Kansas",1142,927,215,20,05600,18.82661996497373
"Courtland city, Kansas",192,157,35,20,16025,18.229166666666664
"Narka city, Kansas",74,68,6,20,49350,8.108108108108109
"Grandview Plaza city, Kansas",912,659,253,20,27425,27.74122807017544
"Turon city, Kansas",250,146,104,20,71800,41.6
"Lindsborg city, Kansas",1376,1302,74,20,41375,5.377906976744186
"Colony city, Kansas",219,191,28,20,14950,12.785388127853881
"Lone Elm city, Kansas",8,8,0,20,42425,0.0
"Protection city, Kansas",233,144,89,20,57850,38.197424892703864
"Englewood city, Kansas",47,32,15,20,21350,31.914893617021278
"West Mineral city, Kansas",76,52,24,20,77150,31.57894736842105
"Haven city, Kansas",501,454,47,20,30725,9.3812375249501
"Willowbrook city, Kansas",38,38,0,20,79425,0.0
"Smolan city, Kansas",94,83,11,20,66100,11.702127659574469
"Solomon city, Kansas",458,397,61,20,66275,13.318777292576419
"Galva city, Kansas",492,464,28,20,25200,5.691056910569105
"McPherson city, Kansas",5996,5647,349,20,43950,5.820547031354236
"Frontenac city, Kansas",1477,1375,102,20,24850,6.9058903182125935
"Colwich city, Kansas",453,436,17,20,15100,3.7527593818984544
"Kechi city, Kansas",957,906,51,20,36225,5.329153605015674
"Oaklawn-Sunview CDP, Kansas",1365,1150,215,20,51810,15.75091575091575
"Garnett city, Kansas",1807,1470,337,20,25925,18.649695628112894
"Kincaid city, Kansas",84,40,44,20,36875,52.38095238095239
"Westphalia city, Kansas",66,56,10,20,77250,15.151515151515152
"Coldwater city, Kansas",420,349,71,20,14700,16.904761904761905
"Moline city, Kansas",249,158,91,20,47600,36.54618473895582
"Weir city, Kansas",318,258,60,20,76350,18.867924528301888
"Greensburg city, Kansas",464,387,77,20,28675,16.594827586206897
"Buhler city, Kansas",546,481,65,20,09200,11.904761904761903
"Hutchinson city, Kansas",18779,16415,2364,20,33625,12.588529740667767
"Conesville city, Iowa",174,151,23,19,15645,13.218390804597702
"Akron city, Iowa",748,626,122,19,00775,16.31016042780749
"Craig city, Iowa",36,26,10,19,16950,27.77777777777778
"Struble city, Iowa",40,36,4,19,75945,10.0
"Anthon city, Iowa",302,281,21,19,02350,6.95364238410596
"Bronson city, Iowa",113,103,10,19,08650,8.849557522123893
"Lake View city, Iowa",906,535,371,19,42690,40.94922737306843
"Lytton city, Iowa",145,130,15,19,47730,10.344827586206897
"Gilbertville city, Iowa",388,360,28,19,30675,7.216494845360824
"Cleghorn city, Iowa",108,96,12,19,14115,11.11111111111111
"Larrabee city, Iowa",88,86,2,19,43500,2.272727272727273
"Washta city, Iowa",115,88,27,19,82380,23.47826086956522
"Hazleton city, Iowa",423,321,102,19,35580,24.113475177304963
"Independence city, Iowa",2906,2526,380,19,38100,13.07639366827254
"Quasqueton city, Iowa",278,220,58,19,65235,20.863309352517987
"Ottumwa city, Iowa",11116,9925,1191,19,60465,10.714285714285714
"Osage city, Iowa",1832,1649,183,19,59745,9.989082969432314
"Altoona city, Iowa",6810,6448,362,19,01630,5.3157121879588844
"Johnston city, Iowa",8542,8151,391,19,39765,4.577382346054788
"Dunkerton city, Iowa",340,313,27,19,22845,7.941176470588235
"Raymond city, Iowa",293,284,9,19,65820,3.0716723549488054
"Meriden city, Iowa",76,73,3,19,51150,3.9473684210526314
"Springbrook city, Iowa",60,50,10,19,74505,16.666666666666664
"Sandyville city, Iowa",22,22,0,19,70590,0.0
"Russell city, Iowa",262,236,26,19,69285,9.923664122137405
"Ackworth city, Iowa",66,66,0,19,00235,0.0
"Norwalk city, Iowa",4192,4130,62,19,57675,1.4790076335877862
"Spring Hill city, Iowa",28,22,6,19,74685,21.428571428571427
"Boyden city, Iowa",327,324,3,19,07840,0.9174311926605505
"Lucas city, Iowa",95,78,17,19,47100,17.894736842105264
"Doon city, Iowa",298,298,0,19,21900,0.0
"Miles city, Iowa",214,190,24,19,52050,11.214953271028037
"Monmouth city, Iowa",69,69,0,19,53265,0.0
"Ashton city, Iowa",228,210,18,19,03295,7.894736842105263
"Storm Lake city, Iowa",3817,3544,273,19,75630,7.152213780455856
"Bankston city, Iowa",10,10,0,19,04510,0.0
"Dyersville city, Iowa",1938,1852,86,19,23115,4.437564499484004
"Sageville city, Iowa",32,26,6,19,69690,18.75
"Truesdale city, Iowa",54,50,4,19,79095,7.4074074074074066
"Monona city, Iowa",808,747,61,19,53310,7.5495049504950495
"Volga city, Iowa",99,84,15,19,81345,15.151515151515152
"Dedham city, Iowa",110,97,13,19,19450,11.818181818181818
"Floris city, Iowa",65,63,2,19,27975,3.076923076923077
"Wiota city, Iowa",53,42,11,19,86610,20.754716981132077
"Dumont city, Iowa",315,266,49,19,22620,15.555555555555555
"Readlyn city, Iowa",314,291,23,19,65910,7.32484076433121
"Linden city, Iowa",84,79,5,19,45390,5.952380952380952
"Redfield city, Iowa",326,285,41,19,66045,12.576687116564417
"Garrison city, Iowa",207,170,37,19,30000,17.874396135265698
"Harris city, Iowa",88,65,23,19,34635,26.136363636363637
"Forest City city, Iowa",1858,1632,226,19,28380,12.16361679224973
"Ossian city, Iowa",430,408,22,19,59970,5.116279069767442
"Nemaha city, Iowa",51,51,0,19,55515,0.0
"Cedar Falls city, Iowa",16338,15144,1194,19,11755,7.308116048475946
"Correctionville city, Iowa",411,333,78,19,16545,18.97810218978102
"Sioux City city, Iowa",33717,31244,2473,19,73335,7.3345789957588154
"Dallas Center city, Iowa",685,652,33,19,18255,4.817518248175182
"Chillicothe city, Iowa",49,40,9,19,13215,18.367346938775512
"Fremont city, Iowa",312,287,25,19,29190,8.012820512820513
"Webb city, Iowa",73,63,10,19,83010,13.698630136986301
"Boone city, Iowa",5827,5322,505,19,07480,8.666552256735885
"Terril city, Iowa",185,164,21,19,77520,11.351351351351353
"Bertram city, Iowa",131,124,7,19,06175,5.343511450381679
"Nichols city, Iowa",160,140,20,19,56685,12.5
"Northboro city, Iowa",41,39,2,19,57045,4.878048780487805
"Pomona city, Kansas",488,444,44,20,57000,9.01639344262295
"Princeton city, Kansas",110,97,13,20,57725,11.818181818181818
"Independence city, Kansas",4698,3794,904,20,33875,19.24223073648361
"Elkhart city, Kansas",912,702,210,20,20350,23.026315789473685
"Esbon city, Kansas",100,71,29,20,21600,28.999999999999996
"Mankato city, Kansas",517,377,140,20,44300,27.079303675048354
"Langdon city, Kansas",26,13,13,20,38500,50.0
"Haysville city, Kansas",4480,4139,341,20,31125,7.611607142857142
"Sedgwick city, Kansas",624,550,74,20,63800,11.858974358974358
"Valley Center city, Kansas",2801,2498,303,20,73250,10.81756515530168
"Viola city, Kansas",53,38,15,20,74025,28.30188679245283
"Wichita city, Kansas",171175,152260,18915,20,79000,11.050094932087045
"Beverly city, Kansas",86,54,32,20,06500,37.2093023255814
"St. John city, Kansas",680,560,120,20,62275,17.647058823529413
"Geneseo city, Kansas",162,117,45,20,26075,27.77777777777778
"Parker city, Kansas",183,151,32,20,54500,17.48633879781421
"Bazine city, Kansas",189,139,50,20,04775,26.455026455026452
"Wilson city, Kansas",382,289,93,20,79675,24.345549738219894
"New Strawn city, Kansas",175,165,10,20,50450,5.714285714285714
"Towanda city, Kansas",496,446,50,20,71125,10.080645161290322
"Whitewater city, Kansas",298,254,44,20,78050,14.76510067114094
"Phillipsburg city, Kansas",1361,1138,223,20,55675,16.385011021307864
"Alma city, Kansas",490,425,65,20,01350,13.26530612244898
"Paola city, Kansas",2296,2241,55,20,54250,2.3954703832752613
"Kiowa city, Kansas",558,378,180,20,37125,32.25806451612903
"Sharon city, Kansas",81,77,4,20,64325,4.938271604938271
"Burlington city, Kansas",1286,1076,210,20,09400,16.329704510108865
"Hanston city, Kansas",113,100,13,20,29925,11.504424778761061
"Johnson City city, Kansas",674,520,154,20,35600,22.8486646884273
"Leonardville city, Kansas",235,196,39,20,39500,16.595744680851062
"Holyrood city, Kansas",286,221,65,20,32850,22.727272727272727
"Kanopolis city, Kansas",279,244,35,20,35950,12.544802867383511
"WaKeeney city, Kansas",1139,993,146,20,74450,12.818261633011414
"Eskridge city, Kansas",281,220,61,20,21650,21.70818505338078
"McFarland city, Kansas",137,129,8,20,43775,5.839416058394161
"Bogue city, Kansas",155,125,30,20,07825,19.35483870967742
"Hudson city, Kansas",59,50,9,20,33400,15.254237288135593
"Chanute city, Kansas",4452,3784,668,20,12500,15.00449236298293
"Lyons city, Kansas",1711,1440,271,20,43525,15.838690824079485
"Hazelton city, Kansas",86,63,23,20,31150,26.744186046511626
"Isabel city, Kansas",60,36,24,20,34550,40.0
"Spivey city, Kansas",31,20,11,20,67250,35.483870967741936
"Ness City city, Kansas",750,630,120,20,49925,16.0
"Ogden city, Kansas",986,730,256,20,52275,25.963488843813387
"Randolph city, Kansas",60,60,0,20,58475,0.0
"Maple Hill city, Kansas",233,212,21,20,44500,9.012875536480687
"Glade city, Kansas",30,9,21,20,26325,70.0
"Kirwin city, Kansas",189,74,115,20,37275,60.84656084656085
"Augusta city, Kansas",3940,3518,422,20,03300,10.710659898477157
"Cassoday city, Kansas",72,63,9,20,10925,12.5
"Potwin city, Kansas",209,176,33,20,57300,15.789473684210526
"Lorraine city, Kansas",83,67,16,20,42800,19.27710843373494
"Rozel city, Kansas",87,59,28,20,61600,32.18390804597701
"Satanta city, Kansas",436,325,111,20,63150,25.458715596330272
"Edna city, Kansas",199,159,40,20,19900,20.100502512562816
"Manchester city, Kansas",65,51,14,20,44225,21.53846153846154
"Cherokee city, Kansas",375,297,78,20,12825,20.8
"Pittsburg city, Kansas",9326,7815,1511,20,56025,16.202015869611838
"Mound Valley city, Kansas",193,161,32,20,48825,16.580310880829018
"Kanorado city, Kansas",109,100,9,20,35975,8.256880733944955
"Goddard city, Kansas",1415,1331,84,20,26725,5.936395759717315
"Park City city, Kansas",3016,2742,274,20,54450,9.084880636604776
"Seneca city, Kansas",1032,933,99,20,63950,9.593023255813954
"Grand Junction city, Iowa",396,346,50,19,31980,12.626262626262626
"Carlisle city, Iowa",1598,1547,51,19,10765,3.1914893617021276
"Knierim city, Iowa",35,21,14,19,41790,40.0
"Sheldon city, Iowa",2333,2166,167,19,72390,7.1581654522074585
"Halbur city, Iowa",116,103,13,19,33645,11.206896551724139
"University Park city, Iowa",191,170,21,19,79815,10.99476439790576
"Frederika city, Iowa",176,144,32,19,29010,18.181818181818183
"Somers city, Iowa",61,56,5,19,73920,8.19672131147541
"Rossie city, Iowa",25,20,5,19,68925,20.0
"Galt city, Iowa",20,11,9,19,29550,45.0
"Garwin city, Iowa",303,253,50,19,30045,16.5016501650165
"Malcom city, Iowa",165,132,33,19,48540,20.0
"Ventura city, Iowa",410,330,80,19,80580,19.51219512195122
"Silver City city, Iowa",125,102,23,19,73155,18.4
"Thornton city, Iowa",240,212,28,19,77880,11.666666666666666
"Waucoma city, Iowa",107,91,16,19,82650,14.953271028037381
"Van Wert city, Iowa",83,78,5,19,80490,6.024096385542169
"Stanwood city, Iowa",274,263,11,19,75045,4.014598540145985
"Fontanelle city, Iowa",350,299,51,19,28290,14.571428571428571
"Bagley city, Iowa",180,137,43,19,04240,23.88888888888889
"Pleasanton city, Iowa",16,12,4,19,63570,25.0
"Lu Verne city, Iowa",164,129,35,19,47370,21.341463414634145
"Walcott city, Iowa",715,679,36,19,81705,5.034965034965035
"Hopkinton city, Iowa",290,241,49,19,37155,16.896551724137932
"Macksburg city, Iowa",61,54,7,19,48180,11.475409836065573
"Peterson city, Iowa",207,171,36,19,62625,17.391304347826086
"Clarksville city, Iowa",622,588,34,19,13755,5.466237942122187
"Perry city, Iowa",3256,2971,285,19,62355,8.753071253071253
"Drakesville city, Iowa",102,100,2,19,22350,1.9607843137254901
"Rowan city, Iowa",87,77,10,19,69015,11.494252873563218
"Calamus city, Iowa",196,186,10,19,09820,5.1020408163265305
"Houghton city, Iowa",67,63,4,19,37335,5.970149253731343
"Red Oak city, Iowa",2858,2496,362,19,66135,12.666200139958011
"Solon city, Iowa",944,892,52,19,73875,5.508474576271186
"Harpers Ferry city, Iowa",618,135,483,19,34590,78.15533980582524
"Clare city, Iowa",90,75,15,19,13485,16.666666666666664
"Hudson city, Iowa",928,901,27,19,37470,2.9094827586206895
"La Porte City city, Iowa",1044,958,86,19,43365,8.237547892720306
"Waterloo city, Iowa",31525,28550,2975,19,82425,9.43695479777954
"Strawberry Point city, Iowa",661,588,73,19,75855,11.043872919818456
"Asbury city, Iowa",1990,1899,91,19,03160,4.572864321608041
"Epworth city, Iowa",702,702,0,19,25725,0.0
"Sherrill city, Iowa",96,96,0,19,72660,0.0
"Atlantic city, Iowa",3442,3224,218,19,03520,6.333527019174897
"Cumberland city, Iowa",133,102,31,19,17760,23.308270676691727
"Massena city, Iowa",180,146,34,19,50250,18.88888888888889
"De Soto city, Iowa",412,387,25,19,21045,6.067961165048544
"Minburn city, Iowa",182,160,22,19,52545,12.087912087912088
"Dubuque city, Iowa",25918,23926,1992,19,22395,7.685778223628366
"Jesup city, Iowa",1175,1052,123,19,39585,10.46808510638298
"Fostoria city, Iowa",104,97,7,19,28650,6.730769230769231
"Spencer city, Iowa",5527,5013,514,19,74280,9.299800977021892
"Moravia city, Iowa",281,276,5,19,53985,1.7793594306049825
"Janesville city, Iowa",424,401,23,19,39405,5.4245283018867925
"Urbana city, Iowa",586,549,37,19,79905,6.313993174061433
"Van Horne city, Iowa",373,340,33,19,80400,8.847184986595174
"Vinton city, Iowa",2308,2069,239,19,81210,10.35528596187175
"Woodburn city, Iowa",102,90,12,19,86880,11.76470588235294
"Oxford city, Iowa",393,376,17,19,60645,4.325699745547073
"Shueyville city, Iowa",230,230,0,19,72840,0.0
"Bussey city, Iowa",249,223,26,19,09730,10.441767068273093
"Melcher-Dallas city, Iowa",619,559,60,19,50935,9.693053311793214
"Swan city, Iowa",30,30,0,19,76665,0.0
"Gravity city, Iowa",89,66,23,19,32520,25.842696629213485
"Republic city, Kansas",92,62,30,20,59000,32.608695652173914
"Mahaska city, Kansas",46,26,20,20,44150,43.47826086956522
"Whiting city, Kansas",89,80,9,20,78100,10.112359550561797
"Lyndon city, Kansas",419,376,43,20,43350,10.26252983293556
"Altamont city, Kansas",431,395,36,20,01550,8.352668213457076
"Morrowville city, Kansas",95,59,36,20,48450,37.89473684210527
"Caney city, Kansas",982,809,173,20,10375,17.617107942973522
"Liberty city, Kansas",65,47,18,20,40250,27.692307692307693
"Wilmore city, Kansas",31,21,10,20,79550,32.25806451612903
"Preston city, Kansas",91,60,31,20,57675,34.065934065934066
"Windom city, Kansas",43,38,5,20,79850,11.627906976744185
"St. Francis city, Kansas",788,649,139,20,62175,17.639593908629443
"Howard city, Kansas",442,312,130,20,33250,29.411764705882355
"Silver Lake city, Kansas",587,568,19,20,65600,3.2367972742759794
"Uniontown city, Kansas",160,133,27,20,72525,16.875
"Bushong city, Kansas",6,6,0,20,09675,0.0
"Hartford city, Kansas",191,162,29,20,30475,15.18324607329843
"Reading city, Kansas",93,79,14,20,58600,15.053763440860216
"Clayton city, Kansas",48,30,18,20,13675,37.5
"Everest city, Kansas",165,133,32,20,22025,19.393939393939394
"Fairview city, Kansas",141,135,6,20,22425,4.25531914893617
"Highland city, Kansas",275,193,82,20,31850,29.818181818181817
"Troy city, Kansas",418,380,38,20,71575,9.090909090909092
"Victoria city, Kansas",510,436,74,20,73775,14.50980392156863
"Hoisington city, Kansas",1156,936,220,20,32550,19.031141868512112
"Olmitz city, Kansas",86,56,30,20,52750,34.883720930232556
"Syracuse city, Kansas",762,621,141,20,69850,18.503937007874015
"Grinnell city, Kansas",191,161,30,20,28900,15.706806282722512
"Waldo city, Kansas",41,24,17,20,74575,41.46341463414634
"Marysville city, Kansas",1753,1512,241,20,45050,13.74786081003993
"Waterville city, Kansas",392,293,99,20,75950,25.255102040816325
"Culver city, Kansas",60,54,6,20,16700,10.0
"Delia city, Kansas",65,61,4,20,17525,6.153846153846154
"Mayetta city, Kansas",167,134,33,20,45250,19.760479041916167
"Alexander city, Kansas",56,37,19,20,01050,33.92857142857143
"Moscow city, Kansas",106,74,32,20,48600,30.18867924528302
"Carbondale city, Kansas",628,536,92,20,10600,14.64968152866242
"Netawaka city, Kansas",66,64,2,20,49950,3.0303030303030303
"McCracken city, Kansas",137,104,33,20,43700,24.087591240875913
"Rush Center city, Kansas",117,107,10,20,61775,8.547008547008547
"Osage City city, Kansas",1486,1281,205,20,53200,13.79542395693136
"Mission Hills city, Kansas",1345,1229,116,20,47350,8.62453531598513
"Galena city, Kansas",1513,1135,378,20,25100,24.98347653668209
"Haviland city, Kansas",270,215,55,20,30825,20.37037037037037
"Mullinville city, Kansas",124,93,31,20,49075,25.0
"Topeka city, Kansas",60207,53312,6895,20,71000,11.452156725962096
"Plevna city, Kansas",57,40,17,20,56725,29.82456140350877
"Grenola city, Kansas",121,83,38,20,28800,31.40495867768595
"Auburn city, Kansas",526,471,55,20,03250,10.456273764258556
"Abbyville city, Kansas",48,35,13,20,00100,27.083333333333332
"South Hutchinson city, Kansas",1334,1179,155,20,66750,11.619190404797601
"Sylvia city, Kansas",105,72,33,20,69800,31.428571428571427
"Fredonia city, Kansas",1247,994,253,20,24575,20.288692862870892
"Buffalo city, Kansas",146,121,25,20,09150,17.123287671232877
"Neodesha city, Kansas",1204,952,252,20,49650,20.930232558139537
"Girard city, Kansas",1244,1010,234,20,26300,18.810289389067524
"Bartlett city, Kansas",33,25,8,20,04350,24.242424242424242
"Goodland city, Kansas",2360,1973,387,20,26875,16.39830508474576
"Garden Plain city, Kansas",315,309,6,20,25375,1.9047619047619049
"Eastborough city, Kansas",316,286,30,20,19300,9.49367088607595
"Mount Hope city, Kansas",318,293,25,20,48900,7.861635220125786
"Minneola city, Kansas",416,344,72,20,47150,17.307692307692307
"Elk Falls city, Kansas",66,46,20,20,20300,30.303030303030305
"Farragut city, Iowa",248,237,11,19,26985,4.435483870967742
"Hamburg city, Iowa",590,484,106,19,33780,17.966101694915253
"Riverton city, Iowa",157,131,26,19,67575,16.560509554140125
"Thornburg city, Iowa",41,37,4,19,77835,9.75609756097561
"Hayesville city, Iowa",23,19,4,19,35445,17.391304347826086
"North English city, Iowa",468,413,55,19,57225,11.752136752136751
"Reinbeck city, Iowa",755,702,53,19,66315,7.0198675496688745
"Mitchell city, Iowa",66,60,6,19,52905,9.090909090909092
"Middletown city, Iowa",156,137,19,19,51735,12.179487179487179
"Logan city, Iowa",708,628,80,19,46155,11.299435028248588
"Fort Madison city, Iowa",5030,4370,660,19,28605,13.12127236580517
"Exira city, Iowa",477,436,41,19,26265,8.59538784067086
"Buck Grove city, Iowa",23,22,1,19,09145,4.3478260869565215
"Dow City city, Iowa",254,227,27,19,22215,10.62992125984252
"North Liberty city, Iowa",7402,7075,327,19,57360,4.417724939205621
"West Branch city, Iowa",1023,932,91,19,83595,8.895405669599219
"Marysville city, Iowa",40,35,5,19,50070,12.5
"Allerton city, Iowa",251,219,32,19,01270,12.749003984063744
"Corydon city, Iowa",795,687,108,19,16635,13.584905660377359
"West Point city, Iowa",500,459,41,19,84585,8.200000000000001
"Thayer city, Iowa",19,19,0,19,77565,0.0
"Martinsburg city, Iowa",60,52,8,19,49935,13.333333333333334
"McIntire city, Iowa",54,41,13,19,48045,24.074074074074073
"Bondurant city, Iowa",2100,1992,108,19,07390,5.142857142857142
"Armstrong city, Iowa",501,439,62,19,02935,12.375249500998004
"Corwith city, Iowa",149,125,24,19,16590,16.10738255033557
"Kanawha city, Iowa",403,366,37,19,40260,9.181141439205955
"Klemme city, Iowa",270,253,17,19,41655,6.296296296296296
"New Virginia city, Iowa",232,207,25,19,56595,10.775862068965516
"Humeston city, Iowa",245,201,44,19,37605,17.959183673469386
"Pioneer city, Iowa",3,1,2,19,62985,66.66666666666666
"Westfield city, Iowa",65,59,6,19,84090,9.230769230769232
"Danbury city, Iowa",176,156,20,19,18390,11.363636363636363
"Bristow city, Iowa",71,70,1,19,08560,1.4084507042253522
"Cascade city, Iowa",941,889,52,19,11305,5.526036131774708
"Olin city, Iowa",387,340,47,19,58980,12.144702842377262
"Tabor city, Iowa",510,482,28,19,76935,5.490196078431373
"Aurelia city, Iowa",492,453,39,19,03745,7.926829268292683
"Marcus city, Iowa",657,596,61,19,49350,9.28462709284627
"Holstein city, Iowa",771,634,137,19,36840,17.769130998702984
"Lakeside city, Iowa",344,304,40,19,42645,11.627906976744185
"Newell city, Iowa",439,396,43,19,55965,9.79498861047836
"Rembrandt city, Iowa",84,76,8,19,66360,9.523809523809524
"Ricketts city, Iowa",44,40,4,19,66855,9.090909090909092
"Carpenter city, Iowa",63,53,10,19,11035,15.873015873015872
"Grimes city, Iowa",4535,4493,42,19,33060,0.926130099228225
"Brooklyn city, Iowa",702,659,43,19,08695,6.1253561253561255
"Beaconsfield city, Iowa",17,12,5,19,05095,29.411764705882355
"Audubon city, Iowa",1143,1003,140,19,03655,12.248468941382328
"Waukon city, Iowa",1996,1791,205,19,82740,10.270541082164328
"Deloit city, Iowa",193,157,36,19,19765,18.65284974093264
"Schleswig city, Iowa",439,405,34,19,71130,7.744874715261959
"Lone Tree city, Iowa",560,511,49,19,46335,8.75
"Hamilton city, Iowa",53,30,23,19,33870,43.39622641509434
"Clio city, Iowa",34,30,4,19,14475,11.76470588235294
"Grinnell city, Iowa",3962,3708,254,19,33105,6.4109035840484605
"Graettinger city, Iowa",436,361,75,19,31800,17.201834862385322
"West Bend city, Iowa",375,338,37,19,83550,9.866666666666667
"Roland city, Iowa",493,477,16,19,68475,3.2454361054766734
"Clearfield city, Iowa",171,141,30,19,13980,17.543859649122805
"Redding city, Iowa",40,26,14,19,66000,35.0
"Huxley city, Iowa",1319,1319,0,19,37920,0.0
"Arlington city, Kansas",274,255,19,20,02325,6.934306569343065
"Sheldahl city, Iowa",130,110,20,19,72345,15.384615384615385
"Princeton city, Iowa",470,411,59,19,64740,12.553191489361701
"Longton city, Kansas",215,147,68,20,42650,31.627906976744185
"Partridge city, Kansas",121,92,29,20,54700,23.96694214876033
"Pretty Prairie city, Kansas",252,217,35,20,57700,13.88888888888889
"Wathena city, Kansas",676,623,53,20,76000,7.840236686390532
"Brownell city, Kansas",33,20,13,20,08675,39.39393939393939
"Mayfield city, Kansas",52,38,14,20,45275,26.923076923076923
"Mulvane city, Kansas",2588,2323,265,20,49100,10.239567233384852
"Hamlin city, Kansas",28,26,2,20,29700,7.142857142857142
"Severance city, Kansas",74,46,28,20,64025,37.83783783783784
"Coolidge city, Kansas",52,42,10,20,15400,19.230769230769234
"St. Paul city, Kansas",248,216,32,20,62500,12.903225806451612
"Stark city, Kansas",52,37,15,20,68025,28.846153846153843
"Bushton city, Kansas",164,115,49,20,09700,29.878048780487802
"Jennings city, Kansas",111,89,22,20,35375,19.81981981981982
"Gridley city, Kansas",166,143,23,20,28850,13.855421686746988
"Douglass city, Kansas",759,689,70,20,18400,9.22266139657444
"El Dorado city, Kansas",6212,5487,725,20,20075,11.670959433354797
"Bucklin city, Kansas",395,339,56,20,09000,14.177215189873419
"Garfield city, Kansas",100,76,24,20,25750,24.0
"Garden City city, Kansas",9816,9214,602,20,25325,6.132844335778321
"Almena city, Kansas",207,162,45,20,01425,21.73913043478261
"Oxford city, Kansas",494,433,61,20,53850,12.348178137651821
"Wellington city, Kansas",3638,3185,453,20,76475,12.451896646509072
"Olpe city, Kansas",274,251,23,20,52800,8.394160583941606
"Palco city, Kansas",129,75,54,20,54125,41.86046511627907
"Ingalls city, Kansas",107,95,12,20,34225,11.214953271028037
"Raymond city, Kansas",48,43,5,20,58550,10.416666666666668
"Sublette city, Kansas",683,571,112,20,68775,16.398243045387993
"Earlton city, Kansas",37,33,4,20,19275,10.81081081081081
"Little River city, Kansas",242,216,26,20,41575,10.743801652892563
"Medicine Lodge city, Kansas",1166,844,322,20,45500,27.615780445969122
"Lebo city, Kansas",392,331,61,20,39125,15.561224489795919
"Waverly city, Kansas",308,262,46,20,76050,14.935064935064934
"Blue Mound city, Kansas",192,168,24,20,07600,12.5
"Havensville city, Kansas",67,50,17,20,30775,25.37313432835821
"Louisville city, Kansas",132,107,25,20,42925,18.939393939393938
"Arma city, Kansas",688,545,143,20,02375,20.78488372093023
"Fairway city, Kansas",1870,1736,134,20,22700,7.165775401069519
"Merriam city, Kansas",5417,5100,317,20,46000,5.851947572457079
"Mission city, Kansas",4911,4625,286,20,47225,5.8236611688047235
"Dunlap city, Kansas",22,12,10,20,18950,45.45454545454545
"Hoxie city, Kansas",636,566,70,20,33350,11.0062893081761
"Bentley city, Kansas",211,196,15,20,06125,7.109004739336493
"Olathe city, Kansas",48925,47265,1660,20,52575,3.39294839039346
"Prairie Village city, Kansas",10442,9727,715,20,57575,6.84734725148439
"Lakin city, Kansas",820,642,178,20,38175,21.70731707317073
"Longford city, Kansas",50,50,0,20,42575,0.0
"Tribune city, Kansas",380,311,69,20,71450,18.157894736842106
"Ulysses city, Kansas",2168,1935,233,20,71975,10.747232472324724
"Peabody city, Kansas",579,451,128,20,55100,22.107081174438687
"Dexter city, Kansas",140,123,17,20,17925,12.142857142857142
"Wellsville city, Kansas",784,724,60,20,76625,7.653061224489796
"Newton city, Kansas",8529,7659,870,20,50475,10.200492437565952
"Athol city, Kansas",31,18,13,20,03025,41.935483870967744
"Neosho Falls city, Kansas",85,74,11,20,49825,12.941176470588237
"Formoso city, Kansas",68,43,25,20,23825,36.76470588235294
"Clifton city, Kansas",230,188,42,20,14200,18.26086956521739
"Palmer city, Kansas",82,70,12,20,54200,14.634146341463413
"Havana city, Kansas",51,39,12,20,30700,23.52941176470588
"Salina city, Kansas",21166,19359,1807,20,62700,8.537276764622508
"Canton city, Kansas",336,309,27,20,10475,8.035714285714286
"Altoona city, Kansas",218,137,81,20,01625,37.15596330275229
"La Motte city, Iowa",114,103,11,19,43050,9.649122807017543
"Maquoketa city, Iowa",3017,2627,390,19,49215,12.926748425588332
"Preston city, Iowa",454,419,35,19,64605,7.709251101321586
"Sabula city, Iowa",269,212,57,19,69510,21.189591078066915
"Zwingle city, Iowa",43,39,4,19,87690,9.30232558139535
"New Market city, Iowa",240,206,34,19,56370,14.166666666666666
"Moorland city, Iowa",95,82,13,19,53895,13.684210526315791
"Vincent city, Iowa",79,65,14,19,81075,17.72151898734177
"Marengo city, Iowa",1272,1144,128,19,49395,10.062893081761008
"Ayrshire city, Iowa",100,79,21,19,04105,21.0
"Carter Lake city, Iowa",1532,1356,176,19,11215,11.488250652741515
"Hospers city, Iowa",328,317,11,19,37290,3.353658536585366
"Orange City city, Iowa",2197,2064,133,19,59475,6.053709604005462
"Rock Valley city, Iowa",1399,1350,49,19,68205,3.5025017869907074
"Oakland city, Iowa",653,572,81,19,58080,12.404287901990811
"New Sharon city, Iowa",559,478,81,19,56460,14.490161001788909
"Luxemburg city, Iowa",112,104,8,19,47460,7.142857142857142
"Farmersburg city, Iowa",133,130,3,19,26850,2.2556390977443606
"Lowden city, Iowa",406,379,27,19,46920,6.65024630541872
"Exline city, Iowa",84,73,11,19,26310,13.095238095238097
"Bonaparte city, Iowa",210,177,33,19,07345,15.714285714285714
"Alburnett city, Iowa",234,220,14,19,01000,5.982905982905983
"Wahpeton city, Iowa",816,198,618,19,81615,75.73529411764706
"Hanlontown city, Iowa",97,83,14,19,34185,14.432989690721648
"Kensett city, Iowa",163,136,27,19,40665,16.56441717791411
"Randalia city, Iowa",45,37,8,19,65550,17.77777777777778
"Sumner city, Iowa",1004,894,110,19,76260,10.95617529880478
"Ellsworth city, Iowa",222,198,24,19,25050,10.81081081081081
"Coggon city, Iowa",278,262,16,19,14925,5.755395683453238
"Robins city, Iowa",1220,1193,27,19,67800,2.2131147540983607
"Leon city, Iowa",967,825,142,19,44535,14.68459152016546
"Webster City city, Iowa",3886,3450,436,19,83145,11.219763252702007
"Rathbun city, Iowa",48,35,13,19,65730,27.083333333333332
"Carbon city, Iowa",24,22,2,19,10585,8.333333333333332
"Prescott city, Iowa",122,100,22,19,64560,18.0327868852459
"Panama city, Iowa",81,76,5,19,61275,6.172839506172839
"Granville city, Iowa",166,157,9,19,32475,5.421686746987952
"Ireton city, Iowa",388,364,24,19,38820,6.185567010309279
"Bendena CDP, Kansas",90,78,12,20,05975,13.333333333333334
"Bucyrus CDP, Kansas",167,137,30,20,09050,17.964071856287426
"Catharine CDP, Kansas",20,20,0,20,11025,0.0
"Chicopee CDP, Kansas",253,253,0,20,13100,0.0
"Detroit CDP, Kansas",34,34,0,20,17875,0.0
"Falun CDP, Kansas",21,21,0,20,22900,0.0
"Fort Dodge CDP, Kansas",153,113,40,20,23890,26.143790849673206
"Fort Riley CDP, Kansas",1317,1193,124,20,23975,9.41533788914199
"Franklin CDP, Kansas",180,155,25,20,24325,13.88888888888889
"Grantville CDP, Kansas",52,52,0,20,28200,0.0
"Harris CDP, Kansas",0,0,0,20,30250,
"Healy CDP, Kansas",150,115,35,20,31200,23.333333333333332
"Hillsdale CDP, Kansas",161,127,34,20,32300,21.11801242236025
"Home CDP, Kansas",72,72,0,20,32875,0.0
"Kickapoo Site 6 CDP, Kansas",7,7,0,20,36740,0.0
"Kickapoo Site 1 CDP, Kansas",27,20,7,20,36735,25.925925925925924
"Kickapoo Site 2 CDP, Kansas",12,12,0,20,36736,0.0
"Kickapoo Site 5 CDP, Kansas",10,10,0,20,36739,0.0
"Kickapoo Site 7 CDP, Kansas",26,23,3,20,36741,11.538461538461538
"Kickapoo Tribal Center CDP, Kansas",82,62,20,20,36744,24.390243902439025
"Kipp CDP, Kansas",25,25,0,20,37200,0.0
"Levant CDP, Kansas",17,17,0,20,39700,0.0
"Lowell CDP, Kansas",138,115,23,20,43050,16.666666666666664
"McConnell AFB CDP, Kansas",379,363,16,20,43675,4.221635883905013
"Marienthal CDP, Kansas",59,46,13,20,44600,22.033898305084744
"Milton CDP, Kansas",67,67,0,20,46925,0.0
"Benedict city, Kansas",43,43,0,20,06000,0.0
"Coyville city, Kansas",39,20,19,20,16150,48.717948717948715
"McCune city, Kansas",197,160,37,20,43725,18.781725888324875
"New Albany city, Kansas",50,47,3,20,50150,6.0
"Brewster city, Kansas",149,135,14,20,08425,9.395973154362416
"Montezuma city, Kansas",447,387,60,20,47875,13.422818791946309
"Bunker Hill city, Kansas",78,63,15,20,09225,19.230769230769234
"Dorrance city, Kansas",113,85,28,20,18325,24.778761061946902
"Summerfield city, Kansas",80,63,17,20,68950,21.25
"Denton city, Kansas",72,61,11,20,17750,15.277777777777779
"White Cloud city, Kansas",103,53,50,20,77850,48.54368932038835
"Elmdale city, Kansas",35,23,12,20,20675,34.285714285714285
"Long Island city, Kansas",76,59,17,20,42600,22.36842105263158
"Prairie View city, Kansas",57,52,5,20,57525,8.771929824561402
"Norcatur city, Kansas",174,166,8,20,50925,4.597701149425287
"Pleasanton city, Kansas",735,647,88,20,56450,11.972789115646258
"Prescott city, Kansas",140,111,29,20,57650,20.714285714285715
"Lincoln Center city, Kansas",796,554,242,20,41300,30.402010050251256
"Radium city, Kansas",17,13,4,20,58300,23.52941176470588
"Hardtner city, Kansas",119,77,42,20,30000,35.294117647058826
"Dresden city, Kansas",41,28,13,20,18600,31.70731707317073
"Utica city, Kansas",116,89,27,20,72650,23.275862068965516
"Latham city, Kansas",99,72,27,20,38775,27.27272727272727
"Scott City city, Kansas",1728,1601,127,20,63600,7.349537037037036
"Burdett city, Kansas",164,133,31,20,09275,18.902439024390244
"Larned city, Kansas",2160,1805,355,20,38700,16.435185185185187
"Paxico city, Kansas",103,98,5,20,54950,4.854368932038835
"Logan city, Kansas",333,287,46,20,42100,13.813813813813812
"Geuda Springs city, Kansas",83,71,12,20,26200,14.457831325301203
"Williamsburg city, Kansas",171,154,17,20,79300,9.941520467836257
"Sedan city, Kansas",599,438,161,20,63750,26.878130217028378
"Lane city, Kansas",123,116,7,20,38400,5.691056910569105
"Rantoul city, Kansas",88,75,13,20,58525,14.772727272727273
"Junction City city, Kansas",11052,9192,1860,20,35750,16.829533116178066
"Holton city, Kansas",1658,1504,154,20,32825,9.288299155609167
"Melvern city, Kansas",214,177,37,20,45700,17.289719626168225
"Overbrook city, Kansas",444,370,74,20,53725,16.666666666666664
"Kansas City city, Kansas",63132,55533,7599,20,36000,12.036685040866756
"De Soto city, Kansas",2621,2399,222,20,17850,8.470049599389547
"Elsmore city, Kansas",46,31,15,20,20875,32.608695652173914
"Moran city, Kansas",205,182,23,20,48125,11.219512195121952
"Downs city, Kansas",496,389,107,20,18500,21.572580645161292
"Galatia city, Kansas",33,17,16,20,25050,48.484848484848484
"Huron city, Kansas",34,34,0,20,33575,0.0
"Arcadia city, Kansas",200,167,33,20,02175,16.5
"Lancaster city, Kansas",114,98,16,20,38325,14.035087719298245
"Wamego city, Kansas",2109,2022,87,20,75325,4.125177809388336
"Cedar Point city, Kansas",7,4,3,20,11425,42.857142857142854
"Milan city, Kansas",56,31,25,20,46450,44.642857142857146
"Mulberry city, Kansas",267,206,61,20,49025,22.846441947565545
"Westmoreland city, Kansas",312,267,45,20,77200,14.423076923076922
"Wheaton city, Kansas",46,27,19,20,77700,41.30434782608695
"Anthony city, Kansas",1243,850,393,20,01975,31.61705551086082
"Chautauqua city, Kansas",56,23,33,20,12675,58.92857142857143
"Argonia city, Kansas",258,205,53,20,02250,20.54263565891473
"Caldwell city, Kansas",617,485,132,20,09900,21.39384116693679
"Powhattan city, Kansas",41,37,4,20,57350,9.75609756097561
"Bassett city, Kansas",9,9,0,20,04450,0.0
"Copeland city, Kansas",164,142,22,20,15475,13.414634146341465
"Ensign city, Kansas",119,106,13,20,21400,10.92436974789916
"Winchester city, Kansas",357,300,57,20,79800,15.966386554621847
"Gem city, Kansas",49,47,2,20,26050,4.081632653061225
"Menlo city, Kansas",16,16,0,20,45750,0.0
"Munjor CDP, Kansas",121,96,25,20,49200,20.66115702479339
"Odin CDP, Kansas",110,60,50,20,52175,45.45454545454545
"Piqua CDP, Kansas",32,32,0,20,56000,0.0
"Riverton CDP, Kansas",376,328,48,20,60200,12.76595744680851
"Rosalia CDP, Kansas",51,51,0,20,61100,0.0
"Roxbury CDP, Kansas",24,24,0,20,61550,0.0
"Talmage CDP, Kansas",48,48,0,20,69925,0.0
"Vassar CDP, Kansas",433,351,82,20,73450,18.937644341801384
"Wakarusa CDP, Kansas",98,98,0,20,74425,0.0
"Welda CDP, Kansas",38,38,0,20,76425,0.0
"Weskan CDP, Kansas",73,45,28,20,76675,38.35616438356164
"Wilroads Gardens CDP, Kansas",204,192,12,20,79625,5.88235294117647
"Wright CDP, Kansas",58,58,0,20,80500,0.0
"Yoder CDP, Kansas",102,102,0,20,80750,0.0
"Greeley County unified government (balance), Kansas",189,144,45,20,28412,23.809523809523807
"Chase city, Kansas",248,214,34,20,12650,13.709677419354838
"Frederick city, Kansas",13,3,10,20,24550,76.92307692307693
"Niotaze city, Kansas",36,29,7,20,50750,19.444444444444446
"Lehigh city, Kansas",91,72,19,20,39225,20.87912087912088
"Moundridge city, Kansas",1027,963,64,20,48800,6.2317429406037
"Bronson city, Kansas",126,93,33,20,08475,26.190476190476193
"Tampa city, Kansas",57,57,0,20,70000,0.0
"Barnes city, Kansas",96,71,25,20,04250,26.041666666666668
"Latimer city, Kansas",11,6,5,20,38800,45.45454545454545
"Edgerton city, Kansas",650,597,53,20,19825,8.153846153846153
"Gardner city, Kansas",7641,7125,516,20,25425,6.753042795445623
"Herndon city, Kansas",109,62,47,20,31475,43.11926605504588
"Dighton city, Kansas",576,463,113,20,18050,19.618055555555554
"Horace city, Kansas",47,39,8,20,33150,17.02127659574468
"Goessel city, Kansas",278,246,32,20,26750,11.510791366906476
"Ramona city, Kansas",72,47,25,20,58375,34.72222222222222
"Udall city, Kansas",307,279,28,20,71950,9.120521172638437
"Gypsum city, Kansas",184,173,11,20,29250,5.978260869565218
"New Cambria city, Kansas",50,31,19,20,50300,38.0
"Abilene city, Kansas",3288,2791,497,20,00125,15.115571776155717
"Carlton city, Kansas",13,6,7,20,10675,53.84615384615385
"Hepler city, Kansas",74,58,16,20,31375,21.62162162162162
"Walnut city, Kansas",91,73,18,20,74950,19.78021978021978
"Bel Aire city, Kansas",3045,2873,172,20,05337,5.648604269293925
"Lawrence city, Kansas",40487,37557,2930,20,38900,7.236890853854323
"Lost Springs city, Kansas",44,37,7,20,42825,15.909090909090908
"Burden city, Kansas",302,262,40,20,09250,13.245033112582782
"Hesston city, Kansas",1505,1492,13,20,31600,0.8637873754152824
"Winfield city, Kansas",5123,4361,762,20,79950,14.874097208666798
"Ottawa city, Kansas",5610,4953,657,20,53550,11.711229946524064
"Halstead city, Kansas",885,783,102,20,29600,11.525423728813559
"Tonganoxie city, Kansas",2049,1847,202,20,70800,9.858467545143974
"Gaylord city, Kansas",119,80,39,20,26000,32.773109243697476
"Toronto city, Kansas",217,131,86,20,71050,39.63133640552996
"Wetmore city, Kansas",163,143,20,20,77550,12.269938650306749
"Greenleaf city, Kansas",195,170,25,20,28625,12.82051282051282
"Haddam city, Kansas",87,45,42,20,29400,48.275862068965516
"Coats city, Kansas",86,52,34,20,14525,39.53488372093023
"Marquette city, Kansas",359,321,38,20,44925,10.584958217270195
"Greeley city, Kansas",136,107,29,20,28350,21.323529411764707
"Ashland city, Kansas",423,324,99,20,02675,23.404255319148938
"Stockton city, Kansas",720,606,114,20,68350,15.833333333333332
"Woodston city, Kansas",89,38,51,20,80450,57.30337078651685
"Zurich city, Kansas",68,47,21,20,81025,30.88235294117647
"Redfield city, Kansas",58,43,15,20,58725,25.862068965517242
"Aurora city, Kansas",54,37,17,20,03425,31.48148148148148
"Jamestown city, Kansas",153,125,28,20,34975,18.30065359477124
"Miltonvale city, Kansas",339,240,99,20,46950,29.20353982300885
"Danville city, Kansas",26,18,8,20,17000,30.76923076923077
"Elkhorn City city, Kentucky",570,424,146,21,24382,25.6140350877193
"Stanton city, Kentucky",1052,930,122,21,73164,11.596958174904943
"Livingston city, Kentucky",90,53,37,21,47098,41.11111111111111
"Oak Grove city, Kentucky",3274,2657,617,21,57090,18.845448992058643
"Paintsville city, Kentucky",1979,1628,351,21,58962,17.73623041940374
"Cadiz city, Kentucky",1388,1231,157,21,11692,11.311239193083573
"Crestview city, Kentucky",168,158,10,21,18424,5.952380952380952
"Park Hills city, Kentucky",1388,1313,75,21,59255,5.403458213256484
"Berry city, Kentucky",158,134,24,21,05968,15.18987341772152
"Breckinridge Center CDP, Kentucky",417,255,162,21,09379,38.84892086330935
"Hardin city, Kentucky",272,238,34,21,34534,12.5
"Murray city, Kentucky",8939,7094,1845,21,54642,20.63989260543685
"Mortons Gap city, Kentucky",496,460,36,21,53616,7.258064516129033
"Prospect city, Kentucky",2108,2017,91,21,63264,4.3168880455407965
"Taylorsville city, Kentucky",696,616,80,21,75810,11.494252873563218
"Columbus city, Kentucky",92,87,5,21,16768,5.434782608695652
"Uniontown city, Kentucky",419,359,60,21,78492,14.319809069212411
"Walton city, Kentucky",1511,1365,146,21,80490,9.662475181998676
"Frankfort city, Kentucky",13946,12317,1629,21,28900,11.680768679191166
"Lewisport city, Kentucky",850,739,111,21,45136,13.058823529411764
"Smithfield city, Kentucky",56,48,8,21,71364,14.285714285714285
"Bedford city, Kentucky",339,288,51,21,04816,15.04424778761062
"Bonnieville city, Kentucky",124,112,12,21,08488,9.67741935483871
"Mount Washington city, Kentucky",5593,5363,230,21,54228,4.112283211156803
"Salt Lick city, Kentucky",191,158,33,21,68160,17.277486910994764
"Barbourville city, Kentucky",1210,1015,195,21,03574,16.115702479338843
"Danville city, Kentucky",7130,6278,852,21,19882,11.949509116409537
"Dayton city, Kentucky",2482,2128,354,21,20350,14.26269137792103
"Melbourne city, Kentucky",163,135,28,21,51438,17.177914110429448
"Silver Grove city, Kentucky",559,486,73,21,70644,13.059033989266547
"Green Spring city, Kentucky",293,277,16,21,32986,5.460750853242321
"Grayson city, Kentucky",1565,1324,241,21,32572,15.399361022364216
"Olive Hill city, Kentucky",862,724,138,21,57918,16.009280742459396
"Glenview Hills city, Kentucky",148,136,12,21,31402,8.108108108108109
"Langdon Place city, Kentucky",347,341,6,21,43900,1.729106628242075
"Somerset city, Kentucky",5173,4517,656,21,71688,12.681229460661125
"Lynnview city, Kentucky",434,418,16,21,48648,3.686635944700461
"Shively city, Kentucky",7347,6509,838,21,70284,11.40601606097727
"Wildwood city, Kentucky",123,115,8,21,83208,6.504065040650407
"Monterey city, Kentucky",101,82,19,21,53076,18.81188118811881
"Burnside city, Kentucky",612,443,169,21,11278,27.61437908496732
"Jamestown city, Kentucky",912,754,158,21,40114,17.324561403508774
"Wickliffe city, Kentucky",403,327,76,21,83064,18.858560794044664
"Pembroke city, Kentucky",392,320,72,21,59934,18.367346938775512
"Fairfield city, Kentucky",48,40,8,21,26020,16.666666666666664
"New Haven city, Kentucky",341,280,61,21,55758,17.888563049853374
"Cave City city, Kentucky",1220,1061,159,21,13492,13.032786885245901
"Grand Rivers city, Kentucky",263,179,84,21,32212,31.93916349809886
"Sharpsburg city, Kentucky",233,213,20,21,69852,8.583690987124463
"Centertown city, Kentucky",175,156,19,21,13870,10.857142857142858
"Taylor Mill city, Kentucky",2686,2660,26,21,75738,0.967982129560685
"Fordsville city, Kentucky",298,226,72,21,28270,24.161073825503358
"Elsmere city, Kentucky",3264,2909,355,21,24778,10.876225490196079
"Fort Wright city, Kentucky",2577,2497,80,21,28612,3.104384943733023
"Kenton Vale city, Kentucky",65,63,2,21,42094,3.076923076923077
"McHenry city, Kentucky",161,137,24,21,49098,14.906832298136646
"Morganfield city, Kentucky",1620,1497,123,21,53472,7.592592592592593
"Corbin city, Kentucky",3368,2783,585,21,17362,17.36935866983373
"Lakeside Park city, Kentucky",1358,1302,56,21,43606,4.123711340206185
"Ludlow city, Kentucky",2279,1875,404,21,48378,17.727073277753398
"Blue Rapids city, Kansas",448,377,71,20,07650,15.848214285714285
"Atchison city, Kansas",4299,3688,611,20,02900,14.212607583158873
"Wallace city, Kansas",41,38,3,20,74750,7.317073170731707
"Glen Elder city, Kansas",262,183,79,20,26500,30.15267175572519
"Simpson city, Kansas",52,28,24,20,65650,46.15384615384615
"Emmett city, Kansas",68,42,26,20,21100,38.23529411764706
"Pawnee Rock city, Kansas",170,118,52,20,54875,30.58823529411765
"Soldier city, Kansas",53,40,13,20,66175,24.528301886792452
"Timken city, Kansas",49,26,23,20,70625,46.93877551020408
"Scranton city, Kansas",270,247,23,20,63675,8.518518518518519
"Gove City city, Kansas",53,36,17,20,27125,32.075471698113205
"Park city, Kansas",101,84,17,20,54400,16.831683168316832
"McLouth city, Kansas",489,461,28,20,43900,5.725971370143149
"Meriden city, Kansas",302,264,38,20,45950,12.582781456953644
"Valley Falls city, Kansas",445,401,44,20,73300,9.887640449438202
"Axtell city, Kansas",189,165,24,20,03600,12.698412698412698
"Oketo city, Kansas",50,39,11,20,52525,22.0
"Ellis city, Kansas",924,864,60,20,20450,6.493506493506493
"Schoenchen city, Kansas",89,69,20,20,63425,22.47191011235955
"Alton city, Kansas",80,61,19,20,01600,23.75
"Claflin city, Kansas",275,237,38,20,13425,13.818181818181818
"Gas city, Kansas",246,214,32,20,25975,13.008130081300814
"Iola city, Kansas",2800,2317,483,20,34300,17.25
"La Harpe city, Kansas",306,246,60,20,37725,19.607843137254903
"Belle Plaine city, Kansas",765,648,117,20,05500,15.294117647058824
"Sun City city, Kansas",31,16,15,20,69275,48.38709677419355
"Benton city, Kansas",408,400,8,20,06175,1.9607843137254901
"Council Grove city, Kansas",1095,933,162,20,15925,14.794520547945206
"Lake Quivira city, Kansas",418,351,67,20,37975,16.028708133971293
"Deerfield city, Kansas",259,214,45,20,17225,17.374517374517374
"Selden city, Kansas",181,170,11,20,63875,6.077348066298343
"Willis city, Kansas",30,14,16,20,79400,53.333333333333336
"Lucas city, Kansas",277,192,85,20,43150,30.685920577617328
"Elwood city, Kansas",534,428,106,20,20950,19.850187265917604
"Effingham city, Kansas",279,247,32,20,20025,11.469534050179211
"Nortonville city, Kansas",284,245,39,20,51525,13.732394366197184
"Luray city, Kansas",144,69,75,20,43250,52.083333333333336
"Colby city, Kansas",2508,2351,157,20,14650,6.2599681020733655
"Frankfort city, Kansas",348,302,46,20,24275,13.218390804597702
"Cedar city, Kansas",21,10,11,20,11325,52.38095238095239
"Walton city, Kansas",123,117,6,20,75200,4.878048780487805
"Basehor city, Kansas",2086,1992,94,20,04400,4.506232023010546
"Kensington city, Kansas",244,206,38,20,36550,15.573770491803279
"Agra city, Kansas",166,125,41,20,00550,24.69879518072289
"Conway Springs city, Kansas",571,511,60,20,15325,10.507880910683012
"Horton city, Kansas",961,742,219,20,33200,22.788761706555672
"Morrill city, Kansas",121,99,22,20,48300,18.181818181818183
"Leona city, Kansas",20,9,11,20,39475,55.00000000000001
"Strong City city, Kansas",254,199,55,20,68650,21.653543307086615
"Lewis city, Kansas",240,182,58,20,39725,24.166666666666668
"Natoma city, Kansas",221,142,79,20,49425,35.74660633484163
"Great Bend city, Kansas",7327,6308,1019,20,28300,13.907465538419544
"Admire city, Kansas",43,43,0,20,00325,0.0
"Americus city, Kansas",386,339,47,20,01675,12.176165803108809
"Emporia city, Kansas",11313,10018,1295,20,21275,11.4470078670556
"Plainville city, Kansas",958,806,152,20,56150,15.866388308977037
"Perry city, Kansas",426,400,26,20,55450,6.103286384976526
"Paradise city, Kansas",30,18,12,20,54325,40.0
"Cedar Vale city, Kansas",335,201,134,20,11450,40.0
"Fall River city, Kansas",105,69,36,20,22775,34.285714285714285
"Beloit city, Kansas",1981,1642,339,20,05775,17.1125694093892
"Olsburg city, Kansas",102,90,12,20,52825,11.76470588235294
"Woodbine city, Kansas",91,82,9,20,80350,9.89010989010989
"Ryland Heights city, Kentucky",420,371,49,21,67602,11.666666666666666
"Hanson city, Kentucky",281,253,28,21,34390,9.9644128113879
"White Plains city, Kentucky",395,363,32,21,82722,8.10126582278481
"Cloverport city, Kentucky",511,427,84,21,15904,16.43835616438356
"Woodbury city, Kentucky",24,20,4,21,84432,16.666666666666664
"Sandy Hook city, Kentucky",419,329,90,21,68556,21.479713603818613
"Henderson city, Kentucky",13283,11966,1317,21,35866,9.914928856433034
"Campton city, Kentucky",307,267,40,21,12358,13.029315960912053
"Frenchburg city, Kentucky",365,321,44,21,29260,12.054794520547945
"Shepherdsville city, Kentucky",4697,4378,319,21,70086,6.791569086651054
"Fort Thomas city, Kentucky",6872,6471,401,21,28594,5.835273573923167
"Brownsville city, Kentucky",426,362,64,21,10324,15.023474178403756
"Fulton city, Kentucky",1347,1007,340,21,29566,25.24127691165553
"Dawson Springs city, Kentucky",1358,1178,180,21,20224,13.25478645066274
"Arlington city, Kentucky",258,206,52,21,02044,20.155038759689923
"Mackville city, Kentucky",91,85,6,21,49206,6.593406593406594
"Springfield city, Kentucky",1390,1195,195,21,72660,14.028776978417264
"Willisburg city, Kentucky",127,118,9,21,83424,7.086614173228346
"Williamsburg city, Kentucky",1689,1287,402,21,83334,23.80106571936057
"Morgantown city, Kentucky",1193,1099,94,21,53490,7.879295892707461
"Bromley city, Kentucky",421,335,86,21,09856,20.42755344418052
"Independence city, Kentucky",9501,9045,456,21,39142,4.799494790022103
"Blandville city, Kentucky",30,30,0,21,07390,0.0
"Rochester city, Kentucky",121,93,28,21,65982,23.140495867768596
"Albany city, Kentucky",1169,946,223,21,00694,19.076133447390934
"Corydon city, Kentucky",309,285,24,21,17686,7.766990291262135
"Adairville city, Kentucky",413,368,45,21,00298,10.895883777239709
"Morehead city, Kentucky",2341,2105,236,21,53418,10.081161896625373
"Auburn city, Kentucky",562,506,56,21,02638,9.9644128113879
"Lewisburg city, Kentucky",406,321,85,21,45064,20.935960591133004
"Russellville city, Kentucky",3512,3144,368,21,67512,10.478359908883828
"Park City city, Kentucky",263,232,31,21,59232,11.787072243346007
"Junction City city, Kentucky",1021,885,136,21,41338,13.320274240940256
"Hendron CDP, Kentucky",2250,2078,172,21,35902,7.644444444444444
"Reidland CDP, Kentucky",1872,1805,67,21,64632,3.579059829059829
"Oakbrook CDP, Kentucky",3823,3655,168,21,57030,4.3944546167930945
"Salem city, Kentucky",365,294,71,21,68052,19.45205479452055
"Livermore city, Kentucky",714,580,134,21,47062,18.76750700280112
"Covington city, Kentucky",19911,16959,2952,21,17848,14.825975591381649
"Crescent Springs city, Kentucky",1603,1480,123,21,18352,7.673112913287586
"Villa Hills city, Kentucky",2907,2826,81,21,79698,2.786377708978328
"Nortonville city, Kentucky",588,422,166,21,56910,28.2312925170068
"Stearns CDP, Kentucky",437,372,65,21,73362,14.874141876430205
"Stamping Ground city, Kentucky",375,360,15,21,73038,4.0
"Franklin city, Kentucky",3820,3375,445,21,28918,11.649214659685864
"Corinth city, Kentucky",124,90,34,21,17434,27.419354838709676
"Campbellsville city, Kentucky",4964,4432,532,21,12160,10.717163577759871
"Island city, Kentucky",235,202,33,21,39700,14.042553191489363
"Paducah city, Kentucky",13352,11379,1973,21,58836,14.776812462552428
"Pleasureville city, Kentucky",440,377,63,21,61788,14.318181818181818
"Simpsonville city, Kentucky",1027,1027,0,21,70752,0.0
"Carrsville city, Kentucky",29,17,12,21,13060,41.37931034482759
"Massac CDP, Kentucky",2251,2101,150,21,50556,6.663705019991115
"Georgetown city, Kentucky",13304,12576,728,21,30700,5.472038484666266
"Edmonton city, Kentucky",822,741,81,21,23968,9.854014598540147
"Union city, Kentucky",1946,1946,0,21,78384,0.0
"Smithland city, Kentucky",169,135,34,21,71382,20.118343195266274
"Crab Orchard city, Kentucky",479,411,68,21,17956,14.19624217118998
"Calhoun city, Kentucky",351,328,23,21,11854,6.552706552706552
"Sacramento city, Kentucky",250,220,30,21,67638,12.0
"Smiths Grove city, Kentucky",386,337,49,21,71454,12.694300518134716
"Cawker City city, Kansas",362,264,98,20,11175,27.071823204419886
"Hunter city, Kansas",63,36,27,20,33525,42.857142857142854
"Scottsville city, Kansas",16,14,2,20,63650,12.5
"Harper city, Kansas",784,543,241,20,30175,30.739795918367346
"Peru city, Kansas",136,79,57,20,55525,41.911764705882355
"Fowler city, Kansas",247,214,33,20,24175,13.360323886639677
"Dodge City city, Kansas",9307,8745,562,20,18250,6.038465671000322
"Spearville city, Kansas",382,355,27,20,67125,7.068062827225131
"Collyer city, Kansas",47,31,16,20,14900,34.04255319148936
"Holcomb city, Kansas",697,673,24,20,32575,3.443328550932568
"Sylvan Grove city, Kansas",195,139,56,20,69775,28.717948717948715
"Seward city, Kansas",49,20,29,20,64100,59.183673469387756
"Thayer city, Kansas",294,257,37,20,70300,12.585034013605442
"Betsy Layne CDP, Kentucky",324,278,46,21,06220,14.19753086419753
"Boston CDP, Kentucky",56,56,0,21,08722,0.0
"Buffalo CDP, Kentucky",172,172,0,21,10774,0.0
"Burna CDP, Kentucky",115,61,54,21,11188,46.95652173913044
"Cannonsburg CDP, Kentucky",336,288,48,21,12610,14.285714285714285
"Cawood CDP, Kentucky",236,174,62,21,13582,26.27118644067797
"Cayce CDP, Kentucky",24,24,0,21,13600,0.0
"Cecilia CDP, Kentucky",199,199,0,21,13636,0.0
"Cerulean CDP, Kentucky",156,117,39,21,14068,25.0
"Chaplin CDP, Kentucky",189,128,61,21,14266,32.27513227513227
"Diablock CDP, Kentucky",370,223,147,21,21358,39.729729729729726
"Coldiron CDP, Kentucky",133,60,73,21,16354,54.88721804511278
"Crayne CDP, Kentucky",97,80,17,21,18190,17.525773195876287
"Dexter CDP, Kentucky",137,121,16,21,21322,11.678832116788321
"Doe Valley CDP, Kentucky",1015,762,253,21,21844,24.92610837438424
"Dwale CDP, Kentucky",69,69,0,21,23104,0.0
"Elizaville CDP, Kentucky",86,86,0,21,24292,0.0
"Emlyn CDP, Kentucky",185,173,12,21,24922,6.486486486486487
"Ezel CDP, Kentucky",98,67,31,21,25876,31.63265306122449
"Fairview CDP, Kentucky",54,54,0,21,26182,0.0
"Fancy Farm CDP, Kentucky",201,191,10,21,26452,4.975124378109453
"Farley CDP, Kentucky",2112,1780,332,21,26528,15.719696969696969
"Farmers CDP, Kentucky",99,15,84,21,26560,84.84848484848484
"Farmington CDP, Kentucky",110,78,32,21,26614,29.09090909090909
"Flat Lick CDP, Kentucky",425,425,0,21,27730,0.0
"Francisville CDP, Kentucky",2988,2915,73,21,28882,2.443105756358768
"Freeburn CDP, Kentucky",138,138,0,21,29134,0.0
"Garrison CDP, Kentucky",300,212,88,21,30232,29.333333333333332
"Gilbertsville CDP, Kentucky",323,248,75,21,30880,23.219814241486066
"Gracey CDP, Kentucky",31,31,0,21,32032,0.0
"Hardyville CDP, Kentucky",189,148,41,21,34660,21.693121693121693
"Hazel Green CDP, Kentucky",123,52,71,21,35398,57.72357723577236
"Hebron CDP, Kentucky",1935,1890,45,21,35542,2.3255813953488373
"High Bridge CDP, Kentucky",140,140,0,21,36460,0.0
"Hiseville CDP, Kentucky",136,107,29,21,37234,21.323529411764707
"Jeff CDP, Kentucky",138,91,47,21,40204,34.05797101449276
"Kenvir CDP, Kentucky",146,146,0,21,42112,0.0
"Lovelaceville CDP, Kentucky",47,17,30,21,48072,63.829787234042556
"Lowes CDP, Kentucky",50,26,24,21,48234,48.0
"McCarr CDP, Kentucky",61,51,10,21,48810,16.39344262295082
"Maceo CDP, Kentucky",160,160,0,21,49026,0.0
"Magnolia CDP, Kentucky",251,219,32,21,49476,12.749003984063744
"Manitou CDP, Kentucky",95,95,0,21,49746,0.0
"Marrowbone CDP, Kentucky",66,51,15,21,50124,22.727272727272727
"Mayking CDP, Kentucky",231,187,44,21,50952,19.047619047619047
"Mays Lick CDP, Kentucky",151,122,29,21,51006,19.205298013245034
"Millstone CDP, Kentucky",35,35,0,21,52464,0.0
"New Hope CDP, Kentucky",71,71,0,21,55794,0.0
"Oneida CDP, Kentucky",188,142,46,21,58062,24.46808510638298
"Onton CDP, Kentucky",49,25,24,21,58116,48.97959183673469
"Midway city, Kentucky",741,634,107,21,52140,14.439946018893387
"Plain Dealing town, Louisiana",550,397,153,22,60670,27.81818181818182
"Red Chute CDP, Louisiana",2759,2684,75,22,63855,2.7183762232693005
"Baskin village, Louisiana",108,93,15,22,04615,13.88888888888889
"Port Barre town, Louisiana",874,694,180,22,61825,20.59496567505721
"Grosse Tete village, Louisiana",410,311,99,22,32020,24.146341463414632
"Grand Coteau town, Louisiana",374,306,68,22,30760,18.181818181818183
"Leonville town, Louisiana",386,351,35,22,43395,9.067357512953368
"Montegut CDP, Louisiana",660,617,43,22,51550,6.515151515151516
"Lydia CDP, Louisiana",323,323,0,22,46755,0.0
"Westminster CDP, Louisiana",1318,1208,110,22,80920,8.34597875569044
"Grand Cane village, Louisiana",156,124,32,22,30690,20.51282051282051
"Cut Off CDP, Louisiana",2681,2283,398,22,18930,14.845207012308839
"Raceland CDP, Louisiana",4432,4026,406,22,63155,9.160649819494585
"Waterproof town, Louisiana",453,282,171,22,79940,37.74834437086093
"Paradis CDP, Louisiana",653,510,143,22,58920,21.898928024502297
"St. Rose CDP, Louisiana",3280,2908,372,22,67740,11.341463414634147
"Ponchatoula city, Louisiana",2923,2672,251,22,61615,8.587068080738968
"Keachi town, Louisiana",140,121,19,22,39085,13.571428571428571
"Dodson village, Louisiana",163,142,21,22,21170,12.883435582822086
"Lisbon village, Louisiana",107,57,50,22,44235,46.728971962616825
"Midway CDP, Louisiana",607,488,119,22,50395,19.604612850082372
"Mansfield city, Louisiana",2193,1746,447,22,48365,20.383036935704517
"Chackbay CDP, Louisiana",2170,1980,190,22,14100,8.755760368663594
"Golden Meadow town, Louisiana",1020,778,242,22,29640,23.72549019607843
"Scott city, Louisiana",3886,3308,578,22,68475,14.873906330416881
"Newellton town, Louisiana",568,413,155,22,53930,27.2887323943662
"Mooringsport town, Louisiana",312,261,51,22,51830,16.346153846153847
"Avondale CDP, Louisiana",1855,1725,130,22,03810,7.008086253369273
"Bridge City CDP, Louisiana",3197,2505,692,22,09480,21.64529246168283
"Jean Lafitte town, Louisiana",672,611,61,22,38092,9.077380952380953
"Jefferson CDP, Louisiana",5778,4972,806,22,38145,13.949463482173762
"Lafitte CDP, Louisiana",423,362,61,22,40840,14.420803782505912
"Ashland village, Louisiana",148,96,52,22,03145,35.13513513513514
"Boyce town, Louisiana",564,459,105,22,09165,18.617021276595743
"Claiborne CDP, Louisiana",5613,4565,1048,22,15605,18.670942455015144
"West Monroe city, Louisiana",6423,5284,1139,22,80955,17.73314650474856
"North Vacherie CDP, Louisiana",845,737,108,22,56170,12.781065088757396
"Kaplan city, Louisiana",1975,1681,294,22,39055,14.88607594936709
"St. Martinville city, Louisiana",2839,2369,470,22,67600,16.555125044029587
"Gueydan town, Louisiana",703,538,165,22,32055,23.470839260312946
"Longstreet village, Louisiana",81,54,27,22,45460,33.33333333333333
"Metairie CDP, Louisiana",64833,59798,5035,22,50115,7.766106766615767
"Terrytown CDP, Louisiana",9426,8474,952,22,75180,10.099724167197115
"Woodmere CDP, Louisiana",3948,3507,441,22,83002,11.170212765957446
"Clarence village, Louisiana",177,141,36,22,15745,20.33898305084746
"Robeline village, Louisiana",97,51,46,22,65325,47.42268041237113
"Ball town, Louisiana",1565,1368,197,22,04055,12.587859424920127
"Berwick town, Louisiana",1863,1689,174,22,07100,9.339774557165862
"Franklin city, Louisiana",3108,2631,477,22,27155,15.347490347490348
"Pearl River town, Louisiana",1014,874,140,22,59445,13.806706114398423
"New Roads city, Louisiana",2172,1784,388,22,55105,17.863720073664823
"Mansura town, Louisiana",900,759,141,22,48400,15.666666666666668
"Plaucheville village, Louisiana",124,105,19,22,60985,15.32258064516129
"Clinton town, Louisiana",936,762,174,22,15990,18.58974358974359
"Gramercy town, Louisiana",1423,1278,145,22,30550,10.189739985945186
"Olla town, Louisiana",726,587,139,22,57905,19.146005509641874
"Lockport town, Louisiana",1095,954,141,22,44900,12.876712328767123
"Blanchard town, Louisiana",1269,1163,106,22,07730,8.353033884948777
"Gilliam village, Louisiana",63,46,17,22,29010,26.984126984126984
"Waggaman CDP, Louisiana",3716,3362,354,22,79100,9.526372443487622
"Pathfork CDP, Kentucky",242,200,42,21,59466,17.355371900826448
"Payne Gap CDP, Kentucky",203,147,56,21,59592,27.586206896551722
"Petersburg CDP, Kentucky",199,199,0,21,60312,0.0
"Plano CDP, Kentucky",397,397,0,21,61536,0.0
"Pleasant View CDP, Kentucky",212,212,0,21,61734,0.0
"Pryorsburg CDP, Kentucky",109,109,0,21,63426,0.0
"Rabbit Hash CDP, Kentucky",138,138,0,21,63804,0.0
"Rockholds CDP, Kentucky",120,102,18,21,66162,15.0
"Rosine CDP, Kentucky",81,65,16,21,66846,19.753086419753085
"Salvisa CDP, Kentucky",155,95,60,21,68214,38.70967741935484
"Sedalia CDP, Kentucky",154,134,20,21,69258,12.987012987012985
"South Williamson CDP, Kentucky",341,240,101,21,72264,29.61876832844575
"Spottsville CDP, Kentucky",224,170,54,21,72570,24.107142857142858
"Summer Shade CDP, Kentucky",128,99,29,21,74586,22.65625
"Verona CDP, Kentucky",546,546,0,21,79464,0.0
"Summersville CDP, Kentucky",280,244,36,21,74604,12.857142857142856
"Symsonia CDP, Kentucky",266,198,68,21,75270,25.563909774436087
"Tolu CDP, Kentucky",38,38,0,21,77124,0.0
"Virgie CDP, Kentucky",94,68,26,21,79860,27.659574468085108
"Westport CDP, Kentucky",140,121,19,21,81948,13.571428571428571
"Wallins Creek CDP, Kentucky",167,148,19,21,80310,11.377245508982035
"Water Valley CDP, Kentucky",136,101,35,21,80832,25.735294117647058
"Allensville CDP, Kentucky",78,78,0,21,01000,0.0
"Dunmor CDP, Kentucky",133,85,48,21,23014,36.09022556390977
"Elk Creek CDP, Kentucky",626,589,37,21,24328,5.9105431309904155
"Maytown CDP, Kentucky",137,95,42,21,51042,30.656934306569344
"Ages CDP, Kentucky",152,152,0,21,00514,0.0
"Anthoston CDP, Kentucky",85,85,0,21,01720,0.0
"Arjay CDP, Kentucky",209,188,21,21,01972,10.047846889952153
"Belfry CDP, Kentucky",141,141,0,21,05266,0.0
"Big Clifty CDP, Kentucky",132,132,0,21,06508,0.0
"Cleaton CDP, Kentucky",129,90,39,21,15490,30.23255813953488
"Combs CDP, Kentucky",162,113,49,21,16822,30.246913580246915
"Coxton CDP, Kentucky",70,70,0,21,17938,0.0
"Cunningham CDP, Kentucky",148,136,12,21,19234,8.108108108108109
"Hickory CDP, Kentucky",66,66,0,21,36316,0.0
"Ironville CDP, Kentucky",326,326,0,21,39592,0.0
"McDowell CDP, Kentucky",384,302,82,21,48954,21.354166666666664
"McKinney CDP, Kentucky",71,71,0,21,49134,0.0
"Poole CDP, Kentucky",107,73,34,21,62202,31.775700934579437
"Rineyville CDP, Kentucky",974,923,51,21,65388,5.236139630390143
"Utica CDP, Kentucky",128,118,10,21,78708,7.8125
"South Park View city, Kentucky",1,1,0,21,72138,0.0
"Spring Mill city, Kentucky",101,95,6,21,72770,5.9405940594059405
"Strathmoor Village city, Kentucky",286,274,12,21,74082,4.195804195804196
"Sycamore city, Kentucky",79,79,0,21,75190,0.0
"Flatwoods city, Kentucky",3403,2983,420,21,27802,12.342051131354687
"Russell city, Kentucky",1548,1310,238,21,67458,15.374677002583978
"Evarts city, Kentucky",250,191,59,21,25606,23.599999999999998
"Loyall city, Kentucky",353,284,69,21,48288,19.54674220963173
"Lynch city, Kentucky",456,291,165,21,48540,36.18421052631579
"McKee city, Kentucky",578,496,82,21,49116,14.186851211072666
"Blue Ridge Manor city, Kentucky",459,427,32,21,07858,6.971677559912854
"Cambridge city, Kentucky",96,79,17,21,12066,17.708333333333336
"Bowling Green city, Kentucky",26829,24176,2653,21,08902,9.888553430988855
"Glencoe city, Kentucky",147,106,41,21,31204,27.89115646258503
"Monticello city, Kentucky",2885,2313,572,21,53130,19.826689774696707
"Versailles city, Kentucky",4001,3689,312,21,79482,7.7980504873781555
"Jackson city, Kentucky",1013,838,175,21,39952,17.275419545903258
"Masonville CDP, Kentucky",450,422,28,21,50520,6.222222222222222
"Crittenden city, Kentucky",1530,1326,204,21,18568,13.333333333333334
"Hawesville city, Kentucky",475,413,62,21,35200,13.052631578947368
"Natchitoches city, Louisiana",7816,6260,1556,22,53545,19.907881269191403
"Garyville CDP, Louisiana",1048,761,287,22,28345,27.385496183206108
"Reserve CDP, Louisiana",3923,3325,598,22,64310,15.243436145806779
"Wallace CDP, Louisiana",349,261,88,22,79275,25.214899713467048
"Homer town, Louisiana",1632,1282,350,22,35870,21.44607843137255
"DeQuincy city, Louisiana",1381,1012,369,22,20575,26.71976828385228
"Bayou Gauche CDP, Louisiana",661,661,0,22,05315,0.0
"Hammond city, Louisiana",7706,6604,1102,22,32755,14.300545029846873
"Natalbany CDP, Louisiana",1313,1075,238,22,53475,18.126428027418125
"Gray CDP, Louisiana",2185,1996,189,22,31180,8.649885583524028
"Calvin village, Louisiana",99,71,28,22,11930,28.28282828282828
"Donaldsonville city, Louisiana",3224,2900,324,22,21240,10.049627791563276
"Franklinton town, Louisiana",2073,1672,401,22,27190,19.343945972021224
"Loreauville village, Louisiana",354,295,59,22,45670,16.666666666666664
"Baton Rouge city, Louisiana",101691,85263,16428,22,05000,16.154821960645485
"Monticello CDP, Louisiana",2029,1708,321,22,51645,15.82060128141942
"Stanley village, Louisiana",66,54,12,22,72800,18.181818181818183
"River Ridge CDP, Louisiana",6198,5545,653,22,65150,10.53565666343982
"Goldonna village, Louisiana",195,137,58,22,29745,29.743589743589745
"Provencal village, Louisiana",311,219,92,22,62770,29.581993569131832
"Forest Hill village, Louisiana",327,260,67,22,26420,20.489296636085626
"Woodworth town, Louisiana",639,549,90,22,83125,14.084507042253522
"Baker city, Louisiana",5451,4827,624,22,03985,11.447440836543754
"Inniswold CDP, Louisiana",2690,2476,214,22,37270,7.95539033457249
"Shenandoah CDP, Louisiana",7503,7323,180,22,69225,2.3990403838464616
"Ridgecrest town, Louisiana",395,337,58,22,64765,14.683544303797468
"Empire CDP, Louisiana",557,492,65,22,23725,11.669658886894076
"Washington town, Louisiana",459,358,101,22,79870,22.004357298474943
"Angie village, Louisiana",140,120,20,22,02165,14.285714285714285
"Gardere CDP, Louisiana",5190,4329,861,22,28275,16.589595375722542
"Oak Hills Place CDP, Louisiana",4399,3889,510,22,56855,11.593543987269834
"Old Jefferson CDP, Louisiana",3371,2769,602,22,57705,17.858202313853454
"Zachary city, Louisiana",5918,5517,401,22,83405,6.775937816830011
"South Mansfield village, Louisiana",203,153,50,22,71820,24.63054187192118
"Stonewall town, Louisiana",997,923,74,22,73395,7.422266800401204
"Oak Ridge village, Louisiana",68,54,14,22,57205,20.588235294117645
"Iowa town, Louisiana",1438,1261,177,22,37445,12.308762169680111
"Bastrop city, Louisiana",5049,3880,1169,22,04685,23.153099623687858
"Collinston village, Louisiana",172,121,51,22,16655,29.651162790697676
"Springfield town, Louisiana",219,191,28,22,72415,12.785388127853881
"Destrehan CDP, Louisiana",4393,4173,220,22,20820,5.007967220578193
"Timberlane CDP, Louisiana",3613,3379,234,22,75740,6.476612233600886
"Westwego city, Louisiana",4105,3415,690,22,81165,16.808769792935443
"Abita Springs town, Louisiana",1114,1018,96,22,00240,8.617594254937163
"Slidell city, Louisiana",11215,10168,1047,22,70805,9.335711101203744
"Hall Summit village, Louisiana",187,142,45,22,32650,24.06417112299465
"Rayville town, Louisiana",1647,1388,259,22,63680,15.725561627200971
"Montpelier village, Louisiana",140,121,19,22,51690,13.571428571428571
"Greenwood town, Louisiana",1509,1321,188,22,31705,12.458581842279655
"Hosston village, Louisiana",148,106,42,22,36150,28.37837837837838
"Shreveport city, Louisiana",88938,75842,13096,22,70000,14.724864512356922
"Vivian town, Louisiana",1719,1383,336,22,78890,19.546247818499126
"Jennings city, Louisiana",4728,3773,955,22,38355,20.19881556683587
"Grand Isle town, Louisiana",2046,335,1711,22,30830,83.62658846529814
"Gretna city, Louisiana",8119,7120,999,22,31915,12.304470993964774
"Harahan city, Louisiana",4074,3752,322,22,32930,7.903780068728522
"Harvey CDP, Louisiana",9142,8198,944,22,33245,10.325968059505579
"Lecompte town, Louisiana",573,393,180,22,42800,31.413612565445025
"Pineville city, Louisiana",5827,4911,916,22,60530,15.719924489445683
"Charenton CDP, Louisiana",825,745,80,22,14310,9.696969696969697
"Covington city, Louisiana",4184,3650,534,22,18125,12.762906309751434
"Sonora city, Kentucky",291,247,44,21,71724,15.120274914089347
"Westwood CDP, Kentucky",2147,1880,267,21,82146,12.435957149510946
"Jeffersontown city, Kentucky",11877,11313,564,21,40222,4.748673907552412
"Milton city, Kentucky",363,321,42,21,52590,11.570247933884298
"Greensburg city, Kentucky",1134,951,183,21,32968,16.137566137566136
"Plum Springs city, Kentucky",197,183,14,21,61860,7.1065989847715745
"Wheelwright city, Kentucky",340,218,122,21,82272,35.88235294117647
"Wingo city, Kentucky",316,264,52,21,83856,16.455696202531644
"Benham city, Kentucky",294,214,80,21,05662,27.2108843537415
"Audubon Park city, Kentucky",604,577,27,21,02656,4.470198675496689
"Bancroft city, Kentucky",185,181,4,21,03376,2.1621621621621623
"South Wallins CDP, Kentucky",314,260,54,21,72255,17.197452229299362
"Hodgenville city, Kentucky",1394,1250,144,21,37396,10.329985652797705
"Upton city, Kentucky",325,278,47,21,78672,14.461538461538462
"Bellemeade city, Kentucky",423,389,34,21,05392,8.037825059101655
"Bellewood city, Kentucky",129,128,1,21,05464,0.7751937984496124
"Crossgate city, Kentucky",87,87,0,21,18766,0.0
"Goose Creek city, Kentucky",119,112,7,21,31870,5.88235294117647
"Norbourne Estates city, Kentucky",175,165,10,21,56550,5.714285714285714
"Fincastle city, Kentucky",312,290,22,21,27262,7.051282051282051
"Hurstbourne Acres city, Kentucky",1108,999,109,21,38818,9.83754512635379
"Parkway Village city, Kentucky",326,324,2,21,59322,0.6134969325153374
"St. Matthews city, Kentucky",9394,8812,582,21,67944,6.1954439003619335
"Strathmoor Manor city, Kentucky",130,128,2,21,74064,1.5384615384615385
"Watterson Park city, Kentucky",564,525,39,21,80913,6.914893617021277
"Wellington city, Kentucky",234,221,13,21,81372,5.555555555555555
"East Bernstadt CDP, Kentucky",365,326,39,21,23284,10.684931506849315
"Blackey city, Kentucky",84,78,6,21,07012,7.142857142857142
"Oakland city, Kentucky",127,116,11,21,57144,8.661417322834646
"Sanders city, Kentucky",83,74,9,21,68358,10.843373493975903
"Worthville city, Kentucky",98,62,36,21,84900,36.734693877551024
"Liberty city, Kentucky",894,787,107,21,46072,11.968680089485458
"Dry Ridge city, Kentucky",890,855,35,21,22582,3.932584269662921
"Wurtland city, Kentucky",614,550,64,21,85008,10.423452768729643
"Horse Cave city, Kentucky",1204,1040,164,21,38008,13.621262458471762
"Eminence city, Kentucky",1116,985,131,21,24904,11.738351254480287
"Briarwood city, Kentucky",256,249,7,21,09532,2.734375
"Douglass Hills city, Kentucky",2521,2341,180,21,22204,7.140023800079335
"Druid Hills city, Kentucky",170,162,8,21,22474,4.705882352941177
"Glenview city, Kentucky",207,191,16,21,31348,7.729468599033816
"Glenview Manor city, Kentucky",98,98,0,21,31420,0.0
"Hills and Dales city, Kentucky",67,67,0,21,36865,0.0
"Hollow Creek city, Kentucky",310,308,2,21,37576,0.6451612903225806
"Hollyvilla city, Kentucky",208,190,18,21,37630,8.653846153846153
"Meadowview Estates city, Kentucky",244,221,23,21,51294,9.426229508196721
"Kingsley city, Kentucky",183,183,0,21,42598,0.0
"Manor Creek city, Kentucky",117,115,2,21,49800,1.7094017094017095
"Meadow Vale city, Kentucky",298,290,8,21,51258,2.684563758389262
"Richlawn city, Kentucky",173,171,2,21,65208,1.1560693641618496
"Woodburn city, Kentucky",125,121,4,21,84414,3.2
"Middlesborough city, Kentucky",4737,3968,769,21,51924,16.23390331433397
"North Middletown city, Kentucky",291,262,29,21,56820,9.965635738831615
"Ashland city, Kentucky",10291,8753,1538,21,02368,14.945097658147896
"Owensboro city, Kentucky",27250,25155,2095,21,58620,7.6880733944954125
"Warsaw city, Kentucky",910,783,127,21,80706,13.956043956043956
"South Shore city, Kentucky",532,409,123,21,72210,23.1203007518797
"Anchorage city, Kentucky",809,740,69,21,01504,8.529048207663783
"Vine Grove city, Kentucky",2507,2252,255,21,79734,10.1715197447148
"Harlan city, Kentucky",896,732,164,21,34732,18.303571428571427
"Forest Hills city, Kentucky",165,158,7,21,28342,4.242424242424243
"Lake Charles city, Louisiana",36744,32012,4732,22,41155,12.87829305464838
"Hickory Hill city, Kentucky",43,43,0,21,36374,0.0
"Laplace CDP, Louisiana",11341,10236,1105,22,42030,9.743408870469976
"Carlyss CDP, Louisiana",2216,1768,448,22,12840,20.216606498194945
"Walker town, Louisiana",2641,2368,273,22,79240,10.3369935630443
"Ama CDP, Louisiana",537,496,41,22,01780,7.635009310986965
"Taft CDP, Louisiana",66,41,25,22,74550,37.878787878787875
"Kentwood town, Louisiana",1055,869,186,22,39545,17.6303317535545
"Tullos town, Louisiana",232,163,69,22,76615,29.74137931034483
"Napoleonville village, Louisiana",275,223,52,22,53370,18.90909090909091
"Benton town, Louisiana",965,831,134,22,06925,13.8860103626943
"Gilbert village, Louisiana",257,215,42,22,28940,16.342412451361866
"Mound village, Louisiana",3,2,1,22,52565,33.33333333333333
"Bienville village, Louisiana",169,94,75,22,07205,44.37869822485207
"Ville Platte city, Louisiana",3832,2997,835,22,78715,21.790187891440503
"Gibsland town, Louisiana",444,305,139,22,28835,31.306306306306308
"Mount Lebanon town, Louisiana",41,18,23,22,52740,56.09756097560976
"Turkey Creek village, Louisiana",193,162,31,22,76685,16.06217616580311
"Cottonport town, Louisiana",882,713,169,22,17880,19.160997732426306
"Morganza village, Louisiana",338,283,55,22,52075,16.272189349112427
"Arcadia town, Louisiana",1358,1107,251,22,02655,18.483063328424155
"Castor village, Louisiana",158,127,31,22,13260,19.62025316455696
"Richwood town, Louisiana",671,531,140,22,64660,20.864381520119224
"Parks village, Louisiana",358,306,52,22,59165,14.52513966480447
"South Vacherie CDP, Louisiana",1427,1288,139,22,72092,9.74071478626489
"Sorrento town, Louisiana",766,689,77,22,71225,10.052219321148826
"Merryville town, Louisiana",616,494,122,22,50010,19.805194805194805
"Plaquemine city, Louisiana",2943,2468,475,22,60880,16.139993204213386
"White Castle town, Louisiana",895,744,151,22,81375,16.87150837988827
"Simsboro village, Louisiana",423,352,71,22,70630,16.78486997635934
"Cankton village, Louisiana",245,226,19,22,12420,7.755102040816326
"Krotz Springs town, Louisiana",483,395,88,22,40280,18.219461697722565
"Chauvin CDP, Louisiana",1095,927,168,22,14520,15.342465753424658
"Oakdale city, Louisiana",2793,2092,701,22,56540,25.098460436806302
"Lake Providence town, Louisiana",1768,1344,424,22,41400,23.981900452488688
"St. Joseph town, Louisiana",534,375,159,22,67495,29.775280898876407
"Fenton village, Louisiana",160,141,19,22,25335,11.875
"Hessmer village, Louisiana",489,414,75,22,34015,15.337423312883436
"Iota town, Louisiana",800,679,121,22,37410,15.125
"Prien CDP, Louisiana",3042,2824,218,22,62647,7.166337935568705
"Killona CDP, Louisiana",222,197,25,22,39720,11.26126126126126
"Junction City village, Louisiana",280,217,63,22,38985,22.5
"Erath town, Louisiana",937,863,74,22,24180,7.897545357524013
"Kenner city, Louisiana",27926,24918,3008,22,39475,10.771324213994127
"Natchez village, Louisiana",338,233,105,22,53510,31.06508875739645
"Addis town, Louisiana",1884,1684,200,22,00415,10.615711252653929
"Mathews CDP, Louisiana",1022,942,80,22,49170,7.8277886497064575
"Powhatan village, Louisiana",139,80,59,22,62245,42.44604316546763
"Deville CDP, Louisiana",562,504,58,22,20890,10.320284697508896
"Brusly town, Louisiana",1111,1050,61,22,10600,5.4905490549054905
"Breaux Bridge city, Louisiana",3541,3075,466,22,09340,13.16012425868399
"Paincourtville CDP, Louisiana",394,309,85,22,58745,21.573604060913706
"Bayou Vista CDP, Louisiana",2123,1877,246,22,05525,11.587376354215733
"Madisonville town, Louisiana",363,318,45,22,47560,12.396694214876034
"Forest village, Louisiana",139,114,25,22,26350,17.985611510791365
"Edgard CDP, Louisiana",927,718,209,22,22815,22.54584681769148
"Chatham town, Louisiana",410,288,122,22,14485,29.756097560975608
"Crowley city, Louisiana",6113,4986,1127,22,18650,18.436119744806152
"Rosedale village, Louisiana",382,334,48,22,66060,12.56544502617801
"Anacoco village, Louisiana",442,383,59,22,01920,13.34841628959276
"Mamou town, Louisiana",1204,1046,158,22,48085,13.122923588039868
"Florien village, Louisiana",311,236,75,22,25860,24.115755627009648
"Indian Hills city, Kentucky",1136,1099,37,21,39304,3.2570422535211265
"Mockingbird Valley city, Kentucky",71,65,6,21,52842,8.450704225352112
"Old Brownsboro Place city, Kentucky",166,151,15,21,57658,9.036144578313253
"Beattyville city, Kentucky",671,598,73,21,04546,10.879284649776453
"Fleming-Neon city, Kentucky",377,272,105,21,27846,27.851458885941643
"Owenton city, Kentucky",753,681,72,21,58692,9.56175298804781
"Ekron city, Kentucky",116,103,13,21,24094,11.206896551724139
"Lebanon city, Kentucky",2853,2693,160,21,44344,5.608131791097091
"Raywick city, Kentucky",68,68,0,21,64146,0.0
"Calvert City city, Kentucky",1233,1033,200,21,12016,16.220600162206
"La Grange city, Kentucky",3415,3203,212,21,43480,6.207906295754027
"River Bluff city, Kentucky",161,158,3,21,65559,1.8633540372670807
"Lakeview Heights city, Kentucky",133,120,13,21,43668,9.774436090225564
"Ravenna city, Kentucky",269,232,37,21,64092,13.754646840148698
"Crestview Hills city, Kentucky",1496,1439,57,21,18442,3.8101604278074865
"Erlanger city, Kentucky",7692,7093,599,21,25300,7.787311492459699
"Princeton city, Kentucky",2878,2492,386,21,63138,13.412091730368312
"Alexandria city, Kentucky",3502,3300,202,21,00802,5.768132495716733
"Claryville CDP, Kentucky",938,871,67,21,15166,7.142857142857142
"Mentor city, Kentucky",130,101,29,21,51564,22.30769230769231
"Clinton city, Kentucky",646,486,160,21,15742,24.76780185758514
"Edgewood city, Kentucky",3509,3289,220,21,23932,6.269592476489027
"Fort Mitchell city, Kentucky",3338,3170,168,21,28558,5.032953864589575
"Irvington city, Kentucky",578,550,28,21,39664,4.844290657439446
"Perryville city, Kentucky",465,405,60,21,60258,12.903225806451612
"Clay City city, Kentucky",578,487,91,21,15238,15.7439446366782
"Brodhead city, Kentucky",576,478,98,21,09838,17.01388888888889
"Trenton city, Kentucky",214,195,19,21,77592,8.878504672897195
"Drakesboro city, Kentucky",185,144,41,21,22348,22.162162162162165
"Mount Vernon city, Kentucky",1235,997,238,21,54174,19.271255060728745
"Guthrie city, Kentucky",771,617,154,21,33562,19.974059662775616
"Hindman city, Kentucky",355,237,118,21,37108,33.23943661971831
"Brooksville city, Kentucky",330,303,27,21,10000,8.181818181818182
"Lebanon Junction city, Kentucky",799,755,44,21,44362,5.506883604505632
"Cold Spring city, Kentucky",2762,2746,16,21,16372,0.5792903692976104
"Hickman city, Kentucky",1101,855,246,21,36298,22.3433242506812
"Earlington city, Kentucky",791,581,210,21,23230,26.548672566371685
"Whitley City CDP, Kentucky",843,690,153,21,82938,18.14946619217082
"Manchester city, Kentucky",719,628,91,21,49656,12.656467315716272
"Irvine city, Kentucky",1320,1024,296,21,39646,22.424242424242426
"Crofton city, Kentucky",327,258,69,21,18658,21.100917431192663
"Winchester city, Kentucky",8412,7592,820,21,83676,9.747979077508322
"Lancaster city, Kentucky",1708,1552,156,21,43840,9.133489461358314
"Cynthiana city, Kentucky",2831,2425,406,21,19432,14.341222182974214
"Robards city, Kentucky",221,191,30,21,65874,13.574660633484163
"Rockport city, Kentucky",120,89,31,21,66216,25.833333333333336
"Leitchfield city, Kentucky",3147,2807,340,21,44686,10.803940260565618
"Columbia city, Kentucky",1982,1687,295,21,16750,14.883955600403635
"Sturgis city, Kentucky",888,752,136,21,74316,15.315315315315313
"Louisa city, Kentucky",1242,1082,160,21,47854,12.88244766505636
"Beaver Dam city, Kentucky",1497,1434,63,21,04654,4.208416833667335
"Hartford city, Kentucky",1177,1068,109,21,35020,9.260832625318606
"Russell Springs city, Kentucky",1163,1005,158,21,67494,13.585554600171971
"Waverly city, Kentucky",153,148,5,21,80958,3.2679738562091507
"Barlow city, Kentucky",369,257,112,21,03718,30.35230352303523
"La Center city, Kentucky",408,334,74,21,43336,18.137254901960784
"Harrodsburg city, Kentucky",4002,3562,440,21,34966,10.994502748625687
"Bloomfield city, Kentucky",459,360,99,21,07516,21.568627450980394
"Glasgow city, Kentucky",6821,6013,808,21,31114,11.845770414895176
"Ledbetter CDP, Kentucky",784,702,82,21,44434,10.459183673469388
"Hustonville city, Kentucky",269,233,36,21,38836,13.382899628252787
"Elmwood CDP, Louisiana",3274,2943,331,22,23567,10.109957238851559
"Sunset town, Louisiana",1290,1101,189,22,74060,14.651162790697676
"Brownfields CDP, Louisiana",2134,1998,136,22,10145,6.373008434864105
"Grambling city, Louisiana",2098,1779,319,22,30515,15.204957102001906
"St. Gabriel city, Louisiana",1888,1563,325,22,67250,17.21398305084746
"Slaughter town, Louisiana",465,437,28,22,70770,6.021505376344086
"Broussard city, Louisiana",4608,4147,461,22,10075,10.004340277777777
"DeRidder city, Louisiana",4586,3764,822,22,20610,17.92411687745312
"Killian town, Louisiana",804,553,251,22,39685,31.218905472636816
"Central city, Louisiana",11295,10278,1017,22,13960,9.00398406374502
"Creola village, Louisiana",57,44,13,22,18295,22.807017543859647
"Youngsville city, Louisiana",4358,4143,215,22,83335,4.933455713630106
"Banks Springs CDP, Louisiana",551,439,112,22,04230,20.326678765880217
"Bawcomville CDP, Louisiana",1694,1219,475,22,05105,28.040141676505314
"Bayou Blue CDP, Louisiana",4411,4032,379,22,05175,8.592155973702107
"Bayou Country Club CDP, Louisiana",532,532,0,22,05260,0.0
"Bayou Goula CDP, Louisiana",187,187,0,22,05350,0.0
"Bayou L'Ourse CDP, Louisiana",740,569,171,22,05378,23.10810810810811
"Belmont CDP, Louisiana",113,98,15,22,06750,13.274336283185843
"Boothville CDP, Louisiana",403,288,115,22,08710,28.53598014888337
"Bordelonville CDP, Louisiana",303,248,55,22,08745,18.151815181518153
"Bourg CDP, Louisiana",1021,862,159,22,09095,15.572967678746327
"Branch CDP, Louisiana",98,63,35,22,09235,35.714285714285715
"Brownsville CDP, Louisiana",2189,1615,574,22,10225,26.22201918684331
"Buras CDP, Louisiana",484,398,86,22,10985,17.768595041322314
"Cade CDP, Louisiana",747,697,50,22,11580,6.693440428380187
"Calhoun CDP, Louisiana",407,198,209,22,11825,51.35135135135135
"Catahoula CDP, Louisiana",460,446,14,22,13330,3.0434782608695654
"Center Point CDP, Louisiana",148,139,9,22,13855,6.081081081081082
"Choctaw CDP, Louisiana",304,288,16,22,15150,5.263157894736842
"Convent CDP, Louisiana",261,138,123,22,17180,47.12643678160919
"Crescent CDP, Louisiana",275,167,108,22,18335,39.27272727272727
"Egan CDP, Louisiana",243,243,0,22,23025,0.0
"Erwinville CDP, Louisiana",975,918,57,22,24250,5.846153846153846
"Amite City town, Louisiana",1673,1513,160,22,01885,9.563658099222954
"Sikes village, Louisiana",102,86,16,22,70385,15.686274509803921
"Winnfield city, Louisiana",2614,2022,592,22,82460,22.64728385615914
"Evergreen town, Louisiana",146,144,2,22,24775,1.36986301369863
"Simmesport town, Louisiana",812,663,149,22,70525,18.34975369458128
"Henderson town, Louisiana",771,676,95,22,33875,12.321660181582361
"Cheneyville town, Louisiana",334,252,82,22,14660,24.550898203592812
"McNary village, Louisiana",116,73,43,22,47315,37.06896551724138
"Amelia CDP, Louisiana",1060,774,286,22,01815,26.9811320754717
"Baldwin town, Louisiana",979,862,117,22,04020,11.95097037793667
"Mandeville city, Louisiana",4991,4679,312,22,48225,6.251252254057303
"Lucky village, Louisiana",150,112,38,22,46370,25.333333333333336
"Bunkie city, Louisiana",1974,1544,430,22,10950,21.783181357649443
"Moreauville village, Louisiana",519,481,38,22,51970,7.321772639691715
"Clarks village, Louisiana",256,194,62,22,15780,24.21875
"Swartz CDP, Louisiana",1798,1638,160,22,74340,8.898776418242491
"Cecilia CDP, Louisiana",877,696,181,22,13575,20.63854047890536
"Maurice village, Louisiana",577,547,30,22,49240,5.1993067590987865
"Columbia town, Louisiana",202,166,36,22,16830,17.82178217821782
"Supreme CDP, Louisiana",242,208,34,22,74235,14.049586776859504
"Eastwood CDP, Louisiana",2088,1858,230,22,22610,11.015325670498084
"Winnsboro city, Louisiana",1974,1597,377,22,82495,19.098277608915907
"Glenmora town, Louisiana",606,461,145,22,29220,23.927392739273927
"Patterson city, Louisiana",2800,2265,535,22,59340,19.107142857142854
"Lacombe CDP, Louisiana",4033,3357,676,22,40665,16.76171584428465
"Port Allen city, Louisiana",2438,2162,276,22,61790,11.320754716981133
"Edgefield village, Louisiana",131,110,21,22,22850,16.030534351145036
"Stanford city, Kentucky",1655,1494,161,21,73110,9.728096676737161
"Slaughters city, Kentucky",111,92,19,21,71130,17.117117117117118
"Butler city, Kentucky",296,252,44,21,11530,14.864864864864865
"Elkton city, Kentucky",987,821,166,21,24400,16.818642350557244
"Sebree city, Kentucky",506,440,66,21,69222,13.043478260869565
"Owingsville city, Kentucky",903,801,102,21,58710,11.295681063122924
"Wilmore city, Kentucky",1963,1761,202,21,83550,10.290371879775853
"Pippa Passes city, Kentucky",70,50,20,21,61374,28.57142857142857
"Brooks CDP, Kentucky",1063,987,76,21,09964,7.149576669802446
"Fox Chase city, Kentucky",204,204,0,21,28785,0.0
"Hebron Estates city, Kentucky",488,475,13,21,35545,2.663934426229508
"California city, Kentucky",53,41,12,21,11872,22.641509433962266
"Southgate city, Kentucky",1831,1742,89,21,71976,4.860731840524304
"Bardwell city, Kentucky",371,258,113,21,03664,30.45822102425876
"Wilder city, Kentucky",1425,1354,71,21,83172,4.982456140350877
"Woodlawn city, Kentucky",82,75,7,21,84522,8.536585365853659
"Ewing city, Kentucky",136,97,39,21,25786,28.676470588235293
"Pineville city, Kentucky",953,839,114,21,61248,11.962224554039874
"Carrollton city, Kentucky",1693,1451,242,21,13024,14.294152392203188
"Prestonville city, Kentucky",66,51,15,21,62958,22.727272727272727
"Martin city, Kentucky",326,253,73,21,50286,22.392638036809817
"Fort Campbell North CDP, Kentucky",3352,3001,351,21,28486,10.471360381861574
"LaFayette city, Kentucky",112,92,20,21,43444,17.857142857142858
"Scottsville city, Kentucky",2117,1760,357,21,69114,16.863486065186585
"Kevil city, Kentucky",329,279,50,21,42292,15.19756838905775
"Burgin city, Kentucky",537,439,98,21,11044,18.24953445065177
"Bardstown city, Kentucky",5806,5210,596,21,03628,10.26524285222184
"Burlington CDP, Kentucky",6184,5941,243,21,11170,3.9294954721862876
"Florence city, Kentucky",13687,12941,746,21,27982,5.4504274128735295
"Sadieville city, Kentucky",195,132,63,21,67656,32.30769230769231
"Shelbyville city, Kentucky",6061,5803,258,21,70050,4.256723312984656
"Caneyville city, Kentucky",297,224,73,21,12538,24.579124579124578
"Clarkson city, Kentucky",413,404,9,21,15148,2.1791767554479415
"Hardinsburg city, Kentucky",1037,975,62,21,34552,5.978784956605593
"Hopkinsville city, Kentucky",14627,12611,2016,21,37918,13.782730566760101
"Fairview city, Kentucky",74,60,14,21,26236,18.91891891891892
"Blaine city, Kentucky",37,32,5,21,07264,13.513513513513514
"Elizabethtown city, Kentucky",13386,12144,1242,21,24274,9.278350515463918
"Bellefonte city, Kentucky",400,353,47,21,05374,11.75
"Greenup city, Kentucky",596,518,78,21,33004,13.087248322147651
"Worthington city, Kentucky",692,647,45,21,84864,6.502890173410404
"Radcliff city, Kentucky",10611,8945,1666,21,63912,15.700687965319007
"Cumberland city, Kentucky",1198,922,276,21,19108,23.03839732888147
"Campbellsburg city, Kentucky",385,350,35,21,12142,9.090909090909092
"Creekside city, Kentucky",116,116,0,21,18270,0.0
"New Castle city, Kentucky",477,435,42,21,55596,8.80503144654088
"Barbourmeade city, Kentucky",533,523,10,21,03556,1.876172607879925
"Brownsboro Farm city, Kentucky",257,247,10,21,10162,3.8910505836575875
"Sparta city, Kentucky",137,101,36,21,72372,26.277372262773724
"Eubank city, Kentucky",143,128,15,21,25552,10.48951048951049
"Millersburg city, Kentucky",430,331,99,21,52302,23.02325581395349
"Paris city, Kentucky",4397,4017,380,21,59196,8.642256083693427
"Hazel city, Kentucky",230,173,57,21,35380,24.782608695652176
"Burkesville city, Kentucky",977,783,194,21,11098,19.85670419651996
"Whitesville city, Kentucky",230,207,23,21,82830,10.0
"Flemingsburg city, Kentucky",1414,1278,136,21,27856,9.618104667609618
"Prestonsburg city, Kentucky",1617,1401,216,21,62940,13.358070500927644
"Raceland city, Kentucky",1182,1081,101,21,63858,8.544839255499154
"West Point city, Kentucky",457,328,129,21,81930,28.227571115973742
"Munfordville city, Kentucky",872,721,151,21,54570,17.31651376146789
"Lincolnshire city, Kentucky",64,64,0,21,46540,0.0
"Folsom village, Louisiana",372,275,97,22,26140,26.0752688172043
"Sun village, Louisiana",157,132,25,22,73955,15.92356687898089
"Meraux CDP, Louisiana",2392,2216,176,22,49800,7.357859531772576
"Cullen town, Louisiana",694,515,179,22,18790,25.79250720461095
"Sarepta town, Louisiana",421,327,94,22,68125,22.327790973871732
"Oak Grove town, Louisiana",895,695,200,22,56820,22.3463687150838
"Bryceland village, Louisiana",50,30,20,22,10705,40.0
"Lutcher town, Louisiana",1586,1440,146,22,46720,9.205548549810844
"Merrydale CDP, Louisiana",3435,2986,449,22,49940,13.071324599708877
"Pollock town, Louisiana",182,154,28,22,61580,15.384615384615385
"Village St. George CDP, Louisiana",2966,2621,345,22,78680,11.631827376938638
"Wisner town, Louisiana",423,315,108,22,82565,25.53191489361702
"Colfax town, Louisiana",723,623,100,22,16375,13.831258644536653
"Martin village, Louisiana",264,217,47,22,48925,17.803030303030305
"St. Francisville town, Louisiana",900,714,186,22,67215,20.666666666666668
"Logansport town, Louisiana",764,637,127,22,45040,16.623036649214658
"Mermentau village, Louisiana",381,287,94,22,49870,24.671916010498688
"Georgetown village, Louisiana",157,111,46,22,28660,29.29936305732484
"Delta village, Louisiana",134,93,41,22,20330,30.597014925373134
"Hackberry CDP, Louisiana",915,556,359,22,32405,39.23497267759563
"Galliano CDP, Louisiana",3124,2718,406,22,28065,12.996158770806659
"Ida village, Louisiana",148,115,33,22,36885,22.2972972972973
"Lake Arthur town, Louisiana",1070,926,144,22,41050,13.457943925233645
"Marrero CDP, Louisiana",13047,11741,1306,22,48785,10.00996397639304
"Campti town, Louisiana",567,437,130,22,12280,22.92768959435626
"Alexandria city, Louisiana",22201,18109,4092,22,00975,18.43160218008198
"Morgan City city, Louisiana",5557,4707,850,22,52040,15.296023034011158
"Eden Isle CDP, Louisiana",3651,3250,401,22,22722,10.983292248698987
"Fordoche town, Louisiana",419,370,49,22,26280,11.694510739856803
"Livonia town, Louisiana",674,584,90,22,44690,13.353115727002967
"Jamestown village, Louisiana",76,69,7,22,37935,9.210526315789473
"Pine Prairie village, Louisiana",330,284,46,22,60495,13.939393939393941
"Monroe city, Louisiana",20959,17549,3410,22,51410,16.269860203253973
"Sterlington town, Louisiana",1040,840,200,22,73255,19.230769230769234
"Des Allemands CDP, Louisiana",872,654,218,22,20680,25.0
"New Sarpy CDP, Louisiana",536,437,99,22,55140,18.470149253731343
"Independence town, Louisiana",817,680,137,22,37025,16.768665850673194
"Tickfaw village, Louisiana",260,238,22,22,75670,8.461538461538462
"Vidalia town, Louisiana",1726,1584,142,22,78470,8.227114716106605
"Athens village, Louisiana",189,159,30,22,03320,15.873015873015872
"Harrisonburg village, Louisiana",194,121,73,22,33210,37.628865979381445
"Urania town, Louisiana",325,235,90,22,77490,27.692307692307693
"Belle Rose CDP, Louisiana",882,799,83,22,06260,9.410430839002268
"Pierre Part CDP, Louisiana",1471,1174,297,22,60075,20.190346702923183
"Montgomery town, Louisiana",439,288,151,22,51620,34.39635535307517
"Coushatta town, Louisiana",1063,833,230,22,18055,21.636876763875822
"Delhi town, Louisiana",1368,1093,275,22,20190,20.10233918128655
"Mangham town, Louisiana",253,224,29,22,48260,11.462450592885375
"Greensburg town, Louisiana",295,249,46,22,31565,15.593220338983052
"Larose CDP, Louisiana",3009,2645,364,22,42135,12.097042206713194
"Spearsville village, Louisiana",74,51,23,22,72170,31.08108108108108
"Epps village, Louisiana",253,191,62,22,24145,24.50592885375494
"Kilbourne village, Louisiana",199,158,41,22,39650,20.603015075376884
"Mer Rouge village, Louisiana",202,154,48,22,49905,23.762376237623762
"Denham Springs city, Louisiana",4553,3718,835,22,20435,18.33955633648144
"Livingston town, Louisiana",821,740,81,22,44655,9.866017052375152
"Boutte CDP, Louisiana",1324,1061,263,22,09130,19.86404833836858
"Duson town, Louisiana",801,626,175,22,22255,21.84769038701623
"Eunice city, Louisiana",4328,3734,594,22,24565,13.724584103512013
"Morse village, Louisiana",359,310,49,22,52320,13.649025069637883
"Pioneer village, Louisiana",95,85,10,22,60565,10.526315789473683
"Beechwood Village city, Kentucky",597,572,25,21,05068,4.1876046901172534
"Broeck Pointe city, Kentucky",112,112,0,21,09847,0.0
"Brownsboro Village city, Kentucky",202,195,7,21,10198,3.4653465346534658
"Coldstream city, Kentucky",468,460,8,21,16395,1.7094017094017095
"Houston Acres city, Kentucky",208,208,0,21,38170,0.0
"Middletown city, Kentucky",3676,3455,221,21,51978,6.0119695321001085
"Moorland city, Kentucky",214,214,0,21,53328,0.0
"Graymoor-Devondale city, Kentucky",1173,1145,28,21,32523,2.3870417732310316
"Hurstbourne city, Kentucky",1842,1725,117,21,38814,6.351791530944626
"Maryhill Estates city, Kentucky",65,65,0,21,50412,0.0
"Meadowbrook Farm city, Kentucky",50,50,0,21,51193,0.0
"Murray Hill city, Kentucky",325,316,9,21,54660,2.769230769230769
"Northfield city, Kentucky",447,440,7,21,56730,1.5659955257270695
"Norwood city, Kentucky",201,185,16,21,56928,7.960199004975125
"Poplar Hills city, Kentucky",337,247,90,21,62370,26.706231454005934
"Riverwood city, Kentucky",183,180,3,21,65766,1.639344262295082
"London city, Kentucky",3675,3377,298,21,47476,8.108843537414966
"Rolling Fields city, Kentucky",268,257,11,21,66486,4.104477611940299
"Ten Broeck city, Kentucky",60,60,0,21,75963,0.0
"Thornhill city, Kentucky",84,80,4,21,76380,4.761904761904762
"Jenkins city, Kentucky",1113,946,167,21,40312,15.00449236298293
"Whitesburg city, Kentucky",1083,954,129,21,82776,11.911357340720222
"Concord city, Kentucky",13,7,6,21,16894,46.15384615384615
"Loretto city, Kentucky",306,263,43,21,47710,14.052287581699346
"Dover city, Kentucky",110,103,7,21,22222,6.363636363636363
"Germantown city, Kentucky",53,30,23,21,30718,43.39622641509434
"Muldraugh city, Kentucky",596,430,166,21,54480,27.85234899328859
"Mount Sterling city, Kentucky",3198,2818,380,21,54084,11.882426516572858
"Lyndon city, Kentucky",6027,5739,288,21,48558,4.778496764559483
"Plantation city, Kentucky",346,346,0,21,61554,0.0
"Spring Valley city, Kentucky",265,253,12,21,72790,4.528301886792453
"West Buechel city, Kentucky",643,606,37,21,81624,5.7542768273716955
"North Corbin CDP, Kentucky",921,782,139,21,56694,15.092290988056462
"Bradfordsville city, Kentucky",147,110,37,21,09100,25.170068027210885
"Inez city, Kentucky",397,313,84,21,39430,21.158690176322416
"Williamstown city, Kentucky",1361,1261,100,21,83406,7.347538574577516
"Fountain Run city, Kentucky",110,89,21,21,28666,19.090909090909093
"Camargo city, Kentucky",523,474,49,21,12052,9.369024856596559
"Buckner CDP, Kentucky",1002,932,70,21,10648,6.986027944111776
"Hazard city, Kentucky",2597,2206,391,21,35362,15.055833654216402
"Vicco city, Kentucky",150,125,25,21,79590,16.666666666666664
"Mount Olivet city, Kentucky",255,181,74,21,53976,29.01960784313726
"Dixon city, Kentucky",365,306,59,21,21682,16.164383561643834
"Catlettsburg city, Kentucky",868,709,159,21,13420,18.317972350230416
"Ghent city, Kentucky",188,133,55,21,30808,29.25531914893617
"Dycusburg city, Kentucky",51,34,17,21,23140,33.33333333333333
"Marion city, Kentucky",1518,1212,306,21,50034,20.158102766798418
"Allen city, Kentucky",99,76,23,21,00946,23.232323232323232
"Wayland city, Kentucky",182,145,37,21,81012,20.32967032967033
"Crestwood city, Kentucky",1657,1594,63,21,18496,3.8020519010259504
"Providence city, Kentucky",1650,1233,417,21,63372,25.272727272727273
"Lawrenceburg city, Kentucky",4653,4362,291,21,44146,6.254029658284978
"Pine Knot CDP, Kentucky",557,472,85,21,61122,15.260323159784562
"Mayfield city, Kentucky",4500,3959,541,21,50898,12.022222222222222
"Powderly city, Kentucky",415,360,55,21,62652,13.253012048192772
"South Carrollton city, Kentucky",101,86,15,21,71814,14.85148514851485
"Carlisle city, Kentucky",1135,872,263,21,12898,23.17180616740088
"Orchard Grass Hills city, Kentucky",591,573,18,21,58200,3.0456852791878175
"Ferguson city, Kentucky",427,389,38,21,27010,8.899297423887589
"Richmond city, Kentucky",14530,13108,1422,21,65226,9.78664831383345
"Maysville city, Kentucky",4383,3618,765,21,51024,17.453798767967147
"Chalmette CDP, Louisiana",8429,7587,842,22,14135,9.989322576818129
"Heflin village, Louisiana",90,82,8,22,33735,8.88888888888889
"Dubach town, Louisiana",493,414,79,22,21800,16.024340770791078
"Belle Chasse CDP, Louisiana",5358,4906,452,22,06120,8.43598357596118
"Port Sulphur CDP, Louisiana",762,691,71,22,62070,9.317585301837271
"Arnaudville town, Louisiana",557,469,88,22,03110,15.798922800718133
"New Iberia city, Louisiana",13370,11141,2229,22,54035,16.671652954375467
"Varnado village, Louisiana",222,189,33,22,77910,14.864864864864865
"Dulac CDP, Louisiana",843,609,234,22,21940,27.75800711743772
"Jeanerette city, Louisiana",2587,1973,614,22,38075,23.734054889833782
"Fifth Ward CDP, Louisiana",351,317,34,22,25545,9.686609686609685
"Fort Jesup CDP, Louisiana",141,124,17,22,26665,12.056737588652481
"Frierson CDP, Louisiana",64,64,0,22,27540,0.0
"Gillis CDP, Louisiana",194,194,0,22,29045,0.0
"Glencoe CDP, Louisiana",83,83,0,22,29150,0.0
"Gloster CDP, Louisiana",117,69,48,22,29395,41.02564102564102
"Grand Point CDP, Louisiana",1024,982,42,22,30900,4.1015625
"Hayes CDP, Louisiana",356,316,40,22,33490,11.235955056179774
"Hester CDP, Louisiana",143,135,8,22,34085,5.594405594405594
"Jordan Hill CDP, Louisiana",61,29,32,22,38845,52.459016393442624
"Joyce CDP, Louisiana",119,62,57,22,38880,47.89915966386555
"Kraemer CDP, Louisiana",400,375,25,22,40210,6.25
"Lacassine CDP, Louisiana",124,124,0,22,40595,0.0
"Lafourche Crossing CDP, Louisiana",854,735,119,22,40878,13.934426229508196
"Lakeshore CDP, Louisiana",978,832,146,22,41470,14.92842535787321
"Lakeview CDP, Louisiana",591,545,46,22,41645,7.7834179357022
"Lawtell CDP, Louisiana",470,470,0,22,42520,0.0
"Lemannville CDP, Louisiana",192,188,4,22,43255,2.083333333333333
"Lockport Heights CDP, Louisiana",587,560,27,22,44970,4.599659284497445
"Longville CDP, Louisiana",322,176,146,22,45530,45.3416149068323
"Milton CDP, Louisiana",959,883,76,22,50815,7.924921793534932
"Oretta CDP, Louisiana",199,156,43,22,58150,21.608040201005025
"Minorca CDP, Louisiana",858,697,161,22,50990,18.764568764568764
"Monterey CDP, Louisiana",244,215,29,22,51585,11.885245901639344
"Moonshine CDP, Louisiana",122,104,18,22,51800,14.754098360655737
"Ossun CDP, Louisiana",587,555,32,22,58360,5.45144804088586
"Paulina CDP, Louisiana",407,407,0,22,59375,0.0
"Pitkin CDP, Louisiana",294,264,30,22,60600,10.204081632653061
"Pleasure Bend CDP, Louisiana",154,101,53,22,61160,34.41558441558442
"Pointe a la Hache CDP, Louisiana",98,67,31,22,61440,31.63265306122449
"Point Place CDP, Louisiana",213,213,0,22,61473,0.0
"Prairieville CDP, Louisiana",11733,10708,1025,22,62385,8.736043637603341
"Presquille CDP, Louisiana",554,554,0,22,62510,0.0
"Prospect CDP, Louisiana",270,207,63,22,62733,23.333333333333332
"Reddell CDP, Louisiana",510,435,75,22,63890,14.705882352941178
"Roanoke CDP, Louisiana",162,162,0,22,65290,0.0
"Rock Hill CDP, Louisiana",60,60,0,22,65535,0.0
"Romeville CDP, Louisiana",46,46,0,22,65850,0.0
"St. James CDP, Louisiana",362,297,65,22,67355,17.955801104972377
"St. Maurice CDP, Louisiana",275,202,73,22,67635,26.545454545454543
"Singer CDP, Louisiana",177,136,41,22,70665,23.163841807909606
"Siracusaville CDP, Louisiana",245,198,47,22,70675,19.183673469387756
"Sorrel CDP, Louisiana",306,235,71,22,71190,23.202614379084967
"Spokane CDP, Louisiana",426,167,259,22,72310,60.798122065727696
"Starks CDP, Louisiana",254,204,50,22,72975,19.68503937007874
"Start CDP, Louisiana",473,359,114,22,73010,24.101479915433405
"Sugartown CDP, Louisiana",78,12,66,22,73570,84.61538461538461
"Luling CDP, Louisiana",4691,4523,168,22,46615,3.5813259432956728
"Basile town, Louisiana",635,481,154,22,04580,24.251968503937007
"Church Point town, Louisiana",2099,1926,173,22,15465,8.242020009528348
"Pleasant Hill village, Louisiana",350,265,85,22,61055,24.285714285714285
"Bogalusa city, Louisiana",6108,4604,1504,22,08150,24.62344466273739
"Sardis city, Kentucky",54,49,5,21,68646,9.25925925925926
"Fredonia city, Kentucky",253,218,35,21,29080,13.83399209486166
"Salyersville city, Kentucky",874,692,182,21,68232,20.823798627002287
"Hillview city, Kentucky",3216,3109,107,21,36982,3.3271144278606966
"Hunters Hollow city, Kentucky",107,102,5,21,38670,4.672897196261682
"Bellevue city, Kentucky",2947,2570,377,21,05446,12.792670512385476
"Highland Heights city, Kentucky",2891,2476,415,21,36604,14.354894500172952
"Rolling Hills city, Kentucky",395,382,13,21,66504,3.2911392405063293
"Seneca Gardens city, Kentucky",295,274,21,21,69384,7.118644067796611
"Westwood city, Kentucky",215,213,2,21,82164,0.9302325581395349
"Woodlawn Park city, Kentucky",435,396,39,21,84576,8.96551724137931
"McRoberts CDP, Kentucky",396,338,58,21,49278,14.646464646464647
"Gratz city, Kentucky",37,16,21,21,32428,56.75675675675676
"Science Hill city, Kentucky",308,257,51,21,68952,16.558441558441558
"Eddyville city, Kentucky",1094,899,195,21,23824,17.824497257769654
"Berea city, Kentucky",6007,5481,526,21,05842,8.756450807391376
"Warfield city, Kentucky",140,111,29,21,80616,20.714285714285715
"Tompkinsville city, Kentucky",1280,1116,164,21,77160,12.812499999999998
"Jeffersonville city, Kentucky",803,671,132,21,40240,16.43835616438356
"Bremen city, Kentucky",110,82,28,21,09406,25.454545454545453
"Falmouth city, Kentucky",1199,1091,108,21,26434,9.007506255212677
"Fort Knox CDP, Kentucky",2925,2451,474,21,28540,16.205128205128204
"Gamaliel city, Kentucky",153,132,21,21,29872,13.725490196078432
"Goshen city, Kentucky",326,315,11,21,31960,3.374233128834356
"Buckhorn city, Kentucky",54,36,18,21,10612,33.33333333333333
"Pikeville city, Kentucky",3341,2840,501,21,60852,14.995510326249626
"Worthington Hills city, Kentucky",630,607,23,21,84891,3.650793650793651
"Hyden city, Kentucky",224,152,72,21,38908,32.142857142857146
"Windy Hills city, Kentucky",1155,1079,76,21,83784,6.58008658008658
"Woodland Hills city, Kentucky",295,279,16,21,84486,5.423728813559322
"Phelps CDP, Kentucky",439,378,61,21,60600,13.895216400911162
"Kuttawa city, Kentucky",367,199,168,21,43264,45.776566757493185
"Brandenburg city, Kentucky",1353,1132,221,21,09226,16.334072431633405
"Clay city, Kentucky",519,471,48,21,15202,9.248554913294797
"Wheatcroft city, Kentucky",67,56,11,21,82200,16.417910447761194
"Augusta city, Kentucky",619,465,154,21,02674,24.878836833602584
"Pioneer Village city, Kentucky",1252,1191,61,21,61356,4.872204472843451
"Newport city, Kentucky",7517,6278,1239,21,55884,16.482639350804842
"St. Regis Park city, Kentucky",572,551,21,21,67998,3.6713286713286712
"Coal Run Village city, Kentucky",857,737,120,21,16110,14.002333722287046
"Annville CDP, Kentucky",474,435,39,21,01648,8.227848101265822
"Heritage Creek city, Kentucky",468,449,19,21,36102,4.05982905982906
"Lexington-Fayette urban county, Kentucky",140662,128806,11856,21,46027,8.428715644594845
"Louisville/Jefferson County metro government (balance), Kentucky",275493,246382,29111,21,48006,10.566874657432312
"Artemus CDP, Kentucky",223,165,58,21,02188,26.00896860986547
"Auxier CDP, Kentucky",340,307,33,21,02764,9.705882352941178
"Bandana CDP, Kentucky",214,138,76,21,03412,35.51401869158878
"Beech Grove CDP, Kentucky",174,174,0,21,04978,0.0
"Beechmont CDP, Kentucky",285,244,41,21,05014,14.385964912280702
"Belleview CDP, Kentucky",104,104,0,21,05428,0.0
"Nicholasville city, Kentucky",11895,11216,679,21,56136,5.708280790248003
"Madisonville city, Kentucky",8881,7627,1254,21,49368,14.120031527981084
"Nebo city, Kentucky",78,69,9,21,55092,11.538461538461538
"St. Charles city, Kentucky",144,115,29,21,67710,20.13888888888889
"Vanceburg city, Kentucky",696,587,109,21,79068,15.660919540229884
"Benton city, Kentucky",2074,1890,184,21,05824,8.871745419479266
"West Liberty city, Kentucky",955,827,128,21,81858,13.403141361256546
"Central City city, Kentucky",2736,2176,560,21,13978,20.46783625730994
"Greenville city, Kentucky",1909,1635,274,21,33022,14.3530644316396
"Pewee Valley city, Kentucky",546,510,36,21,60492,6.593406593406594
"Booneville city, Kentucky",62,54,8,21,08614,12.903225806451612
"District Heights city, Maryland",2032,1931,101,24,23025,4.970472440944882
"Eagle Harbor town, Maryland",41,13,28,24,24200,68.29268292682927
"Oxford town, Maryland",571,311,260,24,59450,45.53415061295972
"Keedysville town, Maryland",428,409,19,24,43100,4.439252336448598
"Smithsburg town, Maryland",1083,1015,68,24,72900,6.278855032317636
"Newark CDP, Maryland",121,121,0,24,55325,0.0
"West Ocean City CDP, Maryland",2715,1827,888,24,83225,32.707182320441994
"Whaleyville CDP, Maryland",24,24,0,24,83746,0.0
"Woodsboro town, Maryland",463,411,52,24,86750,11.23110151187905
"Accident town, Maryland",153,107,46,24,00225,30.065359477124183
"Deer Park town, Maryland",234,186,48,24,22275,20.51282051282051
"Leitersburg CDP, Maryland",250,203,47,24,46400,18.8
"Chesapeake Beach town, Maryland",2348,2171,177,24,15925,7.538330494037479
"Sharpsburg town, Maryland",360,328,32,24,71600,8.88888888888889
"Eldorado town, Maryland",24,15,9,24,25600,37.5
"Betterton town, Maryland",308,157,151,24,07200,49.02597402597403
"Westminster city, Maryland",7548,7079,469,24,83100,6.213566507684154
"Frostburg city, Maryland",3663,2961,702,24,30900,19.164619164619165
"Port Tobacco Village town, Maryland",2,2,0,24,63225,0.0
"Olney CDP, Maryland",11896,11655,241,24,58900,2.0258910558170813
"North Potomac CDP, Maryland",8168,7967,201,24,56875,2.460822722820764
"Rock Hall town, Maryland",979,603,376,24,67400,38.40653728294178
"Secretary town, Maryland",221,184,37,24,70900,16.7420814479638
"Perryman CDP, Maryland",1164,1049,115,24,61075,9.879725085910653
"Columbia CDP, Maryland",42324,40332,1992,24,19125,4.706549475474907
"Pleasant Hills CDP, Maryland",1338,1272,66,24,62175,4.932735426008969
"Baltimore city, Maryland",294522,238436,56086,24,04000,19.043059601659635
"Fruitland city, Maryland",2105,1846,259,24,30950,12.304038004750593
"Dundalk CDP, Maryland",25957,23275,2682,24,23975,10.332472936009554
"Owings Mills CDP, Maryland",14219,13254,965,24,59425,6.7866938603277305
"Randallstown CDP, Maryland",12992,12341,651,24,64950,5.010775862068965
"Barnesville town, Maryland",55,51,4,24,04475,7.2727272727272725
"Burtonsville CDP, Maryland",3147,3137,10,24,11750,0.31776294884016526
"Fairland CDP, Maryland",9410,8925,485,24,27250,5.154091392136025
"North Chevy Chase village, Maryland",211,202,9,24,56400,4.265402843601896
"Hillsboro town, Maryland",55,49,6,24,39175,10.909090909090908
"Sharptown town, Maryland",336,304,32,24,71650,9.523809523809524
"Bladensburg town, Maryland",3759,3533,226,24,07850,6.012237297153498
"Landover Hills town, Maryland",502,476,26,24,45400,5.179282868525896
"Marlow Heights CDP, Maryland",2458,2201,257,24,50750,10.455655004068348
"Marlton CDP, Maryland",3485,3370,115,24,50775,3.2998565279770444
"Temple Hills CDP, Maryland",3461,3024,437,24,77100,12.62640855244149
"Chester CDP, Maryland",2421,2026,395,24,16125,16.31557207765386
"Church Hill town, Maryland",304,271,33,24,17100,10.855263157894738
"Fairmount CDP, Maryland",290,139,151,24,27375,52.06896551724138
"Laurel city, Maryland",10398,9800,598,24,45900,5.7511059819196
"Hillcrest Heights CDP, Maryland",7293,6725,568,24,38975,7.788290141231317
"Largo CDP, Maryland",4459,4072,387,24,45825,8.679076026014801
"West Laurel CDP, Maryland",1520,1415,105,24,83025,6.907894736842106
"Millington town, Maryland",264,228,36,24,52825,13.636363636363635
"Queenstown town, Maryland",260,240,20,24,64600,7.6923076923076925
"Crisfield city, Maryland",1456,1036,420,24,20775,28.846153846153843
"Eden CDP, Maryland",341,333,8,24,24850,2.346041055718475
"Mount Vernon CDP, Maryland",456,328,128,24,54375,28.07017543859649
"West Pocomoke CDP, Maryland",174,156,18,24,83337,10.344827586206897
"Federalsburg town, Maryland",1149,922,227,24,27900,19.756309834638817
"Greensboro town, Maryland",901,810,91,24,35200,10.099889012208656
"Ridgely town, Maryland",653,602,51,24,66000,7.810107197549771
"Owings CDP, Maryland",813,787,26,24,59375,3.198031980319803
"Andrews AFB CDP, Maryland",1017,795,222,24,01450,21.828908554572273
"Beltsville CDP, Maryland",5764,5333,431,24,06400,7.477446217904234
"Capitol Heights town, Maryland",1574,1465,109,24,13000,6.925031766200762
"College Park city, Maryland",7745,7054,691,24,18750,8.921885087153
"East Riverdale CDP, Maryland",4170,3927,243,24,24650,5.827338129496403
"Kettering CDP, Maryland",5681,5567,114,24,43900,2.0066889632107023
"Mitchellville CDP, Maryland",3721,3595,126,24,52975,3.3861865090029566
"White Oak CDP, Maryland",6890,6639,251,24,84375,3.6429608127721336
"Pikesville CDP, Maryland",14756,13864,892,24,61400,6.044998644619138
"Colesville CDP, Maryland",4924,4670,254,24,18475,5.158407798537774
"Rockville city, Maryland",26517,25197,1320,24,67675,4.97793868084625
"Maugansville CDP, Maryland",1405,1179,226,24,51425,16.085409252669038
"Barton town, Maryland",228,201,27,24,04625,11.842105263157894
"Luke town, Maryland",61,44,17,24,48775,27.86885245901639
"Hebron town, Maryland",504,424,80,24,37875,15.873015873015872
"Chestertown town, Maryland",2243,2047,196,24,16225,8.738296923762817
"Laytonsville town, Maryland",134,134,0,24,46250,0.0
"Greenbelt city, Maryland",9690,9125,565,24,34775,5.830753353973169
"University Park town, Maryland",970,956,14,24,79675,1.443298969072165
"Adamstown CDP, Maryland",713,713,0,24,00350,0.0
"Herald Harbor CDP, Maryland",1154,1012,142,24,38025,12.305025996533796
"Chewsville CDP, Maryland",128,128,0,24,16800,0.0
"Charlotte Hall CDP, Maryland",422,422,0,24,15475,0.0
"Allen CDP, Maryland",143,143,0,24,00800,0.0
"Annapolis Neck CDP, Maryland",5275,4858,417,24,01635,7.9052132701421804
"Antietam CDP, Maryland",35,35,0,24,01750,0.0
"Aquasco CDP, Maryland",391,319,72,24,01925,18.414322250639387
"Arden on the Severn CDP, Maryland",833,732,101,24,02025,12.12484993997599
"Baden CDP, Maryland",739,689,50,24,03500,6.7658998646820026
"Bagtown CDP, Maryland",173,116,57,24,03514,32.947976878612714
"Bakersville CDP, Maryland",7,7,0,24,03575,0.0
"Baltimore Highlands CDP, Maryland",2698,2405,293,24,04050,10.859896219421794
"Barrelville CDP, Maryland",13,13,0,24,04525,0.0
"Bartonsville CDP, Maryland",542,519,23,24,04650,4.243542435424354
"Beaver Creek CDP, Maryland",144,134,10,24,05250,6.944444444444445
"Bel Air CDP, Maryland",666,624,42,24,05525,6.306306306306306
"Benedict CDP, Maryland",202,187,15,24,06550,7.425742574257425
"Bier CDP, Maryland",112,68,44,24,07285,39.285714285714285
"Big Pool CDP, Maryland",25,25,0,24,07375,0.0
"Big Spring CDP, Maryland",31,31,0,24,07400,0.0
"Bishopville CDP, Maryland",335,256,79,24,07625,23.582089552238806
"Bivalve CDP, Maryland",102,102,0,24,07675,0.0
"Bloomington CDP, Maryland",130,103,27,24,08050,20.76923076923077
"Bowling Green CDP, Maryland",532,503,29,24,08850,5.451127819548872
"Bowmans Addition CDP, Maryland",240,240,0,24,08862,0.0
"Breathedsville CDP, Maryland",55,55,0,24,09400,0.0
"Brock Hall CDP, Maryland",4203,3983,220,24,10150,5.234356412086605
"Broomes Island CDP, Maryland",209,150,59,24,10650,28.22966507177033
"Brownsville CDP, Maryland",12,12,0,24,10800,0.0
"Bryantown CDP, Maryland",224,224,0,24,10950,0.0
"Buckeystown CDP, Maryland",726,655,71,24,11050,9.77961432506887
"Butlertown CDP, Maryland",174,108,66,24,11900,37.93103448275862
"Calvert Beach CDP, Maryland",314,314,0,24,12300,0.0
"Carlos CDP, Maryland",31,31,0,24,13225,0.0
"Cearfoss CDP, Maryland",46,46,0,24,14300,0.0
"Cedarville CDP, Maryland",317,247,70,24,14800,22.082018927444793
"Charlton CDP, Maryland",90,90,0,24,15500,0.0
"Chesapeake Ranch Estates CDP, Maryland",3885,3380,505,24,16050,12.998712998713
"Choptank CDP, Maryland",58,58,0,24,17000,0.0
"Clarysville CDP, Maryland",21,21,0,24,17475,0.0
"Cobb Island CDP, Maryland",498,311,187,24,18200,37.55020080321285
"Corriganville CDP, Maryland",242,215,27,24,19975,11.15702479338843
"Crellin CDP, Maryland",70,70,0,24,20500,0.0
"Cresaptown CDP, Maryland",1231,1167,64,24,20525,5.199025182778229
"Croom CDP, Maryland",1063,960,103,24,20925,9.689557855127
"Danville CDP, Maryland",106,106,0,24,21675,0.0
"Dargan CDP, Maryland",76,62,14,24,21750,18.421052631578945
"Darlington CDP, Maryland",220,205,15,24,21800,6.8181818181818175
"Dawson CDP, Maryland",39,39,0,24,21925,0.0
"Derwood CDP, Maryland",838,838,0,24,22775,0.0
"Detmold CDP, Maryland",76,66,10,24,22825,13.157894736842104
"Downsville CDP, Maryland",189,189,0,24,23500,0.0
"Drum Point CDP, Maryland",976,961,15,24,23700,1.5368852459016393
"Eakles Mill CDP, Maryland",0,0,0,24,24250,
"Eckhart Mines CDP, Maryland",366,321,45,24,24825,12.295081967213115
"Edesville CDP, Maryland",115,87,28,24,24925,24.347826086956523
"Elliott CDP, Maryland",51,25,26,24,26025,50.98039215686274
"Edgemont CDP, Maryland",96,96,0,24,25000,0.0
"Edgewater CDP, Maryland",4028,3871,157,24,25050,3.897715988083416
"Ellerslie CDP, Maryland",188,158,30,24,25925,15.957446808510639
"Ernstville CDP, Maryland",7,7,0,24,26550,0.0
"Fairlee CDP, Maryland",228,185,43,24,27325,18.859649122807017
"Fairplay CDP, Maryland",225,225,0,24,27425,0.0
"Fairview CDP, Maryland",14,14,0,24,27500,0.0
"Fairwood CDP, Maryland",2109,2074,35,24,27580,1.6595542911332386
"Finzel CDP, Maryland",282,251,31,24,28275,10.99290780141844
"Fishing Creek CDP, Maryland",152,110,42,24,28300,27.631578947368425
"Flintstone CDP, Maryland",64,64,0,24,28425,0.0
"Four Corners CDP, Maryland",2849,2830,19,24,29790,0.666900666900667
"Franklin CDP, Maryland",107,87,20,24,30100,18.69158878504673
"Friendship CDP, Maryland",91,91,0,24,30650,0.0
"Friendship Heights Village CDP, Maryland",3094,2937,157,24,30800,5.0743374272786035
"Fulton CDP, Maryland",1476,1404,72,24,31025,4.878048780487805
"Galesville CDP, Maryland",328,247,81,24,31275,24.695121951219512
"Gambrills CDP, Maryland",1082,974,108,24,31350,9.981515711645102
"Gapland CDP, Maryland",54,54,0,24,31400,0.0
"Garretts Mill CDP, Maryland",206,206,0,24,31575,0.0
"Georgetown CDP, Maryland",31,31,0,24,31875,0.0
"Gilmore CDP, Maryland",77,77,0,24,32175,0.0
"Glassmanor CDP, Maryland",7157,6419,738,24,32350,10.31158306553025
"Glenmont CDP, Maryland",5293,5111,182,24,33250,3.4385036841110903
"Gorman CDP, Maryland",64,21,43,24,34150,67.1875
"Grahamtown CDP, Maryland",155,141,14,24,34425,9.032258064516128
"Greensburg CDP, Maryland",142,118,24,24,35225,16.901408450704224
"Highland CDP, Maryland",409,378,31,24,38475,7.579462102689487
"Hutton CDP, Maryland",52,52,0,24,41175,0.0
"Ilchester CDP, Maryland",9456,9049,407,24,41475,4.30414551607445
"Indian Springs CDP, Maryland",19,19,0,24,41700,0.0
"Jefferson CDP, Maryland",801,801,0,24,42350,0.0
"Jennings CDP, Maryland",85,85,0,24,42450,0.0
"Jesterville CDP, Maryland",96,79,17,24,42575,17.708333333333336
"Jugtown CDP, Maryland",74,74,0,24,42950,0.0
"Kemps Mill CDP, Maryland",15,15,0,24,43280,0.0
"Kennedyville CDP, Maryland",149,149,0,24,43475,0.0
"Klondike CDP, Maryland",43,43,0,24,44525,0.0
"Konterra CDP, Maryland",1282,1175,107,24,44715,8.346333853354135
"Landover CDP, Maryland",8484,7878,606,24,45325,7.142857142857142
"Lanham CDP, Maryland",3084,2944,140,24,45550,4.539559014267185
"Lansdowne CDP, Maryland",3261,3038,223,24,45650,6.838393130941429
"Layhill CDP, Maryland",1593,1547,46,24,46150,2.8876333961079723
"Leisure World CDP, Maryland",6412,5897,515,24,46375,8.031815346225827
"Libertytown CDP, Maryland",347,347,0,24,46800,0.0
"Linganore CDP, Maryland",3328,3255,73,24,47040,2.1935096153846154
"Little Orleans CDP, Maryland",160,20,140,24,47275,87.5
"Long Beach CDP, Maryland",923,726,197,24,48025,21.34344528710726
"Lutherville CDP, Maryland",2729,2583,146,24,48875,5.349945034811286
"McCoole CDP, Maryland",289,260,29,24,49325,10.034602076124568
"Madison CDP, Maryland",138,103,35,24,49700,25.36231884057971
"Mapleville CDP, Maryland",104,104,0,24,50375,0.0
"Marlboro Meadows CDP, Maryland",1287,1244,43,24,50680,3.3411033411033406
"Marlboro Village CDP, Maryland",3764,3386,378,24,50685,10.042507970244422
"Mechanicsville CDP, Maryland",606,546,60,24,51800,9.900990099009901
"Mercersville CDP, Maryland",75,65,10,24,51945,13.333333333333334
"Moscow CDP, Maryland",127,127,0,24,53700,0.0
"Middleburg CDP, Maryland",19,19,0,24,52225,0.0
"Midlothian CDP, Maryland",187,173,14,24,52525,7.4866310160427805
"Monrovia CDP, Maryland",164,164,0,24,53100,0.0
"Mount Briar CDP, Maryland",106,106,0,24,53925,0.0
"Mount Savage CDP, Maryland",367,358,9,24,54325,2.452316076294278
"Nanticoke CDP, Maryland",140,116,24,24,54925,17.142857142857142
"Nanticoke Acres CDP, Maryland",10,10,0,24,54930,0.0
"National CDP, Maryland",67,38,29,24,55000,43.28358208955223
"National Harbor CDP, Maryland",2160,1828,332,24,55018,15.37037037037037
"Nikep CDP, Maryland",10,10,0,24,55950,0.0
"Ocean CDP, Maryland",0,0,0,24,58215,
"Oldtown CDP, Maryland",18,18,0,24,58775,0.0
"Oxon Hill CDP, Maryland",7371,6802,569,24,59500,7.719441052774386
"Parsonsburg CDP, Maryland",182,146,36,24,60425,19.78021978021978
"Pecktonville CDP, Maryland",77,77,0,24,60770,0.0
"Peppermill Village CDP, Maryland",1879,1774,105,24,60950,5.5880787653006925
"Pinesburg CDP, Maryland",118,102,16,24,61700,13.559322033898304
"Piney Point CDP, Maryland",495,356,139,24,61875,28.08080808080808
"Pleasant Grove CDP, Maryland",211,178,33,24,62100,15.639810426540285
"Point of Rocks CDP, Maryland",649,630,19,24,62575,2.9275808936825887
"Pomfret CDP, Maryland",257,239,18,24,62675,7.003891050583658
"Pondsville CDP, Maryland",21,21,0,24,62775,0.0
"Potomac Park CDP, Maryland",431,395,36,24,63425,8.352668213457076
"Powellville CDP, Maryland",80,52,28,24,63725,35.0
"Pylesville CDP, Maryland",312,298,14,24,64375,4.487179487179487
"Quantico CDP, Maryland",95,50,45,24,64475,47.368421052631575
"Queen Anne CDP, Maryland",415,360,55,24,64495,13.253012048192772
"Rawlings CDP, Maryland",235,221,14,24,65150,5.957446808510639
"Reid CDP, Maryland",11,11,0,24,65550,0.0
"Ringgold CDP, Maryland",73,73,0,24,66150,0.0
"Rock Point CDP, Maryland",52,41,11,24,67500,21.153846153846153
"Sabillasville CDP, Maryland",119,119,0,24,69200,0.0
"St. George Island CDP, Maryland",243,119,124,24,69425,51.028806584362144
"Sandy Hook CDP, Maryland",55,55,0,24,70175,0.0
"Savage CDP, Maryland",2738,2510,228,24,70475,8.327246165084002
"Seabrook CDP, Maryland",6117,5614,503,24,70775,8.222985123426517
"Shaft CDP, Maryland",139,111,28,24,71460,20.14388489208633
"Silver Hill CDP, Maryland",2676,2275,401,24,72350,14.985052316890881
"Spencerville CDP, Maryland",608,592,16,24,74050,2.631578947368421
"Spring Gap CDP, Maryland",18,18,0,24,74350,0.0
"Spring Ridge CDP, Maryland",2205,2188,17,24,74560,0.7709750566893424
"Suitland CDP, Maryland",10588,9645,943,24,75725,8.906309029089535
"Summerfield CDP, Maryland",5887,5436,451,24,75810,7.660947851197554
"Swanton CDP, Maryland",39,39,0,24,76450,0.0
"Tall Timbers CDP, Maryland",186,172,14,24,76675,7.526881720430108
"Taylors Island CDP, Maryland",138,82,56,24,76925,40.57971014492754
"Tilghmanton CDP, Maryland",203,203,0,24,77925,0.0
"Timonium CDP, Maryland",4170,3950,220,24,78050,5.275779376498801
"Tolchester CDP, Maryland",242,153,89,24,78120,36.77685950413223
"Trego-Rohrersville Station CDP, Maryland",44,44,0,24,78705,0.0
"Tyaskin CDP, Maryland",78,62,16,24,79225,20.51282051282051
"Urbana CDP, Maryland",3655,3608,47,24,79900,1.2859097127222983
"Vale Summit CDP, Maryland",42,42,0,24,80075,0.0
"Waterview CDP, Maryland",55,9,46,24,81925,83.63636363636363
"West Denton CDP, Maryland",40,40,0,24,82625,0.0
"Westphalia CDP, Maryland",3482,3344,138,24,83290,3.963239517518667
"Woodland CDP, Maryland",22,22,0,24,86275,0.0
"Wheaton CDP, Maryland",16293,15363,930,24,83775,5.707972749033327
"Whitehaven CDP, Maryland",25,25,0,24,84225,0.0
"Williston CDP, Maryland",54,46,8,24,85175,14.814814814814813
"Worton CDP, Maryland",74,29,45,24,87000,60.810810810810814
"Yarrowsburg CDP, Maryland",160,101,59,24,87150,36.875
"Zihlman CDP, Maryland",180,129,51,24,87275,28.333333333333332
"Bensville CDP, Maryland",4573,4407,166,24,06662,3.6300021867483054
"Dunkirk CDP, Maryland",815,815,0,24,24050,0.0
"Huntingtown CDP, Maryland",1127,1070,57,24,41025,5.057675244010648
"Melwood CDP, Maryland",1535,1504,31,24,51940,2.019543973941368
"Scaggsville CDP, Maryland",3097,3073,24,24,70525,0.7749434937035841
"Queensland CDP, Maryland",591,582,9,24,64568,1.5228426395939088
"Harwich Port CDP, Massachusetts",2513,944,1569,25,29090,62.43533625149224
"Monument Beach CDP, Massachusetts",1626,1359,267,25,42670,16.420664206642066
"South Dennis CDP, Massachusetts",2735,1673,1062,25,63655,38.82998171846435
"Revere city, Massachusetts",21196,19989,1207,25,56585,5.694470654840536
"Vineyard Haven CDP, Massachusetts",1457,719,738,25,71970,50.65202470830473
"Granby CDP, Massachusetts",714,670,44,25,26500,6.162464985994398
"Hatfield CDP, Massachusetts",698,679,19,25,29230,2.722063037249284
"North Amherst CDP, Massachusetts",2230,1925,305,25,46295,13.67713004484305
"Ware CDP, Massachusetts",3153,2657,496,25,72845,15.731049793847129
"Millis-Clicquot CDP, Massachusetts",1820,1725,95,25,41532,5.21978021978022
"Wellesley CDP, Massachusetts",9083,8654,429,25,74210,4.723109104921281
"Marshfield Hills CDP, Massachusetts",902,866,36,25,38960,3.9911308203991127
"Plymouth CDP, Massachusetts",3991,3298,693,25,54275,17.364069155600102
"Forestdale CDP, Massachusetts",1657,1515,142,25,24190,8.569704284852142
"Popponesset CDP, Massachusetts",544,97,447,25,55070,82.16911764705883
"Popponesset Island CDP, Massachusetts",47,8,39,25,55090,82.97872340425532
"Provincetown CDP, Massachusetts",4509,1596,2913,25,55535,64.60412508316699
"Sagamore CDP, Massachusetts",1939,1454,485,25,58965,25.012893243940177
"West Falmouth CDP, Massachusetts",1620,641,979,25,75960,60.432098765432094
"West Yarmouth CDP, Massachusetts",5014,2421,2593,25,78795,51.715197447147986
"Northfield CDP, Massachusetts",622,538,84,25,47800,13.504823151125404
"Westfield city, Massachusetts",16024,15272,752,25,76030,4.692960559161259
"Attleboro city, Massachusetts",18755,17378,1377,25,02690,7.342042122100772
"Duxbury CDP, Massachusetts",775,673,102,25,17860,13.161290322580646
"New Bedford city, Massachusetts",43262,39242,4020,25,45000,9.292219499791965
"Nantucket CDP, Massachusetts",6899,2550,4349,25,43755,63.03812146687926
"Dover CDP, Massachusetts",866,839,27,25,17370,3.117782909930716
"Bridgewater CDP, Massachusetts",2788,2545,243,25,08050,8.715925394548062
"Hanson CDP, Massachusetts",629,575,54,25,28460,8.585055643879173
"Marion Center CDP, Massachusetts",505,399,106,25,38575,20.99009900990099
"Lexington CDP, Massachusetts",12149,11757,392,25,35250,3.226603012593629
"Malden city, Massachusetts",24273,22996,1277,25,37875,5.26098957689614
"Melrose city, Massachusetts",11691,11256,435,25,40115,3.7208108801642292
"Lenox CDP, Massachusetts",1128,1066,62,25,34935,5.49645390070922
"Beverly city, Massachusetts",17513,16687,826,25,05595,4.716496317021641
"Lynn city, Massachusetts",34172,32709,1463,25,37490,4.281282921690273
"Lynnfield CDP, Massachusetts",4767,4496,271,25,37595,5.684917138661632
"Rockport CDP, Massachusetts",3108,2343,765,25,57845,24.613899613899616
"Barre CDP, Massachusetts",631,502,129,25,03705,20.44374009508716
"Leominster city, Massachusetts",17994,16941,1053,25,35075,5.851950650216739
"Worcester city, Massachusetts",77920,71145,6775,25,82000,8.694815195071868
"Wilmington CDP, Massachusetts",8138,8028,110,25,80195,1.3516834603096584
"Pittsfield city, Massachusetts",21407,19230,2177,25,53960,10.169570701172512
"Housatonic CDP, Massachusetts",365,365,0,25,31295,0.0
"Lee CDP, Massachusetts",892,800,92,25,34620,10.31390134529148
"North Adams city, Massachusetts",6718,5759,959,25,46225,14.275081869604048
"Athol CDP, Massachusetts",3924,3308,616,25,02515,15.698267074413863
"Boxford CDP, Massachusetts",849,849,0,25,07385,0.0
"Gloucester city, Massachusetts",14962,13137,1825,25,26150,12.197567170164417
"Saugus CDP, Massachusetts",10999,10429,570,25,60050,5.182289299027184
"Northborough CDP, Massachusetts",2440,2292,148,25,46785,6.065573770491803
"Rutland CDP, Massachusetts",982,868,114,25,58790,11.608961303462321
"Westborough CDP, Massachusetts",1803,1683,120,25,75050,6.655574043261231
"West Brookfield CDP, Massachusetts",636,551,85,25,75365,13.364779874213836
"Green Harbor-Cedar Crest CDP, Massachusetts",1340,973,367,25,27147,27.38805970149254
"North Lakeville CDP, Massachusetts",1313,1236,77,25,48220,5.864432597105865
"North Scituate CDP, Massachusetts",1867,1818,49,25,49165,2.6245313336904124
"Ocean Bluff-Brant Rock CDP, Massachusetts",2855,2043,812,25,50862,28.441330998248688
"Scituate CDP, Massachusetts",2353,2208,145,25,60295,6.162345941351466
"West Wareham CDP, Massachusetts",1098,1059,39,25,78410,3.551912568306011
"Adams CDP, Massachusetts",3144,2726,418,25,00590,13.295165394402037
"Great Barrington CDP, Massachusetts",1505,1230,275,25,26780,18.272425249169437
"Ipswich CDP, Massachusetts",2058,1946,112,25,32275,5.442176870748299
"Lawrence city, Massachusetts",27244,25635,1609,25,34550,5.905887534870064
"Nahant CDP, Massachusetts",1702,1572,130,25,43615,7.638072855464159
"Milford CDP, Massachusetts",10470,9980,490,25,41200,4.680038204393505
"South Lancaster CDP, Massachusetts",859,719,140,25,64460,16.298020954598368
"Whitinsville CDP, Massachusetts",2613,2433,180,25,79495,6.8886337543053955
"Winchendon CDP, Massachusetts",1922,1554,368,25,80370,19.14672216441207
"Sturbridge CDP, Massachusetts",893,784,109,25,68120,12.206047032474803
"Danvers CDP, Massachusetts",11205,10703,502,25,16285,4.480142793395806
"Essex CDP, Massachusetts",647,539,108,25,21815,16.69242658423493
"Rowley CDP, Massachusetts",590,590,0,25,58370,0.0
"Salisbury CDP, Massachusetts",3392,2245,1147,25,59210,33.81485849056604
"Baldwinville CDP, Massachusetts",825,772,53,25,03355,6.424242424242424
"Clinton CDP, Massachusetts",3391,2921,470,25,14430,13.860218224712476
"Cordaville CDP, Massachusetts",936,936,0,25,15340,0.0
"Fitchburg city, Massachusetts",16726,14817,1909,25,23875,11.41336840846586
"Hopedale CDP, Massachusetts",1460,1405,55,25,30980,3.767123287671233
"Lunenburg CDP, Massachusetts",815,757,58,25,37385,7.116564417177915
"Spencer CDP, Massachusetts",2891,2470,421,25,66070,14.562435143548946
"Randolph CDP, Massachusetts",12750,12237,513,25,55990,4.023529411764706
"Sharon CDP, Massachusetts",2187,1988,199,25,60820,9.099222679469593
"Walpole CDP, Massachusetts",2757,2651,106,25,72460,3.844758795792528
"Brockton city, Massachusetts",34138,32157,1981,25,09000,5.802917569863495
"Marshfield CDP, Massachusetts",1919,1879,40,25,38820,2.084418968212611
"Weweantic CDP, Massachusetts",977,747,230,25,78850,23.541453428863868
"Brewster CDP, Massachusetts",2276,896,1380,25,07945,60.632688927943754
"East Dennis CDP, Massachusetts",2348,1215,1133,25,18840,48.25383304940375
"East Harwich CDP, Massachusetts",3292,2184,1108,25,19400,33.65735115431349
"East Sandwich CDP, Massachusetts",2192,1455,737,25,20380,33.622262773722625
"New Seabury CDP, Massachusetts",1855,439,1416,25,45500,76.33423180592992
"Pocasset CDP, Massachusetts",2496,1553,943,25,54450,37.780448717948715
"Raynham Center CDP, Massachusetts",1715,1656,59,25,56095,3.4402332361516033
"Somerset CDP, Massachusetts",7395,7026,369,25,62465,4.9898580121703855
"Taunton city, Massachusetts",23759,22184,1575,25,69170,6.629066879919189
"Northampton city, Massachusetts",11967,11163,804,25,46330,6.7184758084733005
"Turners Falls CDP, Massachusetts",2159,1951,208,25,70815,9.634089856415006
"Medfield CDP, Massachusetts",2568,2405,163,25,39730,6.347352024922118
"Milton CDP, Massachusetts",9335,8881,454,25,41725,4.863417246920193
"Hingham CDP, Massachusetts",2106,2087,19,25,30175,0.9021842355175688
"Chicopee city, Massachusetts",24679,23002,1677,25,13660,6.79525102313708
"Springfield city, Massachusetts",62359,56476,5883,25,67000,9.434083291906541
"Teaticket CDP, Massachusetts",1576,812,764,25,69205,48.47715736040609
"Smith Mills CDP, Massachusetts",2122,2001,121,25,62300,5.702167766258246
"Dedham CDP, Massachusetts",10439,9983,456,25,16530,4.368234505220807
"Orleans CDP, Massachusetts",1557,988,569,25,51405,36.5446371226718
"Wilbraham CDP, Massachusetts",1248,1180,68,25,79705,5.448717948717949
"Brookline CDP, Massachusetts",25922,24541,1381,25,09210,5.327521024612299
"Groton CDP, Massachusetts",496,488,8,25,27445,1.6129032258064515
"Williamstown CDP, Massachusetts",1447,1026,421,25,79950,29.094678645473394
"Salem city, Massachusetts",19381,18222,1159,25,59105,5.980083587018214
"Winchester CDP, Massachusetts",8197,7879,318,25,80545,3.879468098084665
"Hull CDP, Massachusetts",5921,4860,1061,25,31680,17.91927039351461
"Dennis Port CDP, Massachusetts",5261,1630,3631,25,16810,69.01729709180763
"Northwest Harwich CDP, Massachusetts",3553,1679,1874,25,49700,52.7441598649029
"Foxborough CDP, Massachusetts",2545,2545,0,25,24855,0.0
"South Yarmouth CDP, Massachusetts",7860,5051,2809,25,66035,35.73791348600509
"Pepperell CDP, Massachusetts",1088,990,98,25,52770,9.007352941176471
"Shelburne Falls CDP, Massachusetts",987,906,81,25,61205,8.206686930091186
"Burlington CDP, Massachusetts",10533,9942,591,25,09875,5.610937054970094
"Dennis CDP, Massachusetts",2658,1178,1480,25,16740,55.68096313017307
"Webster CDP, Massachusetts",5211,4676,535,25,73930,10.26674342736519
"Ocean Grove CDP, Massachusetts",1458,1197,261,25,50880,17.901234567901234
"Belchertown CDP, Massachusetts",1213,1095,118,25,04790,9.727947238252268
"Needham CDP, Massachusetts",11222,10765,457,25,44140,4.072357868472643
"Quincy city, Massachusetts",43265,40583,2682,25,55745,6.199006125043337
"Abington CDP, Massachusetts",6762,6413,349,25,00135,5.161194912747708
"Kingston CDP, Massachusetts",2706,2425,281,25,33185,10.384331116038432
"Mattapoisett Center CDP, Massachusetts",1868,1470,398,25,39485,21.306209850107066
"South Duxbury CDP, Massachusetts",1354,1251,103,25,63690,7.607090103397342
"Wareham Center CDP, Massachusetts",2137,1636,501,25,73020,23.444080486663545
"Cambridge city, Massachusetts",51545,46184,5361,25,11000,10.400620816762054
"Pinehurst CDP, Massachusetts",2532,2428,104,25,53680,4.107424960505529
"Bourne CDP, Massachusetts",1139,640,499,25,07140,43.81035996488147
"Buzzards Bay CDP, Massachusetts",1848,1472,376,25,10015,20.346320346320347
"Amherst Center CDP, Massachusetts",3427,3058,369,25,01360,10.767435074409104
"Monson Center CDP, Massachusetts",859,764,95,25,42180,11.059371362048893
"Acushnet Center CDP, Massachusetts",1293,1256,37,25,00530,2.8615622583139984
"Norton Center CDP, Massachusetts",435,435,0,25,50005,0.0
"Holbrook CDP, Massachusetts",4346,4122,224,25,30420,5.154164749194662
"Norwood CDP, Massachusetts",12308,11764,544,25,50285,4.41988950276243
"East Falmouth CDP, Massachusetts",4609,2536,2073,25,18980,44.977218485571704
"Harwich Center CDP, Massachusetts",1096,691,405,25,29055,36.95255474452554
"Monomoscoy Island CDP, Massachusetts",156,56,100,25,41960,64.1025641025641
"Seabrook CDP, Massachusetts",299,224,75,25,60505,25.08361204013378
"Seconsett Island CDP, Massachusetts",63,8,55,25,60627,87.3015873015873
"West Chatham CDP, Massachusetts",2016,588,1428,25,75505,70.83333333333334
"South Deerfield CDP, Massachusetts",835,764,71,25,63620,8.502994011976048
"Holland CDP, Massachusetts",956,562,394,25,30630,41.21338912133891
"Mansfield Center CDP, Massachusetts",3326,3120,206,25,38230,6.19362597714973
"Bellingham CDP, Massachusetts",2147,1975,172,25,04965,8.011178388448998
"Arlington CDP, Massachusetts",19925,18810,1115,25,01640,5.5959849435382685
"Middleborough Center CDP, Massachusetts",3258,2828,430,25,40885,13.19828115408226
"Marlborough city, Massachusetts",17084,15718,1366,25,38715,7.995785530320767
"White Island Shores CDP, Massachusetts",1062,749,313,25,79390,29.47269303201507
"Ayer CDP, Massachusetts",1350,1315,35,25,03040,2.5925925925925926
"Belmont CDP, Massachusetts",10276,9781,495,25,05105,4.817049435578046
"Cochituate CDP, Massachusetts",2631,2483,148,25,14570,5.625237552261497
"Maynard CDP, Massachusetts",4605,4250,355,25,39660,7.709011943539632
"Newton city, Massachusetts",32639,30849,1790,25,45560,5.484236649407151
"Stoneham CDP, Massachusetts",9445,9241,204,25,67700,2.1598729486500794
"West Concord CDP, Massachusetts",2744,2559,185,25,75680,6.74198250728863
"Andover CDP, Massachusetts",3749,3491,258,25,01430,6.881835156041611
"Haverhill city, Massachusetts",25742,24155,1587,25,29405,6.165022142801647
"Barnstable Town city, Massachusetts",26520,19009,7511,25,03690,28.322021116138764
"Agawam Town city, Massachusetts",12384,11875,509,25,00840,4.110142118863049
"Amesbury Town city, Massachusetts",7540,7131,409,25,01260,5.424403183023873
"Blandford CDP, Massachusetts",187,144,43,25,06050,22.994652406417114
"Braintree Town city, Massachusetts",14743,14074,669,25,07740,4.537746727260395
"Brookfield CDP, Massachusetts",336,336,0,25,09070,0.0
"Cheshire CDP, Massachusetts",287,225,62,25,13310,21.602787456445995
"Chester CDP, Massachusetts",338,299,39,25,13450,11.538461538461538
"Deerfield CDP, Massachusetts",179,179,0,25,16635,0.0
"Devens CDP, Massachusetts",231,231,0,25,16840,0.0
"Easthampton Town city, Massachusetts",7731,7292,439,25,19370,5.678437459578321
"Franklin Town city, Massachusetts",11928,11655,273,25,25172,2.2887323943661975
"Greenfield Town city, Massachusetts",8329,7875,454,25,27100,5.450834433905631
"Huntington CDP, Massachusetts",389,320,69,25,31750,17.737789203084834
"Madaket CDP, Massachusetts",661,123,538,25,37735,81.39183055975793
"Methuen Town city, Massachusetts",18477,17692,785,25,40710,4.248525193483791
"Palmer Town city, Massachusetts",5424,4896,528,25,52144,9.734513274336283
"Petersham CDP, Massachusetts",125,116,9,25,53085,7.199999999999999
"Russell CDP, Massachusetts",235,218,17,25,58615,7.234042553191489
"Siasconset CDP, Massachusetts",1015,44,971,25,61940,95.66502463054188
"Southbridge Town city, Massachusetts",7538,6943,595,25,63345,7.893340408596444
"Southfield CDP, Massachusetts",0,0,0,25,63840,
"The Pinehills CDP, Massachusetts",844,776,68,25,69585,8.056872037914692
"Upton CDP, Massachusetts",1100,1023,77,25,71445,7.000000000000001
"Watertown Town city, Massachusetts",16381,15498,883,25,73440,5.390391307002015
"West Springfield Town city, Massachusetts",12463,12037,426,25,77890,3.418117628179411
"Weymouth Town city, Massachusetts",24363,23284,1079,25,78972,4.428847022123712
"Winthrop Town city, Massachusetts",8553,8006,547,25,81005,6.395416812814217
"Framingham city, Massachusetts",29332,28189,1143,25,24960,3.8967680349106777
"Newburyport city, Massachusetts",8633,7918,715,25,45245,8.282173056874782
"Gardner city, Massachusetts",9117,8222,895,25,25485,9.816825710211692
"North Brookfield CDP, Massachusetts",1044,900,144,25,47100,13.793103448275861
"Warren CDP, Massachusetts",508,411,97,25,73055,19.094488188976378
"North Pembroke CDP, Massachusetts",1287,1246,41,25,48710,3.1857031857031854
"Onset CDP, Massachusetts",1162,464,698,25,51160,60.06884681583477
"Everett city, Massachusetts",16871,15816,1055,25,21990,6.253334123644123
"Lowell city, Massachusetts",41303,38829,2474,25,37000,5.989879669757644
"Wakefield CDP, Massachusetts",11210,10743,467,25,72250,4.165923282783229
"Marblehead CDP, Massachusetts",8804,8236,568,25,38435,6.451612903225806
"Peabody city, Massachusetts",22641,21776,865,25,52490,3.820502627975796
"Swampscott CDP, Massachusetts",5853,5495,358,25,68680,6.116521441995558
"Fall River city, Massachusetts",43210,38660,4550,25,23000,10.529969914371673
"Topsfield CDP, Massachusetts",1130,1097,33,25,70115,2.920353982300885
"East Douglas CDP, Massachusetts",1221,1122,99,25,18875,8.108108108108109
"South Ashburnham CDP, Massachusetts",296,296,0,25,62780,0.0
"Chatham CDP, Massachusetts",2055,794,1261,25,12960,61.36253041362531
"North Eastham CDP, Massachusetts",3051,854,2197,25,47590,72.00917731891184
"Bliss Corner CDP, Massachusetts",2239,2208,31,25,06170,1.3845466726217062
"Orange CDP, Massachusetts",1718,1530,188,25,51230,10.942956926658907
"Longmeadow CDP, Massachusetts",5789,5675,114,25,36335,1.969252029711522
"North Seekonk CDP, Massachusetts",1083,973,110,25,49200,10.156971375807942
"North Westport CDP, Massachusetts",1994,1898,96,25,49710,4.814443329989969
"South Amherst CDP, Massachusetts",1756,1568,188,25,62675,10.70615034168565
"Chelsea city, Massachusetts",13726,13151,575,25,13205,4.189130118024187
"Edgartown CDP, Massachusetts",910,212,698,25,21115,76.70329670329672
"Ruston city, Louisiana",8870,7831,1039,22,66655,11.713641488162345
"Houma city, Louisiana",13779,12291,1488,22,36255,10.799042020465926
"Cameron CDP, Louisiana",121,93,28,22,12000,23.140495867768596
"Maringouin town, Louisiana",412,338,74,22,48610,17.96116504854369
"Choudrant village, Louisiana",525,468,57,22,15290,10.857142857142858
"Vienna town, Louisiana",202,189,13,22,78540,6.435643564356436
"Melville town, Louisiana",498,433,65,22,49730,13.052208835341366
"Opelousas city, Louisiana",7667,6154,1513,22,58045,19.733924611973393
"Bayou Cane CDP, Louisiana",8682,7743,939,22,05210,10.815480304077402
"Schriever CDP, Louisiana",2811,2632,179,22,68300,6.367840626111704
"Eros town, Louisiana",85,80,5,22,24215,5.88235294117647
"Jonesboro town, Louisiana",1918,1377,541,22,38670,28.206465067778936
"Poydras CDP, Louisiana",999,891,108,22,62280,10.81081081081081
"Dubberly village, Louisiana",134,105,29,22,21835,21.641791044776117
"Minden city, Louisiana",5703,4954,749,22,50885,13.133438541118709
"Shongaloo village, Louisiana",64,55,9,22,69455,14.0625
"Bonita village, Louisiana",135,92,43,22,08535,31.851851851851855
"Elton town, Louisiana",600,527,73,22,23620,12.166666666666668
"Estelle CDP, Louisiana",6012,5573,439,22,24390,7.3020625415835
"Lafayette city, Louisiana",56828,50416,6412,22,40735,11.283170268177658
"Rodessa village, Louisiana",110,87,23,22,65710,20.909090909090907
"Welsh town, Louisiana",1250,1146,104,22,80430,8.32
"Barataria CDP, Louisiana",519,402,117,22,04300,22.54335260115607
"Wilson village, Louisiana",286,214,72,22,82215,25.174825174825177
"Estherwood village, Louisiana",315,274,41,22,24460,13.015873015873018
"Kinder town, Louisiana",1078,932,146,22,39755,13.543599257884972
"Oberlin town, Louisiana",670,558,112,22,57450,16.716417910447763
"Converse village, Louisiana",189,135,54,22,17215,28.57142857142857
"Noble village, Louisiana",105,89,16,22,55420,15.238095238095239
"Zwolle town, Louisiana",921,731,190,22,83685,20.629750271444085
"Hodge village, Louisiana",271,201,70,22,35100,25.830258302583026
"North Hodge village, Louisiana",242,162,80,22,55910,33.057851239669425
"New Orleans city, Louisiana",191738,154036,37702,22,55000,19.663290531871617
"Marion town, Louisiana",532,344,188,22,48645,35.338345864661655
"Carencro city, Louisiana",3620,3310,310,22,12665,8.56353591160221
"Belcher village, Louisiana",147,120,27,22,05945,18.367346938775512
"Oil City town, Louisiana",503,415,88,22,57590,17.495029821073558
"Delcambre town, Louisiana",923,762,161,22,20155,17.44312026002167
"French Settlement village, Louisiana",509,401,108,22,27435,21.218074656188605
"Port Vincent village, Louisiana",363,261,102,22,62105,28.09917355371901
"Abbeville city, Louisiana",5905,4519,1386,22,00100,23.471634208298052
"Fort Polk South CDP, Louisiana",2790,2418,372,22,26757,13.333333333333334
"Doyline village, Louisiana",389,297,92,22,21590,23.65038560411311
"Rosepine town, Louisiana",825,697,128,22,66200,15.515151515151516
"Violet CDP, Louisiana",1953,1722,231,22,78855,11.827956989247312
"Downsville village, Louisiana",65,41,24,22,21450,36.92307692307693
"Farmerville town, Louisiana",1455,1043,412,22,25160,28.31615120274914
"East Hodge village, Louisiana",155,134,21,22,22465,13.548387096774196
"Fort Polk North CDP, Louisiana",1302,1086,216,22,26746,16.589861751152075
"Hornbeck town, Louisiana",242,189,53,22,36045,21.90082644628099
"Leesville city, Louisiana",3116,2374,742,22,43010,23.812580231065468
"Arabi CDP, Louisiana",2023,1778,245,22,02550,12.110726643598616
"Lillie village, Louisiana",79,66,13,22,43920,16.455696202531644
"Cotton Valley town, Louisiana",636,468,168,22,17915,26.41509433962264
"Sibley town, Louisiana",629,546,83,22,70175,13.195548489666137
"Labadieville CDP, Louisiana",858,781,77,22,40420,8.974358974358974
"Bossier City city, Louisiana",30141,26552,3589,22,08920,11.907368700441259
"Haughton town, Louisiana",1298,1167,131,22,33420,10.092449922958398
"Dry Prong village, Louisiana",229,170,59,22,21765,25.76419213973799
"Richmond village, Louisiana",206,180,26,22,64590,12.62135922330097
"Tallulah city, Louisiana",3243,2671,572,22,74690,17.63798951588036
"Hahnville CDP, Louisiana",1517,1336,181,22,32510,11.931443638760712
"Sulphur city, Louisiana",9207,7989,1218,22,73640,13.22906484196807
"Vinton town, Louisiana",1543,1272,271,22,78820,17.56318859364874
"Albany village, Louisiana",583,463,120,22,00835,20.58319039451115
"Norco CDP, Louisiana",1242,1186,56,22,55525,4.508856682769726
"Clayton town, Louisiana",323,248,75,22,15850,23.219814241486066
"New Llano town, Louisiana",1098,930,168,22,54175,15.300546448087433
"Simpson village, Louisiana",314,213,101,22,70595,32.1656050955414
"Reeves village, Louisiana",129,99,30,22,64100,23.25581395348837
"Quitman village, Louisiana",123,95,28,22,63120,22.76422764227642
"Springhill city, Louisiana",3024,2223,801,22,72485,26.488095238095237
"Palmetto village, Louisiana",66,47,19,22,58780,28.78787878787879
"Bernice town, Louisiana",816,584,232,22,07030,28.431372549019606
"Dixie Inn village, Louisiana",146,121,25,22,21135,17.123287671232877
"Gonzales city, Louisiana",4640,4195,445,22,29850,9.590517241379311
"Ringgold town, Louisiana",764,605,159,22,64905,20.81151832460733
"Saline village, Louisiana",257,213,44,22,67880,17.120622568093385
"Chataignier village, Louisiana",172,110,62,22,14450,36.04651162790697
"Marksville city, Louisiana",2425,2114,311,22,48750,12.824742268041236
"Jackson town, Louisiana",946,734,212,22,37830,22.41014799154334
"Norwood village, Louisiana",182,135,47,22,56295,25.82417582417583
"Westlake city, Louisiana",2136,1827,309,22,80815,14.466292134831459
"Ferriday town, Louisiana",1673,1325,348,22,25440,20.800956365809924
"Haynesville town, Louisiana",1299,1046,253,22,33525,19.47652040030793
"Moss Bluff CDP, Louisiana",4876,4425,451,22,52425,9.249384741591468
"Rayne city, Louisiana",3567,2952,615,22,63645,17.24137931034483
"Fisher village, Louisiana",115,84,31,22,25615,26.956521739130434
"Many town, Louisiana",1212,966,246,22,48470,20.2970297029703
"Elizabeth town, Louisiana",203,155,48,22,23235,23.645320197044335
"Roseland town, Louisiana",469,392,77,22,66165,16.417910447761194
"Jena town, Louisiana",1508,1276,232,22,38285,15.384615384615385
"Thibodaux city, Louisiana",6231,5692,539,22,75425,8.650296902583856
"Montz CDP, Louisiana",758,726,32,22,51795,4.221635883905013
"Tangipahoa village, Louisiana",264,199,65,22,74760,24.62121212121212
"Atlanta village, Louisiana",81,65,16,22,03390,19.753086419753085
"Grayson village, Louisiana",297,220,77,22,31250,25.925925925925924
"Jonesville town, Louisiana",1064,801,263,22,38775,24.718045112781954
"Venice CDP, Louisiana",90,77,13,22,78015,14.444444444444443
"Sicily Island village, Louisiana",286,201,85,22,70245,29.72027972027972
"Triumph CDP, Louisiana",221,168,53,22,76440,23.981900452488688
"Union CDP, Louisiana",324,242,82,22,77035,25.308641975308642
"Ventress CDP, Louisiana",613,424,189,22,78050,30.831973898858074
"Vienna Bend CDP, Louisiana",477,477,0,22,78545,0.0
"Wallace Ridge CDP, Louisiana",355,299,56,22,79310,15.774647887323944
"Watson CDP, Louisiana",520,520,0,22,80010,0.0
"Welcome CDP, Louisiana",321,300,21,22,80360,6.5420560747663545
"Bayou Corne CDP, Louisiana",85,9,76,22,05255,89.41176470588236
"Casco CDP, Maine",469,287,182,23,11090,38.80597014925373
"Castine CDP, Maine",403,130,273,23,11230,67.74193548387096
"Cousins Island CDP, Maine",261,241,20,23,14800,7.662835249042145
"Damariscotta CDP, Maine",804,588,216,23,16200,26.865671641791046
"Eagle Lake CDP, Maine",294,186,108,23,19385,36.734693877551024
"Falmouth CDP, Maine",1031,997,34,23,24480,3.2977691561590685
"Gray CDP, Maine",377,377,0,23,28835,0.0
"Little Falls CDP, Maine",408,322,86,23,40350,21.07843137254902
"Littlejohn Island CDP, Maine",87,15,72,23,40470,82.75862068965517
"Lubec CDP, Maine",329,179,150,23,41575,45.59270516717325
"Mapleton CDP, Maine",355,350,5,23,43220,1.4084507042253522
"Mars Hill CDP, Maine",439,369,70,23,43675,15.945330296127564
"Naples CDP, Maine",522,194,328,23,48050,62.83524904214559
"Newcastle CDP, Maine",405,327,78,23,48610,19.25925925925926
"Southwest Harbor CDP, Maine",688,360,328,23,72830,47.674418604651166
"South Windham CDP, Maine",237,210,27,23,72900,11.39240506329114
"Standish CDP, Maine",324,223,101,23,73635,31.17283950617284
"Steep Falls CDP, Maine",540,515,25,23,73985,4.62962962962963
"Washburn CDP, Maine",529,477,52,23,80250,9.829867674858223
"Winter Harbor CDP, Maine",432,149,283,23,86620,65.50925925925925
"Alfred CDP, Maine",470,452,18,23,00695,3.829787234042553
"Sanford city, Maine",10003,8791,1212,23,65725,12.116365090472858
"Old Town city, Maine",3992,3326,666,23,55225,16.683366733466933
"Biddeford city, Maine",10071,8899,1172,23,04860,11.637374640055604
"Old Orchard Beach CDP, Maine",6748,4778,1970,23,55120,29.193835210432724
"Berwick CDP, Maine",1078,955,123,23,04685,11.410018552875696
"Millinocket CDP, Maine",2819,2150,669,23,45845,23.73181979425328
"Mexico CDP, Maine",1038,619,419,23,45250,40.36608863198459
"Dexter CDP, Maine",1398,1026,372,23,17495,26.609442060085836
"Falmouth Foreside CDP, Maine",644,587,57,23,24530,8.850931677018634
"Howland CDP, Maine",499,404,95,23,34225,19.03807615230461
"Norridgewock CDP, Maine",589,504,85,23,49800,14.431239388794568
"Boothbay Harbor CDP, Maine",894,593,301,23,06085,33.66890380313199
"Oakland CDP, Maine",1209,1048,161,23,54525,13.316790736145576
"Bath city, Maine",4451,3961,490,23,03355,11.008762075937991
"North Windham CDP, Maine",2389,2118,271,23,53685,11.343658434491418
"Machias CDP, Maine",672,525,147,23,41925,21.875
"Richmond CDP, Maine",914,800,114,23,62610,12.472647702407002
"Brewer city, Maine",4252,3669,583,23,06925,13.711194731890874
"West Kennebunk CDP, Maine",427,409,18,23,83330,4.215456674473068
"Auburn city, Maine",11220,10262,958,23,02060,8.538324420677363
"Dover-Foxcroft CDP, Maine",1373,1182,191,23,18230,13.911143481427532
"Milo CDP, Maine",1079,905,174,23,45985,16.126042632066728
"Thomaston CDP, Maine",1003,971,32,23,76330,3.1904287138584246
"Ellsworth city, Maine",4430,3491,939,23,23200,21.196388261851016
"Dixfield CDP, Maine",728,519,209,23,17705,28.708791208791208
"Gorham CDP, Maine",2452,2342,110,23,28205,4.486133768352365
"Belfast city, Maine",3513,2991,522,23,03950,14.859094790777114
"Waldoboro CDP, Maine",895,697,198,23,79515,22.12290502793296
"Augusta city, Maine",9833,8718,1115,23,02100,11.339367436184277
"Winslow CDP, Maine",2321,2209,112,23,86480,4.825506247307195
"Winthrop CDP, Maine",1307,1240,67,23,86935,5.1262433052792655
"Newport CDP, Maine",1009,827,182,23,49100,18.037661050545097
"Eastport city, Maine",1066,640,426,23,21730,39.9624765478424
"Kennebunk CDP, Maine",3002,2726,276,23,36500,9.193870752831446
"Kittery CDP, Maine",2323,2033,290,23,37235,12.48385708136031
"Fort Fairfield CDP, Maine",970,861,109,23,25580,11.237113402061857
"Presque Isle city, Maine",4594,4082,512,23,60825,11.144971702220287
"Lewiston city, Maine",16898,15779,1119,23,38740,6.62208545389987
"Lisbon Falls CDP, Maine",1765,1559,206,23,40105,11.671388101983004
"Guilford CDP, Maine",410,357,53,23,30060,12.926829268292684
"Camden CDP, Maine",2611,1811,800,23,09690,30.639601685178093
"Rockland city, Maine",4014,3453,561,23,63590,13.97608370702541
"Brunswick Station CDP, Maine",304,285,19,23,08500,6.25
"Cumberland Center CDP, Maine",1013,980,33,23,15500,3.257650542941757
"Portland city, Maine",34238,30564,3674,23,60545,10.730766984052806
"Bingham CDP, Maine",531,355,176,23,04965,33.14500941619586
"Skowhegan CDP, Maine",3180,2953,227,23,68875,7.138364779874213
"Winterport CDP, Maine",580,543,37,23,86725,6.379310344827586
"Milford CDP, Maine",1035,858,177,23,45635,17.101449275362317
"Cape Neddick CDP, Maine",3553,1209,2344,23,10320,65.97241767520406
"Kennebunkport CDP, Maine",843,525,318,23,36710,37.72241992882562
"Saco city, Maine",8542,7768,774,23,64675,9.061109810348865
"York Harbor CDP, Maine",1858,1222,636,23,88160,34.230355220667384
"Livermore Falls CDP, Maine",887,745,142,23,40735,16.00901916572717
"Topsham CDP, Maine",2998,2731,267,23,76925,8.905937291527685
"Norway CDP, Maine",1133,944,189,23,53965,16.68137687555163
"Yarmouth CDP, Maine",2378,2344,34,23,87810,1.4297729184188395
"Madison CDP, Maine",1218,1094,124,23,42625,10.180623973727423
"Pittsfield CDP, Maine",1289,1108,181,23,58970,14.04189294026377
"Clinton CDP, Maine",551,426,125,23,13435,22.686025408348456
"Farmingdale CDP, Maine",1203,1037,166,23,24635,13.798836242726518
"Farmington CDP, Maine",1482,1351,131,23,24740,8.83940620782726
"Wiscasset CDP, Maine",746,660,86,23,87040,11.528150134048257
"Bangor city, Maine",15678,14071,1607,23,02795,10.250031891822935
"Limestone CDP, Maine",495,434,61,23,39265,12.323232323232324
"Orono CDP, Maine",3019,2550,469,23,55575,15.534945346141107
"Randolph CDP, Maine",981,852,129,23,61735,13.149847094801222
"Houlton CDP, Maine",2558,2131,427,23,33945,16.692728694292416
"Van Buren CDP, Maine",929,772,157,23,78535,16.89989235737352
"Bucksport CDP, Maine",1551,1219,332,23,08780,21.40554480980013
"Oxford CDP, Maine",548,427,121,23,56240,22.08029197080292
"South Paris CDP, Maine",1060,910,150,23,71780,14.150943396226415
"Bridgton CDP, Maine",1640,1031,609,23,07135,37.13414634146341
"Westbrook city, Maine",8709,8031,678,23,82105,7.7850499483293145
"Hartland CDP, Maine",392,344,48,23,31705,12.244897959183673
"Searsport CDP, Maine",721,595,126,23,66600,17.475728155339805
"Gardiner city, Maine",2668,2447,221,23,27085,8.28335832083958
"Wilton CDP, Maine",1135,857,278,23,85815,24.493392070484582
"Fort Kent CDP, Maine",1145,1013,132,23,25720,11.528384279475983
"Madawaska CDP, Maine",1615,1332,283,23,42485,17.523219814241486
"Lake Arrowhead CDP, Maine",1202,845,357,23,37795,29.700499168053245
"Rumford CDP, Maine",2724,1618,1106,23,64255,40.602055800293684
"Scarborough CDP, Maine",2053,1969,84,23,66110,4.09157330735509
"Unity CDP, Maine",286,173,113,23,78220,39.51048951048951
"Hampden CDP, Maine",1629,1570,59,23,30760,3.6218538980969917
"Kittery Point CDP, Maine",564,564,0,23,37375,0.0
"Brunswick CDP, Maine",6919,6330,589,23,08395,8.512790865732041
"North Berwick CDP, Maine",658,584,74,23,50290,11.246200607902736
"Hallowell city, Maine",1259,1099,160,23,30550,12.708498808578236
"Mechanic Falls CDP, Maine",958,822,136,23,44620,14.19624217118998
"Anson CDP, Maine",420,408,12,23,01360,2.857142857142857
"Chisholm CDP, Maine",826,665,161,23,12770,19.491525423728813
"Lincoln CDP, Maine",1387,1239,148,23,39440,10.670511896178802
"Calais city, Maine",2014,1496,518,23,09585,25.719960278053627
"Woodland CDP, Maine",552,411,141,23,87250,25.543478260869566
"Waterville city, Maine",8026,7195,831,23,80740,10.353849987540494
"South Eliot CDP, Maine",1569,1477,92,23,70660,5.863607393244105
"Caribou city, Maine",4077,3488,589,23,10565,14.446897228354183
"Greenville CDP, Maine",934,510,424,23,29500,45.396145610278374
"Bar Harbor CDP, Maine",1607,949,658,23,02830,40.945861854387054
"Fryeburg CDP, Maine",735,531,204,23,26875,27.755102040816325
"Freeport CDP, Maine",789,682,107,23,26490,13.561470215462613
"South Portland city, Maine",11626,10783,843,23,71990,7.250989162222604
"Fairfield CDP, Maine",1367,1361,6,23,24285,0.43891733723482074
"East Millinocket CDP, Maine",837,757,80,23,21065,9.55794504181601
"Ashland CDP, Maine",349,285,64,23,01675,18.33810888252149
"Blaine CDP, Maine",178,125,53,23,05350,29.775280898876407
"Blue Hill CDP, Maine",670,488,182,23,05665,27.164179104477608
"Bowdoinham CDP, Maine",314,268,46,23,06330,14.64968152866242
"Seat Pleasant city, Maryland",1772,1620,152,24,70850,8.577878103837472
"Walker Mill CDP, Maryland",4899,4605,294,24,81250,6.0012247397428045
"Sudlersville town, Maryland",224,208,16,24,75650,7.142857142857142
"Princess Anne town, Maryland",1801,1417,384,24,64000,21.321488062187672
"Lake Arbor CDP, Maryland",4720,4387,333,24,44817,7.055084745762712
"Morningside town, Maryland",433,407,26,24,53625,6.0046189376443415
"Rosaryville CDP, Maryland",3725,3531,194,24,68300,5.208053691275167
"Springdale CDP, Maryland",1006,1006,0,24,74282,0.0
"Woodlawn CDP (Prince George's County), Maryland",2145,2054,91,24,86525,4.242424242424243
"Prince Frederick CDP, Maryland",1322,1258,64,24,63950,4.841149773071105
"Grasonville CDP, Maryland",1443,1247,196,24,34550,13.582813582813582
"Kingstown CDP, Maryland",897,775,122,24,44325,13.600891861761427
"Templeville town, Maryland",46,37,9,24,77200,19.565217391304348
"Queen Anne town, Maryland",92,91,1,24,64500,1.0869565217391304
"Linthicum CDP, Maryland",4134,3935,199,24,47125,4.813739719400097
"Mayo CDP, Maryland",3435,3065,370,24,51575,10.771470160116449
"Riviera Beach CDP, Maryland",4936,4623,313,24,66850,6.341166936790923
"Funkstown town, Maryland",441,410,31,24,31100,7.029478458049887
"Williamsport town, Maryland",1084,1016,68,24,85100,6.273062730627306
"Bel Air North CDP, Maryland",11404,11121,283,24,05825,2.4815854086285514
"Edgewood CDP, Maryland",10033,9027,1006,24,25150,10.026911193062894
"Bowleys Quarters CDP, Maryland",2827,2637,190,24,08800,6.720905553590378
"Essex CDP, Maryland",16569,14972,1597,24,26600,9.638481501599372
"Hampton CDP, Maryland",1905,1747,158,24,36512,8.293963254593177
"Deal Island CDP, Maryland",331,211,120,24,22100,36.25377643504532
"Ferndale CDP, Maryland",6684,6429,255,24,28075,3.8150807899461405
"Fort Meade CDP, Maryland",2988,2715,273,24,29400,9.136546184738956
"Cordova CDP, Maryland",259,232,27,24,19900,10.424710424710424
"Union Bridge town, Maryland",386,350,36,24,79350,9.32642487046632
"Trappe town, Maryland",506,482,24,24,78575,4.743083003952568
"Pocomoke City city, Maryland",1924,1651,273,24,62475,14.18918918918919
"La Vale CDP, Maryland",1694,1617,77,24,46075,4.545454545454546
"Perryville town, Maryland",2060,1814,246,24,61150,11.941747572815533
"Algonquin CDP, Maryland",584,555,29,24,00712,4.965753424657534
"Walkersville town, Maryland",2243,2243,0,24,81275,0.0
"Vienna town, Maryland",185,144,41,24,80600,22.162162162162165
"Ballenger Creek CDP, Maryland",8025,7621,404,24,03800,5.034267912772586
"Emmitsburg town, Maryland",1163,1068,95,24,26200,8.16852966466036
"Jessup CDP, Maryland",574,574,0,24,42550,0.0
"Leonardtown town, Maryland",1333,1249,84,24,46475,6.301575393848462
"Glen Burnie CDP, Maryland",29091,26768,2323,24,32650,7.985287545976419
"Pasadena CDP, Maryland",11052,10409,643,24,60475,5.817951501990589
"Fort Ritchie CDP, Maryland",121,43,78,24,29450,64.46280991735537
"Cape St. Claire CDP, Maryland",3481,3285,196,24,12912,5.630565929330652
"Aberdeen city, Maryland",7091,6429,662,24,00125,9.335777746439149
"Aberdeen Proving Ground CDP, Maryland",963,760,203,24,00175,21.079958463136034
"Riverside CDP, Maryland",2572,2400,172,24,66762,6.6874027993779155
"Arbutus CDP, Maryland",8330,7598,732,24,01975,8.787515006002401
"Cockeysville CDP, Maryland",9938,9296,642,24,18250,6.46005232441135
"Rossville CDP, Maryland",6590,5893,697,24,68700,10.576631259484067
"Ashton-Sandy Spring CDP, Maryland",2057,1959,98,24,02762,4.76421973748177
"Arnold CDP, Maryland",8819,8438,381,24,02275,4.320217711758702
"Brooklyn Park CDP, Maryland",5736,5346,390,24,10475,6.7991631799163175
"Deale CDP, Maryland",2093,1805,288,24,22050,13.760152890587673
"Brunswick city, Maryland",2319,2221,98,24,10900,4.225959465286762
"La Plata town, Maryland",3255,3092,163,24,45750,5.007680491551459
"East New Market town, Maryland",224,172,52,24,24450,23.214285714285715
"Galestown town, Maryland",72,33,39,24,31250,54.166666666666664
"New Market town, Maryland",403,391,12,24,55650,2.977667493796526
"Rosemont village, Maryland",145,137,8,24,68600,5.517241379310345
"Kitzmiller town, Maryland",139,117,22,24,44450,15.827338129496402
"Parole CDP, Maryland",8975,8159,816,24,60325,9.09192200557103
"Maryland City CDP, Maryland",7079,6613,466,24,51075,6.582850685125018
"Naval Academy CDP, Maryland",117,104,13,24,55050,11.11111111111111
"Odenton CDP, Maryland",17419,16511,908,24,58300,5.212698777197313
"Eldersburg CDP, Maryland",11331,11001,330,24,25575,2.9123643102991794
"Hillandale CDP, Maryland",2096,2034,62,24,38850,2.9580152671755724
"Annapolis city, Maryland",17243,15664,1579,24,01600,9.157339210114248
"Crofton CDP, Maryland",10698,10329,369,24,20875,3.4492428491306786
"Easton town, Maryland",8101,7472,629,24,24475,7.764473521787433
"Sykesville town, Maryland",1544,1453,91,24,76550,5.89378238341969
"Severna Park CDP, Maryland",13867,13190,677,24,71200,4.882094180428355
"New Windsor town, Maryland",535,471,64,24,55925,11.962616822429908
"Taneytown city, Maryland",2704,2548,156,24,76725,5.769230769230769
"St. Michaels town, Maryland",807,563,244,24,69825,30.235439900867412
"Highfield-Cascade CDP, Maryland",495,347,148,24,38437,29.898989898989896
"Mount Aetna CDP, Maryland",219,219,0,24,53750,0.0
"Mount Lena CDP, Maryland",258,196,62,24,54125,24.031007751937985
"Paramount-Long Meadow CDP, Maryland",1053,1002,51,24,59787,4.843304843304843
"San Mar CDP, Maryland",145,34,111,24,70300,76.55172413793103
"Ocean City town, Maryland",30089,3585,26504,24,58225,88.08534680448005
"Ocean Pines CDP, Maryland",9076,5435,3641,24,58275,40.11679153812252
"North East town, Maryland",1850,1566,284,24,56450,15.35135135135135
"Hughesville CDP, Maryland",826,788,38,24,40700,4.600484261501211
"Waldorf CDP, Maryland",28782,27263,1519,24,81175,5.277604058091863
"Bel Air town, Maryland",4758,4518,240,24,05550,5.044136191677175
"Jarrettsville CDP, Maryland",1057,959,98,24,42325,9.271523178807946
"Joppatowne CDP, Maryland",5211,4866,345,24,42875,6.620610247553254
"Crownsville CDP, Maryland",605,605,0,24,21075,0.0
"Highland Beach town, Maryland",100,41,59,24,38500,59.0
"Lake Shore CDP, Maryland",7397,7002,395,24,44975,5.340002703798837
"Boonsboro town, Maryland",1478,1386,92,24,08625,6.2246278755074425
"Severn CDP, Maryland",19380,18341,1039,24,71150,5.361197110423117
"Shady Side CDP, Maryland",2538,2170,368,24,71450,14.49960598896769
"Manchester town, Maryland",1743,1647,96,24,49950,5.507745266781412
"Cavetown CDP, Maryland",487,447,40,24,14225,8.213552361396303
"Clear Spring town, Maryland",252,191,61,24,17600,24.206349206349206
"Halfway CDP, Maryland",4717,4462,255,24,36125,5.4059783760864955
"Rohrersville CDP, Maryland",87,87,0,24,67950,0.0
"St. James CDP, Maryland",1043,1015,28,24,69550,2.684563758389262
"Wilson-Conococheague CDP, Maryland",1018,965,53,24,85395,5.206286836935167
"Girdletree CDP, Maryland",38,38,0,24,32250,0.0
"Charlestown town, Maryland",632,505,127,24,15400,20.094936708860757
"Chesapeake City town, Maryland",394,331,63,24,15950,15.989847715736042
"Indian Head town, Maryland",1545,1386,159,24,41500,10.29126213592233
"Kingsville CDP, Maryland",1652,1573,79,24,44350,4.782082324455206
"Parkville CDP, Maryland",13113,12404,709,24,60275,5.406848165942195
"Towson CDP, Maryland",22801,21130,1671,24,78425,7.328625937458884
"Brookmont CDP, Maryland",1326,1298,28,24,10500,2.1116138763197587
"Chevy Chase town, Maryland",1079,1021,58,24,16620,5.375347544022243
"Chevy Chase CDP, Maryland",3909,3678,231,24,16625,5.909439754412894
"Chevy Chase Section Three village, Maryland",271,250,21,24,16730,7.7490774907749085
"Hagerstown city, Maryland",18290,15976,2314,24,36075,12.651722252597047
"Riva CDP, Maryland",1474,1441,33,24,66400,2.2388059701492535
"Tilghman Island CDP, Maryland",617,390,227,24,77912,36.790923824959485
"Fountainhead-Orchard Hills CDP, Maryland",2486,2447,39,24,29712,1.5687851971037812
"Hancock town, Maryland",773,641,132,24,36600,17.076326002587322
"Robinwood CDP, Maryland",3276,3138,138,24,67000,4.212454212454213
"Berlin town, Maryland",2138,1800,338,24,06800,15.809167446211411
"Snow Hill town, Maryland",944,785,159,24,73075,16.843220338983052
"Stockton CDP, Maryland",86,63,23,24,75200,26.744186046511626
"Cumberland city, Maryland",10299,8360,1939,24,21325,18.82707058937761
"Midland town, Maryland",269,269,0,24,52475,0.0
"Cecilton town, Maryland",390,363,27,24,14325,6.923076923076923
"Rising Sun town, Maryland",1093,993,100,24,66275,9.149130832570906
"Bryans Road CDP, Maryland",2971,2738,233,24,10925,7.842477280376977
"Cambridge city, Maryland",6494,5163,1331,24,12400,20.495842315983985
"Lonaconing town, Maryland",525,432,93,24,47875,17.71428571428571
"Westernport town, Maryland",1004,812,192,24,82750,19.12350597609562
"Elkton town, Maryland",6026,5401,625,24,25800,10.371722535678725
"Bowie city, Maryland",21678,20822,856,24,08775,3.9487037549589448
"Willards town, Maryland",377,338,39,24,84950,10.344827586206897
"Marydel town, Maryland",98,71,27,24,51025,27.55102040816326
"Berwyn Heights town, Maryland",1022,974,48,24,06925,4.6966731898238745
"Langley Park CDP, Maryland",5007,4707,300,24,45525,5.991611743559018
"Riverdale Park town, Maryland",2240,2090,150,24,66635,6.696428571428571
"Upper Marlboro town, Maryland",331,291,40,24,79875,12.084592145015106
"Takoma Park city, Maryland",6890,6574,316,24,76650,4.586357039187227
"St. Leonard CDP, Maryland",164,164,0,24,69675,0.0
"Solomons CDP, Maryland",1240,969,271,24,73325,21.85483870967742
"Adelphi CDP, Maryland",5257,4951,306,24,00400,5.820810348107285
"Brentwood town, Maryland",1057,958,99,24,09500,9.366130558183539
"Cheverly town, Maryland",2619,2484,135,24,16550,5.154639175257731
"Clinton CDP, Maryland",13368,12584,784,24,17900,5.8647516457211255
"Glenn Dale CDP, Maryland",4367,4281,86,24,33400,1.969315319441264
"New Carrollton city, Maryland",4547,4353,194,24,55400,4.266549373213108
"Woodmore CDP, Maryland",1511,1490,21,24,86710,1.3898080741230974
"Centreville town, Maryland",1930,1648,282,24,14950,14.61139896373057
"Colmar Manor town, Maryland",411,387,24,24,18850,5.839416058394161
"Kent Narrows CDP, Maryland",357,265,92,24,43725,25.770308123249297
"Dames Quarter CDP, Maryland",121,45,76,24,21550,62.8099173553719
"Camp Springs CDP, Maryland",8453,7622,831,24,12600,9.830829291375844
"Port Deposit town, Maryland",371,233,138,24,63075,37.19676549865229
"Potomac Heights CDP, Maryland",603,575,28,24,63375,4.643449419568822
"Frederick city, Maryland",28971,27180,1791,24,30325,6.182044113078596
"Friendsville town, Maryland",276,241,35,24,30850,12.681159420289855
"Hyattsville city, Maryland",6915,6414,501,24,41250,7.245119305856833
"Preston town, Maryland",336,297,39,24,63825,11.607142857142858
"Fairmount Heights town, Maryland",581,529,52,24,27400,8.950086058519794
"Forestville CDP, Maryland",4685,4324,361,24,29000,7.705442902881537
"Fort Washington CDP, Maryland",8690,8107,583,24,29525,6.70886075949367
"Friendly CDP, Maryland",3197,3085,112,24,30575,3.5032843290584923
"Mount Rainier city, Maryland",3728,3460,268,24,54275,7.188841201716738
"North Brentwood town, Maryland",222,213,9,24,56375,4.054054054054054
"South Laurel CDP, Maryland",10570,9914,656,24,73650,6.206244087038789
"Barclay town, Maryland",85,52,33,24,04250,38.82352941176471
"Stevensville CDP, Maryland",2637,2424,213,24,75025,8.0773606370876
"Chance CDP, Maryland",277,180,97,24,15075,35.018050541516246
"Frenchtown-Rumbly CDP, Maryland",54,33,21,24,30567,38.88888888888889
"Smith Island CDP, Maryland",188,78,110,24,72887,58.51063829787234
"Oakland town, Maryland",1021,834,187,24,57650,18.31537708129285
"Elkridge CDP, Maryland",7789,7521,268,24,25750,3.440749775324175
"Ellicott City CDP, Maryland",26732,25671,1061,24,26000,3.9690258865778842
"Bel Air South CDP, Maryland",19609,18601,1008,24,05950,5.140496710694069
"Fallston CDP, Maryland",3154,3154,0,24,27700,0.0
"Havre de Grace city, Maryland",6288,5697,591,24,37600,9.398854961832061
"Carney CDP, Maryland",13829,12780,1049,24,13325,7.585508713572926
"Garrison CDP, Maryland",3884,3669,215,24,31625,5.535530381050464
"Hampstead town, Maryland",2552,2478,74,24,36500,2.8996865203761755
"Milford Mill CDP, Maryland",12610,11484,1126,24,52562,8.929421094369548
"White Marsh CDP, Maryland",3768,3513,255,24,84350,6.7675159235668785
"Myersville town, Maryland",603,583,20,24,54875,3.316749585406302
"Church Creek town, Maryland",60,54,6,24,17050,10.0
"Middletown town, Maryland",1705,1513,192,24,52425,11.260997067448681
"Mountain Lake Park town, Maryland",1009,906,103,24,53800,10.20812685827552
"Galena town, Maryland",345,300,45,24,31225,13.043478260869565
"California CDP, Maryland",5821,5403,418,24,12150,7.1808967531352
"Golden Beach CDP, Maryland",1277,1151,126,24,33850,9.866875489428347
"Lexington Park CDP, Maryland",5240,4773,467,24,46725,8.912213740458014
"Catonsville CDP, Maryland",16049,15181,868,24,14125,5.408436662720419
"Chevy Chase View town, Maryland",340,316,24,24,16775,7.0588235294117645
"Forest Glen CDP, Maryland",2642,2446,196,24,28640,7.418622255866768
"Delmar town, Maryland",1428,1267,161,24,22600,11.27450980392157
"Kemp Mill CDP, Maryland",4702,4430,272,24,43200,5.78477243726074
"Kensington town, Maryland",894,875,19,24,43500,2.1252796420581657
"Martin's Additions village, Maryland",341,327,14,24,50965,4.105571847507331
"Montgomery Village CDP, Maryland",12395,11626,769,24,53325,6.204114562323518
"Denton town, Maryland",1821,1585,236,24,22725,12.959912136188906
"Goldsboro town, Maryland",103,85,18,24,33950,17.475728155339805
"Henderson town, Maryland",52,37,15,24,37925,28.846153846153843
"North Laurel CDP, Maryland",8550,8214,336,24,56725,3.929824561403509
"Braddock Heights CDP, Maryland",1332,1247,85,24,09100,6.381381381381382
"Burkittsville town, Maryland",73,63,10,24,11400,13.698630136986301
"Loch Lynn Heights town, Maryland",213,200,13,24,47525,6.103286384976526
"Chevy Chase Section Five village, Maryland",230,216,14,24,16720,6.086956521739131
"Edgemere CDP, Maryland",3539,3258,281,24,24950,7.940096072336818
"Perry Hall CDP, Maryland",11601,10986,615,24,60975,5.3012671321437805
"Aspen Hill CDP, Maryland",17645,16983,662,24,02825,3.7517710399546615
"Darnestown CDP, Maryland",2265,2209,56,24,21825,2.4724061810154527
"Poolesville town, Maryland",1639,1530,109,24,62850,6.650396583282489
"Redland CDP, Maryland",5584,5375,209,24,65312,3.7428366762177654
"Silver Spring CDP, Maryland",33137,31541,1596,24,72450,4.8163684099345145
"Edmonston town, Maryland",438,420,18,24,25425,4.10958904109589
"North Beach town, Maryland",1211,1159,52,24,56300,4.293971924029727
"Chillum CDP, Maryland",11233,10606,627,24,16875,5.581768004985311
"Cottage City town, Maryland",483,453,30,24,20050,6.211180124223603
"Forest Heights town, Maryland",820,760,60,24,28725,7.317073170731707
"Cloverly CDP, Maryland",5067,4773,294,24,18150,5.802249851983422
"Germantown CDP, Maryland",32489,30935,1554,24,32025,4.783157376342762
"Somerset town, Maryland",415,405,10,24,73350,2.4096385542168677
"South Kensington CDP, Maryland",3040,2965,75,24,73600,2.4671052631578947
"Accokeek CDP, Maryland",4127,4044,83,24,00250,2.011146110976496
"Brandywine CDP, Maryland",3396,3030,366,24,09325,10.777385159010601
"Middle River CDP, Maryland",10432,9431,1001,24,52300,9.5954754601227
"Damascus CDP, Maryland",5071,4833,238,24,21475,4.6933543679747585
"Glenarden city, Maryland",2415,2052,363,24,32500,15.031055900621118
"Bethesda CDP, Maryland",27383,25507,1876,24,07125,6.850965927765403
"Calverton CDP, Maryland",7229,6901,328,24,12350,4.537280398395352
"Lusby CDP, Maryland",880,757,123,24,48800,13.977272727272727
"Mardela Springs town, Maryland",202,164,38,24,50525,18.81188118811881
"Salisbury city, Maryland",14268,12291,1977,24,69925,13.856181665264927
"Brookview town, Maryland",23,20,3,24,10575,13.043478260869565
"Hurlock town, Maryland",1069,916,153,24,41125,14.31244153414406
"Mount Airy town, Maryland",3295,3177,118,24,53875,3.5811836115326257
"Thurmont town, Maryland",2715,2573,142,24,77825,5.230202578268877
"Grantsville town, Maryland",364,312,52,24,34525,14.285714285714285
"Woodlawn CDP (Baltimore County), Maryland",15258,14182,1076,24,86475,7.052038275003277
"Brookeville town, Maryland",59,59,0,24,10225,0.0
"Chevy Chase Village town, Maryland",711,663,48,24,16787,6.751054852320674
"Gaithersburg city, Maryland",25910,24540,1370,24,31175,5.287533770744886
"North Kensington CDP, Maryland",3740,3472,268,24,56712,7.165775401069519
"Travilah CDP, Maryland",3784,3619,165,24,78650,4.3604651162790695
"Washington Grove town, Maryland",251,237,14,24,81675,5.577689243027888
"Pittsville town, Maryland",635,580,55,24,62025,8.661417322834646
"Lochearn CDP, Maryland",10771,10126,645,24,47450,5.988301921827128
"Mays Chapel CDP, Maryland",4982,4721,261,24,51587,5.238859895624247
"Overlea CDP, Maryland",5259,4923,336,24,59325,6.38904734740445
"Reisterstown CDP, Maryland",10668,10086,582,24,65600,5.455568053993251
"Rosedale CDP, Maryland",7361,6891,470,24,68400,6.385002037766608
"Cabin John CDP, Maryland",911,862,49,24,12075,5.378704720087816
"Clarksburg CDP, Maryland",7188,6968,220,24,17350,3.060656649972176
"Garrett Park town, Maryland",382,367,15,24,31525,3.926701570680628
"Glen Echo town, Maryland",107,99,8,24,32900,7.476635514018691
"North Bethesda CDP, Maryland",22125,21278,847,24,56337,3.8282485875706214
"Potomac CDP, Maryland",16723,16239,484,24,63300,2.8942175446989173
"Coral Hills CDP, Maryland",3862,3433,429,24,19825,11.108234075608493
"Caspian city, Michigan",428,309,119,26,13860,27.80373831775701
"Weidman CDP, Michigan",402,333,69,26,85140,17.16417910447761
"Potterville city, Michigan",1169,1064,105,26,66100,8.982035928143713
"Sunfield village, Michigan",206,180,26,26,77420,12.62135922330097
"Farmington city, Michigan",4894,4721,173,26,27380,3.534940743767879
"Ferndale city, Michigan",11071,10195,876,26,27880,7.912564357329961
"Hazel Park city, Michigan",8002,7244,758,26,37420,9.47263184203949
"Lincoln Park city, Michigan",15601,14265,1336,26,47800,8.563553618357798
"Lost Lake Woods CDP, Michigan",569,196,373,26,49450,65.5536028119508
"Brighton city, Michigan",3944,3692,252,26,10620,6.389452332657202
"Galien village, Michigan",228,202,26,26,31300,11.403508771929824
"Lake Michigan Beach CDP, Michigan",1132,538,594,26,44820,52.473498233215544
"Elsie village, Michigan",500,445,55,26,25780,11.0
"Clifford village, Michigan",130,117,13,26,16420,10.0
"Norway city, Michigan",1739,1447,292,26,59220,16.791259344450836
"Columbiaville village, Michigan",368,325,43,26,17460,11.684782608695652
"Turner village, Michigan",57,49,8,26,80820,14.035087719298245
"Ashley village, Michigan",245,231,14,26,03740,5.714285714285714
"Elk Rapids village, Michigan",1199,763,436,26,25320,36.36363636363637
"Huntington Woods city, Michigan",2450,2328,122,26,40000,4.979591836734694
"Dryden village, Michigan",426,387,39,26,23140,9.15492957746479
"Mio CDP, Michigan",1288,875,413,26,54660,32.065217391304344
"Hanover village, Michigan",210,170,40,26,36380,19.047619047619047
"Springport village, Michigan",314,301,13,26,75860,4.140127388535031
"Croswell city, Michigan",1240,1084,156,26,18920,12.580645161290322
"Melvin village, Michigan",77,69,8,26,52920,10.38961038961039
"Howell city, Michigan",4574,4297,277,26,39540,6.055968517708789
"Pinckney village, Michigan",947,947,0,26,64140,0.0
"Corunna city, Michigan",1484,1367,117,26,18300,7.884097035040432
"Owosso city, Michigan",6672,6014,658,26,61940,9.8621103117506
"Perry city, Michigan",973,910,63,26,63700,6.474820143884892
"Whittemore city, Michigan",233,195,38,26,87140,16.30901287553648
"Pewamo village, Michigan",191,182,9,26,63900,4.712041884816754
"Portland city, Michigan",1609,1470,139,26,65860,8.638906152889994
"Mulliken village, Michigan",252,224,28,26,56140,11.11111111111111
"Stephenson city, Michigan",419,354,65,26,76380,15.513126491646778
"Buckley village, Michigan",304,271,33,26,11480,10.855263157894738
"Manton city, Michigan",620,495,125,26,50880,20.161290322580644
"Shorewood-Tower Hills-Harbert CDP, Michigan",1684,813,871,26,73730,51.72209026128266
"Grand Beach village, Michigan",453,145,308,26,33260,67.99116997792495
"Michiana village, Michigan",380,107,273,26,53500,71.84210526315789
"Shoreham village, Michigan",456,414,42,26,73660,9.210526315789473
"Boyne City city, Michigan",2261,1714,547,26,09820,24.19283502874834
"Iron Mountain city, Michigan",3465,3014,451,26,40960,13.015873015873018
"Quinnesec CDP, Michigan",502,453,49,26,66720,9.760956175298805
"Kinde village, Michigan",234,193,41,26,43220,17.52136752136752
"Pigeon village, Michigan",667,612,55,26,64060,8.245877061469265
"Chesaning village, Michigan",1132,997,135,26,15140,11.925795053003533
"Big Rapids city, Michigan",3674,3204,470,26,08300,12.792596624931955
"Olivet city, Michigan",433,374,59,26,60580,13.625866050808314
"Waverly CDP, Michigan",11742,11060,682,26,84800,5.808209845000851
"Mount Clemens city, Michigan",7472,6814,658,26,55820,8.806209850107066
"Grand Ledge city, Michigan",3699,3576,123,26,33420,3.32522303325223
"Roseville city, Michigan",21178,19912,1266,26,69800,5.977901595995845
"Utica city, Michigan",2388,2262,126,26,81540,5.276381909547738
"Rockford city, Michigan",2364,2309,55,26,69080,2.3265651438240273
"Capac village, Michigan",820,776,44,26,13140,5.365853658536586
"Emmett village, Michigan",113,99,14,26,25940,12.389380530973451
"Fraser city, Michigan",6454,6043,411,26,30420,6.368143786798884
"Cadillac city, Michigan",4887,4403,484,26,12320,9.903826478412114
"Harrietta village, Michigan",105,73,32,26,36720,30.476190476190478
"Lakeview village, Michigan",477,432,45,26,45240,9.433962264150944
"Belding city, Michigan",2371,2200,171,26,06900,7.212146773513285
"Elkton village, Michigan",445,373,72,26,25360,16.179775280898877
"Owendale village, Michigan",113,106,7,26,61920,6.1946902654867255
"Mayville village, Michigan",492,430,62,26,52540,12.601626016260163
"Linden city, Michigan",1564,1506,58,26,47820,3.70843989769821
"Montrose city, Michigan",729,626,103,26,55280,14.12894375857339
"Mount Morris city, Michigan",1385,1236,149,26,55960,10.75812274368231
"Millington village, Michigan",470,436,34,26,54220,7.234042553191489
"Vassar city, Michigan",1134,1053,81,26,81840,7.142857142857142
"Hart city, Michigan",916,826,90,26,36920,9.82532751091703
"Muskegon Heights city, Michigan",5141,3981,1160,26,56360,22.56370355961875
"Wolf Lake CDP, Michigan",1743,1522,221,26,88220,12.67928858290304
"Bear Lake village, Michigan",170,71,99,26,06460,58.235294117647065
"Scottville city, Michigan",516,451,65,26,72080,12.5968992248062
"Zeeland city, Michigan",2260,2260,0,26,89260,0.0
"Prudenville CDP, Michigan",1572,886,686,26,66400,43.63867684478372
"Roscommon village, Michigan",536,418,118,26,69540,22.01492537313433
"Millersburg village, Michigan",127,82,45,26,54120,35.43307086614173
"Franklin village, Michigan",1221,1154,67,26,30340,5.487305487305488
"Lake Angelus city, Michigan",130,119,11,26,44440,8.461538461538462
"Leonard village, Michigan",155,149,6,26,46940,3.870967741935484
"Pontiac city, Michigan",27033,23143,3890,26,65440,14.38981984981319
"Rochester Hills city, Michigan",30232,28779,1453,26,69035,4.806165652288966
"Vanderbilt village, Michigan",250,224,26,26,81700,10.4
"Ithaca city, Michigan",1177,1079,98,26,41340,8.326253186066271
"Stanton city, Michigan",531,520,11,26,76220,2.0715630885122414
"Burt CDP, Michigan",382,333,49,26,12000,12.827225130890053
"L'Anse village, Michigan",1027,860,167,26,45540,16.260954235637783
"Benzonia village, Michigan",290,202,88,26,07580,30.344827586206897
"Elberta village, Michigan",225,74,151,26,25180,67.11111111111111
"Lake Ann village, Michigan",203,95,108,26,44460,53.20197044334976
"Thompsonville village, Michigan",286,179,107,26,79600,37.41258741258741
"Wakefield city, Michigan",935,731,204,26,82780,21.818181818181817
"Hemlock CDP, Michigan",601,576,25,26,37600,4.159733777038269
"Adrian city, Michigan",8675,7624,1051,26,00440,12.115273775216139
"Deerfield village, Michigan",375,357,18,26,21180,4.8
"Morenci city, Michigan",1028,949,79,26,55500,7.684824902723736
"Martin village, Michigan",212,197,15,26,51980,7.0754716981132075
"Saugatuck city, Michigan",835,414,421,26,71700,50.41916167664671
"Homer village, Michigan",787,696,91,26,38920,11.56289707750953
"Springfield city, Michigan",2519,2178,341,26,75700,13.537117903930133
"Paw Paw Lake CDP, Michigan",2401,1570,831,26,63020,34.61057892544773
"St. Joseph city, Michigan",4673,4204,469,26,70960,10.036379199657608
"Cassopolis village, Michigan",805,692,113,26,13900,14.037267080745341
"Atlanta CDP, Michigan",453,318,135,26,03920,29.80132450331126
"Canada Creek Ranch CDP, Michigan",641,156,485,26,12980,75.66302652106084
"Hubbardston village, Michigan",135,127,8,26,39660,5.9259259259259265
"Rosebush village, Michigan",177,156,21,26,69640,11.864406779661017
"Barryton village, Michigan",225,174,51,26,05580,22.666666666666664
"Mecosta village, Michigan",190,159,31,26,52760,16.315789473684212
"Stanwood village, Michigan",92,84,8,26,76240,8.695652173913043
"Bellevue village, Michigan",673,551,122,26,07060,18.12778603268945
"Minden City village, Michigan",84,74,10,26,54560,11.904761904761903
"Sandusky city, Michigan",1088,1041,47,26,71540,4.31985294117647
"McBain city, Michigan",282,242,40,26,49980,14.184397163120568
"Fremont city, Michigan",1878,1822,56,26,30700,2.9818956336528224
"Kalkaska village, Michigan",1169,1023,146,26,42260,12.489307100085544
"Casnovia village, Michigan",142,127,15,26,13820,10.56338028169014
"Northview CDP, Michigan",6925,6498,427,26,58945,6.166064981949459
"Menominee city, Michigan",4394,4028,366,26,53020,8.329540282203004
"Lake Odessa village, Michigan",989,888,101,26,44880,10.212335692618806
"Muir village, Michigan",258,240,18,26,56080,6.976744186046512
"Saranac village, Michigan",663,619,44,26,71660,6.636500754147813
"Clare city, Michigan",1582,1319,263,26,15920,16.624525916561314
"Morley village, Michigan",230,193,37,26,55540,16.08695652173913
"Stevensville village, Michigan",621,573,48,26,76500,7.729468599033816
"St. Johns city, Michigan",3429,3078,351,26,70940,10.236220472440944
"Garden village, Michigan",102,73,29,26,31380,28.431372549019606
"Sherwood village, Michigan",170,151,19,26,73420,11.176470588235295
"De Tour Village village, Michigan",305,136,169,26,21780,55.40983606557377
"Alanson village, Michigan",496,326,170,26,00860,34.274193548387096
"Petoskey city, Michigan",3633,2898,735,26,63820,20.23121387283237
"Benton Harbor city, Michigan",4896,4189,707,26,07520,14.440359477124181
"Fair Plain CDP, Michigan",3521,3270,251,26,27160,7.128656631638738
"Lakewood Club village, Michigan",511,448,63,26,45340,12.32876712328767
"Republic CDP, Michigan",301,230,71,26,67980,23.588039867109632
"Wayne city, Michigan",7285,6675,610,26,84940,8.373369938229239
"Birch Run village, Michigan",857,772,85,26,08540,9.918319719953326
"Clinton village, Michigan",1000,950,50,26,16480,5.0
"Village of Clarkston city, Michigan",428,414,14,26,82450,3.2710280373831773
"Chatham village, Michigan",139,97,42,26,14940,30.215827338129497
"Hillsdale city, Michigan",3260,2931,329,26,38460,10.0920245398773
"Lewiston CDP, Michigan",1598,586,1012,26,47260,63.32916145181476
"Hersey village, Michigan",163,119,44,26,37820,26.993865030674847
"White Cloud city, Michigan",479,398,81,26,86680,16.910229645093946
"Union City village, Michigan",771,665,106,26,81360,13.748378728923477
"Lapeer city, Michigan",3840,3597,243,26,46040,6.328125
"Bingham Farms village, Michigan",530,490,40,26,08460,7.547169811320755
"Montgomery village, Michigan",151,127,24,26,55220,15.894039735099339
"Applegate village, Michigan",120,112,8,26,03200,6.666666666666667
"Hubbard Lake CDP, Michigan",1347,434,913,26,39634,67.78025241276912
"Grand Blanc city, Michigan",3684,3516,168,26,33280,4.5602605863192185
"Allen village, Michigan",117,105,12,26,01300,10.256410256410255
"Hubbell CDP, Michigan",443,344,99,26,39680,22.34762979683973
"South Range village, Michigan",429,282,147,26,75220,34.26573426573427
"Estral Beach village, Michigan",180,165,15,26,26460,8.333333333333332
"Monroe city, Michigan",8900,8099,801,26,55020,9.0
"South Monroe CDP, Michigan",3092,2840,252,26,75140,8.15006468305304
"West Monroe CDP, Michigan",1453,1352,101,26,86050,6.951135581555403
"Eagle village, Michigan",54,54,0,26,23560,0.0
"Escanaba city, Michigan",6419,5754,665,26,26360,10.359869138495092
"Gladstone city, Michigan",2234,1995,239,26,32300,10.698299015219337
"Baldwin village, Michigan",568,453,115,26,04940,20.246478873239436
"Addison village, Michigan",286,283,3,26,00380,1.048951048951049
"Vermontville village, Michigan",305,268,37,26,81960,12.131147540983607
"Flat Rock city, Michigan",3886,3623,263,26,28360,6.767884714359239
"Hillman village, Michigan",342,291,51,26,38380,14.912280701754385
"Davison city, Michigan",2484,2377,107,26,19880,4.30756843800322
"Bloomingdale village, Michigan",267,238,29,26,09220,10.861423220973784
"Harrisville city, Michigan",318,202,116,26,36860,36.477987421383645
"Fowlerville village, Michigan",1400,1278,122,26,30060,8.714285714285715
"New Lothrop village, Michigan",284,278,6,26,57520,2.112676056338028
"Fife Lake village, Michigan",275,170,105,26,28000,38.18181818181819
"Decatur village, Michigan",831,771,60,26,21040,7.2202166064981945
"Lawton village, Michigan",738,675,63,26,46500,8.536585365853659
"Alma city, Michigan",3801,3579,222,26,01540,5.840568271507498
"Bad Axe city, Michigan",1431,1265,166,26,04740,11.600279524807828
"Ubly village, Michigan",409,367,42,26,81200,10.268948655256724
"Buena Vista CDP, Michigan",3349,2928,421,26,11555,12.570916691549716
"Freeland CDP, Michigan",2305,2250,55,26,30540,2.386117136659436
"Saginaw city, Michigan",23961,19682,4279,26,70520,17.858186219272984
"St. Charles village, Michigan",971,905,66,26,70640,6.797116374871266
"Hudson city, Michigan",970,866,104,26,39720,10.721649484536082
"Barnes Lake-Millers Lake CDP, Michigan",749,504,245,26,05470,32.71028037383177
"Manitou Beach-Devils Lake CDP, Michigan",1691,886,805,26,50830,47.604967474866946
"Baroda village, Michigan",410,393,17,26,05500,4.146341463414634
"Bridgman city, Michigan",1290,1051,239,26,10580,18.527131782945734
"Brownlee Park CDP, Michigan",779,661,118,26,11200,15.14762516046213
"Burlington village, Michigan",120,102,18,26,11800,15.0
"Westphalia village, Michigan",369,361,8,26,86120,2.168021680216802
"Kingsford city, Michigan",2515,2307,208,26,43300,8.270377733598409
"Imlay City city, Michigan",1415,1345,70,26,40320,4.946996466431095
"North Branch village, Michigan",487,418,69,26,58080,14.168377823408623
"Grayling city, Michigan",885,779,106,26,34640,11.977401129943503
"Jackson city, Michigan",15352,13123,2229,26,41420,14.519280875455967
"Tawas City city, Michigan",950,690,260,26,78140,27.368421052631582
"Mesick village, Michigan",187,151,36,26,53320,19.25133689839572
"East Tawas city, Michigan",1791,1412,379,26,24420,21.16136236739252
"Oscoda CDP, Michigan",528,399,129,26,61320,24.431818181818183
"Empire village, Michigan",326,141,185,26,25980,56.74846625766872
"Greilickville CDP, Michigan",803,788,15,26,35300,1.86799501867995
"Suttons Bay village, Michigan",435,220,215,26,77600,49.42528735632184
"Lyons village, Michigan",360,344,16,26,49900,4.444444444444445
"Charlotte city, Michigan",3993,3675,318,26,14820,7.963936889556725
"Dimondale village, Michigan",513,487,26,26,22380,5.0682261208577
"Big Bay CDP, Michigan",339,118,221,26,08180,65.19174041297934
"Buchanan city, Michigan",2120,1823,297,26,11400,14.00943396226415
"Coloma city, Michigan",672,640,32,26,17320,4.761904761904762
"Whitmore Lake CDP, Michigan",3016,2704,312,26,87060,10.344827586206897
"Coldwater city, Michigan",4608,4234,374,26,17020,8.116319444444445
"Bellaire village, Michigan",527,430,97,26,06980,18.40607210626186
"Concord village, Michigan",487,453,34,26,17740,6.981519507186857
"Deckerville village, Michigan",388,318,70,26,21100,18.04123711340206
"Peck village, Michigan",260,236,24,26,63260,9.230769230769232
"Allen Park city, Michigan",11414,10819,595,26,01380,5.21289644296478
"Livonia city, Michigan",38619,37107,1512,26,49000,3.915171288743882
"Melvindale city, Michigan",4045,3734,311,26,52940,7.688504326328801
"Auburn Hills city, Michigan",10055,9295,760,26,04105,7.558428642466435
"Oakley village, Michigan",146,119,27,26,59860,18.493150684931507
"Tecumseh city, Michigan",3807,3630,177,26,79120,4.649330181245075
"Hastings city, Michigan",3275,3051,224,26,37120,6.83969465648855
"Woodland village, Michigan",215,193,22,26,88420,10.232558139534884
"North Adams village, Michigan",238,206,32,26,57920,13.445378151260504
"Calumet village, Michigan",492,353,139,26,12580,28.252032520325205
"Battle Creek city, Michigan",23819,20697,3122,26,05920,13.107183341030272
"Shields CDP, Michigan",2797,2629,168,26,73560,6.006435466571326
"Luther village, Michigan",164,97,67,26,49740,40.853658536585364
"Athens village, Michigan",412,361,51,26,03880,12.37864077669903
"Gilman city, Minnesota",117,117,0,27,23804,0.0
"Eau Claire village, Michigan",270,217,53,26,24580,19.62962962962963
"Kingston city, Minnesota",68,62,6,27,33344,8.823529411764707
"Watkins city, Minnesota",433,407,26,27,68620,6.0046189376443415
"Frazee city, Minnesota",646,555,91,27,22472,14.086687306501547
"Inver Grove Heights city, Minnesota",14684,14081,603,27,31076,4.106510487605557
"South Haven city, Minnesota",73,73,0,27,61402,0.0
"Sherburn city, Minnesota",554,462,92,27,59620,16.60649819494585
"Buffalo city, Minnesota",6266,5840,426,27,08452,6.798595595276093
"Howard Lake city, Minnesota",911,834,77,27,30284,8.45225027442371
"Aurora city, Minnesota",869,736,133,27,02872,15.304948216340621
"Biwabik city, Minnesota",517,376,141,27,06148,27.27272727272727
"Floodwood city, Minnesota",306,257,49,27,21338,16.013071895424837
"Fifty Lakes city, Minnesota",641,157,484,27,21032,75.50702028081123
"Milroy city, Minnesota",136,110,26,27,42362,19.11764705882353
"Redwood Falls city, Minnesota",2362,2044,318,27,53656,13.463166807790008
"Stillwater city, Minnesota",7766,7370,396,27,62824,5.099150141643059
"Jeffers city, Minnesota",192,169,23,27,31796,11.979166666666668
"Atwater city, Minnesota",441,405,36,27,02692,8.16326530612245
"Mora city, Minnesota",1554,1460,94,27,44044,6.048906048906049
"Madison Lake city, Minnesota",443,418,25,27,39320,5.643340857787811
"Sunburg city, Minnesota",39,39,0,27,63454,0.0
"Lowry city, Minnesota",170,166,4,27,38366,2.3529411764705883
"Sedan city, Minnesota",37,28,9,27,59188,24.324324324324326
"Starbuck city, Minnesota",671,570,101,27,62500,15.052160953800298
"Villard city, Minnesota",137,125,12,27,67144,8.75912408759124
"Buffalo Lake city, Minnesota",314,252,62,27,08488,19.745222929936308
"Fairfax city, Minnesota",555,469,86,27,20222,15.495495495495495
"Franklin city, Minnesota",223,209,14,27,22364,6.278026905829597
"Hector city, Minnesota",602,463,139,27,28124,23.089700996677742
"Olivia city, Minnesota",1161,1038,123,27,48256,10.594315245478036
"Champlin city, Minnesota",9066,8976,90,27,10846,0.9927200529450696
"Dayton city, Minnesota",1972,1920,52,27,15022,2.636916835699797
"Golden Valley city, Minnesota",9540,9277,263,27,24308,2.7568134171907754
"Hopkins city, Minnesota",8773,8419,354,27,30140,4.035107716858543
"Loretto city, Minnesota",290,278,12,27,38222,4.137931034482759
"Maple Grove city, Minnesota",27846,27115,731,27,40166,2.625152625152625
"Minnetonka city, Minnesota",24135,23112,1023,27,43252,4.238657551274083
"Mound city, Minnesota",4635,4269,366,27,44476,7.8964401294498385
"New Hope city, Minnesota",8450,8238,212,27,45628,2.5088757396449703
"Osseo city, Minnesota",1376,1261,115,27,49012,8.357558139534884
"Robbinsdale city, Minnesota",6588,6361,227,27,54808,3.445658773527626
"Wilton city, Minnesota",84,69,15,27,70708,17.857142857142858
"Carlos city, Minnesota",222,201,21,27,09964,9.45945945945946
"Millerville city, Minnesota",50,48,2,27,42254,4.0
"Nelson city, Minnesota",106,92,14,27,45106,13.20754716981132
"Preston city, Minnesota",729,636,93,27,52450,12.757201646090536
"Rushford Village city, Minnesota",389,328,61,27,56302,15.681233933161954
"Albert Lea city, Minnesota",8591,7772,819,27,00694,9.53323245256664
"Clarks Grove city, Minnesota",333,290,43,27,11674,12.912912912912914
"Freeborn city, Minnesota",122,106,16,27,22526,13.114754098360656
"Geneva city, Minnesota",166,153,13,27,23354,7.83132530120482
"Sanborn city, Minnesota",208,179,29,27,58306,13.942307692307693
"Wabasso city, Minnesota",323,303,20,27,67396,6.191950464396285
"Becker city, Minnesota",1858,1742,116,27,04618,6.243272335844995
"Zimmerman city, Minnesota",1958,1958,0,27,72238,0.0
"Eyota city, Minnesota",809,758,51,27,20114,6.30407911001236
"Elba city, Minnesota",44,37,7,27,18386,15.909090909090908
"Kent city, Minnesota",31,31,0,27,32786,0.0
"Nashua city, Minnesota",17,5,12,27,44944,70.58823529411765
"Rothsay city, Minnesota",284,233,51,27,56014,17.95774647887324
"Rollingstone city, Minnesota",275,266,9,27,55276,3.272727272727273
"Hawley city, Minnesota",879,796,83,27,27746,9.442548350398178
"Ulen city, Minnesota",251,216,35,27,66136,13.94422310756972
"Breezy Point city, Minnesota",1681,925,756,27,07516,44.97323022010708
"Adams city, Minnesota",359,324,35,27,00190,9.749303621169917
"Sargeant city, Minnesota",25,22,3,27,58576,12.0
"Le Sueur city, Minnesota",1717,1606,111,27,36746,6.46476412347117
"South St. Paul city, Minnesota",8397,8079,318,27,61492,3.7870668095748483
"Twin Valley city, Minnesota",410,304,106,27,65938,25.853658536585368
"Ruthton city, Minnesota",132,110,22,27,56482,16.666666666666664
"Askov city, Minnesota",203,163,40,27,02548,19.704433497536947
"Sandstone city, Minnesota",594,530,64,27,58396,10.774410774410773
"Willow River city, Minnesota",225,191,34,27,70492,15.11111111111111
"Lengby city, Minnesota",51,29,22,27,36404,43.13725490196079
"Hallock city, Minnesota",585,471,114,27,26576,19.48717948717949
"Willmar city, Minnesota",8008,7463,545,27,70420,6.805694305694305
"Kilkenny city, Minnesota",76,76,0,27,33110,0.0
"Le Center city, Minnesota",1075,1001,74,27,36134,6.883720930232558
"Kennedy city, Minnesota",140,125,15,27,32732,10.714285714285714
"Louisburg city, Minnesota",33,21,12,27,38258,36.36363636363637
"Marietta city, Minnesota",126,97,29,27,40526,23.015873015873016
"Adrian city, Minnesota",541,484,57,27,00262,10.536044362292053
"Ellsworth city, Minnesota",237,214,23,27,18836,9.70464135021097
"Greenwood city, Minnesota",339,311,28,27,25918,8.259587020648967
"Long Lake city, Minnesota",779,762,17,27,38006,2.1822849807445444
"St. Bonifacius city, Minnesota",971,917,54,27,56770,5.561277033985582
"Wayzata city, Minnesota",2522,2225,297,27,68818,11.776367961934971
"Fort Ripley city, Minnesota",38,19,19,27,21932,50.0
"Garrison city, Minnesota",182,103,79,27,23192,43.40659340659341
"Pequot Lakes city, Minnesota",1557,946,611,27,50416,39.24213230571612
"Grand Meadow city, Minnesota",485,432,53,27,25010,10.927835051546392
"Oklee city, Minnesota",234,189,45,27,48202,19.230769230769234
"Westbrook city, Minnesota",440,360,80,27,69250,18.181818181818183
"Backus city, Minnesota",215,149,66,27,03124,30.697674418604652
"Nisswa city, Minnesota",1545,802,743,27,46348,48.090614886731395
"St. Augusta city, Minnesota",1365,1326,39,27,56724,2.857142857142857
"Nowthen city, Minnesota",1489,1445,44,27,47536,2.955003357958361
"Columbus city, Minnesota",1524,1496,28,27,12718,1.837270341207349
"Elko New Market city, Minnesota",1411,1365,46,27,18662,3.260099220411056
"Scandia city, Minnesota",1713,1487,226,27,58900,13.193228254524225
"Angle Inlet CDP, Minnesota",139,0,139,27,01558,100.0
"Baker CDP, Minnesota",18,18,0,27,03214,0.0
"Ball Club CDP, Minnesota",92,67,25,27,03376,27.173913043478258
"Beaulieu CDP, Minnesota",19,13,6,27,04348,31.57894736842105
"Big Lake CDP, Minnesota",303,178,125,27,05744,41.254125412541256
"Ebro CDP, Minnesota",29,25,4,27,17882,13.793103448275861
"Esko CDP, Minnesota",799,712,87,27,19718,10.888610763454318
"Fairhaven CDP, Minnesota",201,152,49,27,20276,24.378109452736318
"Finland CDP, Minnesota",160,117,43,27,21104,26.875
"Fish Lake CDP, Minnesota",95,46,49,27,21190,51.578947368421055
"Frontenac CDP, Minnesota",109,109,0,27,22904,0.0
"Garden City CDP, Minnesota",130,103,27,27,23084,20.76923076923077
"Homer CDP, Minnesota",102,94,8,27,30014,7.8431372549019605
"Lutsen CDP, Minnesota",349,161,188,27,38546,53.86819484240688
"Inger CDP, Minnesota",81,76,5,27,30950,6.172839506172839
"Lake George CDP, Minnesota",206,106,100,27,34370,48.54368932038835
"Lansing CDP, Minnesota",89,69,20,27,35558,22.47191011235955
"Mahnomen CDP, Minnesota",83,83,0,27,39394,0.0
"Mahtowa CDP, Minnesota",155,144,11,27,39446,7.096774193548387
"Martin Lake CDP, Minnesota",469,362,107,27,40814,22.81449893390192
"Merrifield CDP, Minnesota",55,40,15,27,41804,27.27272727272727
"Midway CDP, Minnesota",5,4,1,27,42010,20.0
"Nett Lake CDP, Minnesota",119,106,13,27,45268,10.92436974789916
"Osage CDP, Minnesota",247,127,120,27,48760,48.582995951417004
"Pine Bend CDP, Minnesota",15,15,0,27,51028,0.0
"Riverland CDP, Minnesota",92,80,12,27,54596,13.043478260869565
"Ronneby CDP, Minnesota",19,13,6,27,55366,31.57894736842105
"Roy Lake CDP, Minnesota",42,9,33,27,56212,78.57142857142857
"Searles CDP, Minnesota",121,121,0,27,59116,0.0
"Silver Creek CDP, Minnesota",100,100,0,27,60322,0.0
"Soudan CDP, Minnesota",211,185,26,27,61204,12.322274881516588
"Stanchfield CDP, Minnesota",48,31,17,27,62356,35.41666666666667
"The Ranch CDP, Minnesota",3,2,1,27,64547,33.33333333333333
"Twin Lakes CDP, Minnesota",206,74,132,27,65927,64.07766990291263
"Warsaw CDP, Minnesota",332,263,69,27,68260,20.783132530120483
"West Roy Lake CDP, Minnesota",21,17,4,27,69690,19.047619047619047
"Whipholt CDP, Minnesota",113,47,66,27,69880,58.4070796460177
"Rice Lake city, Minnesota",1773,1749,24,27,54060,1.353637901861252
"South End CDP, Minnesota",12,10,2,27,61340,16.666666666666664
"North St. Paul city, Minnesota",5050,4913,137,27,47221,2.712871287128713
"Vadnais Heights city, Minnesota",5668,5382,286,27,66460,5.045871559633028
"Menahga city, Minnesota",665,511,154,27,41660,23.157894736842106
"Coleraine city, Minnesota",808,715,93,27,12502,11.50990099009901
"Grand Rapids city, Minnesota",5066,4847,219,27,25118,4.322937228582708
"La Prairie city, Minnesota",364,350,14,27,35648,3.8461538461538463
"Marble city, Minnesota",283,248,35,27,40418,12.36749116607774
"Eagle Bend city, Minnesota",296,260,36,27,17342,12.162162162162163
"Trommald city, Minnesota",59,37,22,27,65506,37.28813559322034
"Lauderdale city, Minnesota",1333,1270,63,27,35738,4.726181545386346
"Maplewood city, Minnesota",15516,15026,490,27,40382,3.1580304202113947
"New Brighton city, Minnesota",9345,9105,240,27,45430,2.568218298555377
"Sebeka city, Minnesota",367,323,44,27,59152,11.989100817438691
"Keewatin city, Minnesota",564,478,86,27,32570,15.24822695035461
"Bertha city, Minnesota",273,250,23,27,05482,8.424908424908425
"Clarissa city, Minnesota",314,288,26,27,11602,8.280254777070063
"Elrosa city, Minnesota",94,89,5,27,19088,5.319148936170213
"St. Joseph city, Minnesota",1948,1865,83,27,57130,4.260780287474333
"St. Stephen city, Minnesota",329,322,7,27,58090,2.127659574468085
"Bellechester city, Minnesota",90,86,4,27,04798,4.444444444444445
"Darfur city, Minnesota",53,36,17,27,14770,32.075471698113205
"Morristown city, Minnesota",433,417,16,27,44296,3.695150115473441
"Northfield city, Minnesota",6887,6340,547,27,46924,7.942500363002759
"Danube city, Minnesota",225,194,31,27,14716,13.777777777777779
"Morton city, Minnesota",209,180,29,27,44368,13.875598086124402
"St. Paul city, Minnesota",119940,112999,6941,27,58000,5.78706019676505
"Burtrum city, Minnesota",54,46,8,27,08902,14.814814814814813
"Grey Eagle city, Minnesota",195,165,30,27,26000,15.384615384615385
"Brooten city, Minnesota",318,267,51,27,08092,16.037735849056602
"Melrose city, Minnesota",1543,1393,150,27,41570,9.721322099805574
"Sartell city, Minnesota",6788,6541,247,27,58612,3.6387743076016497
"Faribault city, Minnesota",9066,8664,402,27,20546,4.434149569821311
"Sauk Centre city, Minnesota",1853,1776,77,27,58648,4.155423637344846
"Wahkon city, Minnesota",204,110,94,27,67558,46.07843137254902
"Cyrus city, Minnesota",174,169,5,27,14446,2.8735632183908044
"Nerstrand city, Minnesota",129,126,3,27,45196,2.3255813953488373
"Bird Island city, Minnesota",529,417,112,27,06076,21.17202268431002
"Currie city, Minnesota",120,116,4,27,14320,3.3333333333333335
"Slayton city, Minnesota",1063,956,107,27,60808,10.06585136406397
"Hardwick city, Minnesota",126,109,17,27,27116,13.492063492063492
"Jasper city, Minnesota",322,300,22,27,31760,6.832298136645963
"Squaw Lake city, Minnesota",64,34,30,27,62284,46.875
"Echo city, Minnesota",147,129,18,27,17900,12.244897959183673
"Bigfork city, Minnesota",242,200,42,27,05698,17.355371900826448
"Effie city, Minnesota",55,37,18,27,18260,32.72727272727273
"Lake Henry city, Minnesota",35,31,4,27,34478,11.428571428571429
"St. Martin city, Minnesota",127,127,0,27,57238,0.0
"Lake Benton city, Minnesota",384,336,48,27,34100,12.5
"Urbank city, Minnesota",38,30,8,27,66388,21.052631578947366
"Cobden city, Minnesota",13,9,4,27,12394,30.76923076923077
"Browns Valley city, Minnesota",300,252,48,27,08200,16.0
"Big Falls city, Minnesota",206,136,70,27,05680,33.980582524271846
"Mizpah city, Minnesota",37,29,8,27,43540,21.62162162162162
"Baudette city, Minnesota",625,478,147,27,04024,23.52
"Tintah city, Minnesota",26,17,9,27,64948,34.61538461538461
"Canton city, Minnesota",173,157,16,27,09802,9.248554913294797
"Dover city, Minnesota",330,302,28,27,16264,8.484848484848486
"Alden city, Minnesota",314,274,40,27,00838,12.738853503184714
"Conger city, Minnesota",59,54,5,27,12952,8.47457627118644
"Myrtle city, Minnesota",37,29,8,27,44890,21.62162162162162
"Princeton city, Minnesota",1998,1904,94,27,52522,4.704704704704705
"Harris city, Minnesota",435,397,38,27,27278,8.735632183908045
"Lindstrom city, Minnesota",1930,1796,134,27,37304,6.94300518134715
"Chatfield city, Minnesota",1270,1196,74,27,11008,5.826771653543307
"Blooming Prairie city, Minnesota",804,739,65,27,06580,8.084577114427862
"Medford city, Minnesota",459,444,15,27,41426,3.2679738562091507
"Foxhome city, Minnesota",57,44,13,27,22202,22.807017543859647
"Lewiston city, Minnesota",616,589,27,27,36800,4.383116883116883
"Pine Springs city, Minnesota",185,185,0,27,51316,0.0
"St. Marys Point city, Minnesota",171,143,28,27,57292,16.374269005847953
"White Bear Lake city, Minnesota",11005,10638,367,27,69970,3.3348477964561565
"Greenbush city, Minnesota",351,304,47,27,25604,13.390313390313391
"Emmons city, Minnesota",182,176,6,27,19340,3.296703296703297
"Hayward city, Minnesota",128,127,1,27,27944,0.78125
"Clements city, Minnesota",75,50,25,27,11836,33.33333333333333
"Landfall city, Minnesota",300,292,8,27,35414,2.666666666666667
"Utica city, Minnesota",117,103,14,27,66424,11.965811965811966
"Dellwood city, Minnesota",461,409,52,27,15616,11.279826464208242
"Hastings city, Minnesota",9400,8978,422,27,27530,4.48936170212766
"Mahtomedi city, Minnesota",3205,3133,72,27,39428,2.2464898595943836
"Hewitt city, Minnesota",107,85,22,27,28754,20.5607476635514
"Avon city, Minnesota",644,613,31,27,03070,4.813664596273292
"Little Canada city, Minnesota",4966,4789,177,27,37502,3.564236810310109
"Aldrich city, Minnesota",46,32,14,27,00892,30.434782608695656
"Wadena city, Minnesota",2012,1869,143,27,67504,7.107355864811134
"West Union city, Minnesota",36,36,0,27,69736,0.0
"Meire Grove city, Minnesota",76,70,6,27,41534,7.894736842105263
"Richfield city, Minnesota",15598,15056,542,27,54214,3.474804462110527
"Independence city, Minnesota",1307,1192,115,27,30842,8.798775822494262
"Pine River city, Minnesota",497,426,71,27,51280,14.285714285714285
"Mountain Lake city, Minnesota",969,936,33,27,44566,3.4055727554179565
"Boy River city, Minnesota",37,17,20,27,07174,54.054054054054056
"Minneapolis city, Minnesota",185260,173916,11344,27,43000,6.123286192378279
"Shorewood city, Minnesota",2915,2784,131,27,60016,4.493996569468268
"Spring Park city, Minnesota",1121,1011,110,27,62014,9.812667261373774
"Hendricks city, Minnesota",415,364,51,27,28430,12.289156626506024
"Bluffton city, Minnesota",87,77,10,27,06778,11.494252873563218
"Clitherall city, Minnesota",61,42,19,27,12088,31.147540983606557
"Deer Creek city, Minnesota",138,110,28,27,15184,20.28985507246377
"Florence city, Minnesota",13,11,2,27,21410,15.384615384615385
"Lester Prairie city, Minnesota",730,692,38,27,36728,5.205479452054795
"Winsted city, Minnesota",975,912,63,27,71086,6.461538461538462
"Mapleton city, Minnesota",747,663,84,27,40310,11.244979919678714
"Tracy city, Minnesota",1048,888,160,27,65308,15.267175572519085
"Hancock city, Minnesota",320,282,38,27,26936,11.875
"Halma city, Minnesota",32,25,7,27,26612,21.875
"Lancaster city, Minnesota",205,160,45,27,35378,21.951219512195124
"Boyd city, Minnesota",102,63,39,27,07138,38.23529411764706
"Elmdale city, Minnesota",45,39,6,27,18872,13.333333333333334
"Lastrup city, Minnesota",67,63,4,27,35720,5.970149253731343
"Swanville city, Minnesota",145,120,25,27,63778,17.24137931034483
"Leota CDP, Minnesota",90,90,0,27,36548,0.0
"New London city, Minnesota",561,512,49,27,45682,8.73440285204991
"Taopi city, Minnesota",25,20,5,27,64210,20.0
"Minneota city, Minnesota",616,545,71,27,43126,11.525974025974026
"Russell city, Minnesota",165,143,22,27,56428,13.333333333333334
"Donnelly city, Minnesota",124,115,9,27,16084,7.258064516129033
"Appleton city, Minnesota",861,715,146,27,01864,16.957026713124275
"Danvers city, Minnesota",61,56,5,27,14734,8.19672131147541
"De Graff city, Minnesota",83,61,22,27,15418,26.506024096385545
"Hanscom AFB CDP, Massachusetts",571,549,22,25,28425,3.852889667250438
"North Plymouth CDP, Massachusetts",1706,1539,167,25,48780,9.788980070339976
"Sandwich CDP, Massachusetts",1883,1308,575,25,59700,30.53637812002124
"East Pepperell CDP, Massachusetts",794,739,55,25,20310,6.926952141057935
"Medford city, Massachusetts",24074,23016,1058,25,39835,4.394782753177702
"Falmouth CDP, Massachusetts",3064,2012,1052,25,23070,34.33420365535248
"West Dennis CDP, Massachusetts",3026,1139,1887,25,75820,62.35955056179775
"Yarmouth Port CDP, Massachusetts",3220,2525,695,25,82595,21.583850931677016
"Boston city, Massachusetts",289763,266724,23039,25,07000,7.950980628996801
"Hopkinton CDP, Massachusetts",1131,1086,45,25,31050,3.978779840848806
"Shirley CDP, Massachusetts",834,805,29,25,61555,3.477218225419664
"Somerville city, Massachusetts",34472,32851,1621,25,62535,4.702367138547227
"Waltham city, Massachusetts",25299,23631,1668,25,72600,6.593145974149175
"Woburn city, Massachusetts",16870,15741,1129,25,81035,6.6923532898636635
"Holyoke city, Massachusetts",16855,15275,1580,25,30840,9.374072975378226
"Townsend CDP, Massachusetts",591,568,23,25,70325,3.8917089678511
"Hudson CDP, Massachusetts",6382,6095,287,25,31575,4.497022876841116
"Littleton Common CDP, Massachusetts",1328,1296,32,25,36020,2.4096385542168677
"Reading CDP, Massachusetts",9328,9114,214,25,56165,2.2941680960548885
"East Brookfield CDP, Massachusetts",554,454,100,25,18595,18.050541516245488
"Fiskdale CDP, Massachusetts",1213,1213,0,25,23840,0.0
"Oxford CDP, Massachusetts",2439,2301,138,25,51790,5.658056580565805
"Mashpee Neck CDP, Massachusetts",574,377,197,25,39152,34.3205574912892
"North Falmouth CDP, Massachusetts",2429,1196,1233,25,47730,50.7616303005352
"Galesburg city, Michigan",894,842,52,26,31260,5.8165548098434
"Woods Hole CDP, Massachusetts",1059,436,623,25,81245,58.829084041548626
"Millers Falls CDP, Massachusetts",515,466,49,25,41410,9.514563106796116
"Southgate city, Michigan",13691,12692,999,26,74960,7.296764297713827
"Haslett CDP, Michigan",9382,8900,482,26,37100,5.1374973353229585
"Keego Harbor city, Michigan",1770,1641,129,26,42460,7.288135593220339
"Royal Oak city, Michigan",30473,28467,2006,26,70040,6.582876644898763
"Copper City village, Michigan",131,92,39,26,18080,29.770992366412212
"Holt CDP, Michigan",10670,10230,440,26,38780,4.123711340206185
"Stockbridge village, Michigan",608,581,27,26,76560,4.440789473684211
"Kaleva village, Michigan",251,184,67,26,42240,26.693227091633464
"Manistee city, Michigan",3660,2684,976,26,50720,26.666666666666668
"Onekama village, Michigan",339,161,178,26,60740,52.50737463126843
"Ahmeek village, Michigan",115,53,62,26,00620,53.91304347826087
"Newberry village, Michigan",749,588,161,26,57140,21.49532710280374
"Rochester city, Michigan",5997,5471,526,26,69020,8.77105219276305
"Troy city, Michigan",32938,31368,1570,26,80700,4.766531058352055
"Clio city, Michigan",1507,1348,159,26,16620,10.550763105507631
"Holly village, Michigan",2933,2651,282,26,38700,9.61472894647119
"Lathrup Village city, Michigan",1684,1586,98,26,46320,5.819477434679335
"Oak Park city, Michigan",12996,12088,908,26,59920,6.986765158510311
"Orchard Lake Village city, Michigan",897,859,38,26,61020,4.23634336677815
"Ortonville village, Michigan",595,562,33,26,61220,5.546218487394958
"Argentine CDP, Michigan",1154,929,225,26,03400,19.49740034662045
"Gaines village, Michigan",179,160,19,26,31200,10.614525139664805
"Swartz Creek city, Michigan",2698,2451,247,26,77700,9.15492957746479
"Cass City village, Michigan",1134,982,152,26,13880,13.403880070546737
"Gagetown village, Michigan",186,148,38,26,31180,20.43010752688172
"Rothbury village, Michigan",149,125,24,26,69880,16.10738255033557
"Eastwood CDP, Michigan",2653,2270,383,26,24500,14.43648699585375
"Alpha village, Michigan",114,73,41,26,01800,35.96491228070175
"Iron River city, Michigan",1716,1443,273,26,40980,15.909090909090908
"Comstock Northwest CDP, Michigan",2874,2718,156,26,17690,5.427974947807933
"Portage city, Michigan",20848,19649,1199,26,65560,5.751151189562548
"Richland village, Michigan",344,321,23,26,68240,6.686046511627906
"South Gull Lake CDP, Michigan",704,547,157,26,74975,22.301136363636363
"Grandville city, Michigan",6382,6287,95,26,34160,1.4885615794421811
"Sand Lake village, Michigan",224,205,19,26,71360,8.482142857142858
"Wyoming city, Michigan",29114,27731,1383,26,88940,4.750291955760115
"Marine City city, Michigan",2038,1832,206,26,51600,10.107948969578018
"Marysville city, Michigan",4494,4205,289,26,52080,6.430796617712506
"Memphis city, Michigan",543,502,41,26,52960,7.550644567219153
"Au Sable CDP, Michigan",647,575,72,26,04280,11.128284389489954
"Northport village, Michigan",421,255,166,26,58740,39.42992874109264
"Bloomfield Hills city, Michigan",1561,1313,248,26,09180,15.887251761691223
"Sylvan Lake city, Michigan",894,838,56,26,77860,6.263982102908278
"Otisville village, Michigan",437,413,24,26,61600,5.491990846681922
"Munising city, Michigan",1297,815,482,26,56200,37.162683114880494
"Gwinn CDP, Michigan",933,843,90,26,35760,9.646302250803858
"Wixom city, Michigan",6628,6229,399,26,88140,6.019915509957755
"Parma village, Michigan",244,205,39,26,62740,15.983606557377051
"New Buffalo city, Michigan",1679,807,872,26,57220,51.93567599761762
"Michigamme CDP, Michigan",268,120,148,26,53520,55.223880597014926
"Rogers City city, Michigan",1546,1188,358,26,69260,23.15653298835705
"Reese village, Michigan",667,626,41,26,67900,6.146926536731634
"Dansville village, Michigan",236,224,12,26,19780,5.084745762711865
"Muskegon city, Michigan",16096,13941,2155,26,56320,13.38841948310139
"Almont village, Michigan",1151,1054,97,26,01660,8.42745438748914
"Blissfield village, Michigan",1446,1409,37,26,09000,2.5587828492392806
"East Lansing city, Michigan",15139,13461,1678,26,24120,11.083955347116719
"Jenison CDP, Michigan",6864,6760,104,26,41680,1.5151515151515151
"Webberville village, Michigan",536,478,58,26,85080,10.820895522388058
"Romulus city, Michigan",9290,8533,757,26,69420,8.14854682454252
"Ludington city, Michigan",4379,3579,800,26,49640,18.269011189769355
"Warren city, Michigan",58561,53674,4887,26,84000,8.345144379365106
"Beal City CDP, Michigan",174,155,19,26,06360,10.919540229885058
"Mancelona village, Michigan",637,544,93,26,50620,14.599686028257459
"Barton Hills village, Michigan",137,125,12,26,05660,8.75912408759124
"Saline city, Michigan",4044,3775,269,26,71140,6.651829871414441
"Quincy village, Michigan",627,578,49,26,66640,7.814992025518341
"Cement City village, Michigan",215,206,9,26,14260,4.186046511627907
"Harrison city, Michigan",1361,881,480,26,36800,35.268185157972084
"Harbor Springs city, Michigan",1104,552,552,26,36560,50.0
"Mackinaw City village, Michigan",747,406,341,26,50320,45.64926372155288
"Michigan Center CDP, Michigan",2392,2083,309,26,53580,12.918060200668895
"Napoleon CDP, Michigan",470,417,53,26,56620,11.27659574468085
"Port Sanilac village, Michigan",458,292,166,26,65900,36.24454148471616
"Honor village, Michigan",166,102,64,26,39080,38.55421686746988
"Bessemer city, Michigan",1070,834,236,26,07960,22.05607476635514
"Midland city, Michigan",18688,17552,1136,26,53780,6.078767123287672
"Sanford village, Michigan",435,391,44,26,71560,10.114942528735632
"Carson City city, Michigan",492,429,63,26,13600,12.804878048780488
"Edmore village, Michigan",503,488,15,26,25000,2.982107355864811
"Pierson village, Michigan",79,65,14,26,64020,17.72151898734177
"Sheridan village, Michigan",280,254,26,26,73100,9.285714285714286
"Frankenmuth city, Michigan",2483,2356,127,26,30200,5.114780507450665
"Merrill village, Michigan",304,295,9,26,53180,2.9605263157894735
"Dearborn city, Michigan",34161,30897,3264,26,21000,9.554755422850619
"Detroit city, Michigan",364089,260383,103706,26,22000,28.4836949207474
"Grosse Pointe Woods city, Michigan",6367,6032,335,26,35580,5.2615046332652735
"Inkster city, Michigan",10808,9130,1678,26,40680,15.525536639526278
"Gobles city, Michigan",338,308,30,26,32640,8.875739644970414
"East Jordan city, Michigan",1217,1029,188,26,24020,15.447822514379622
"Cheboygan city, Michigan",2554,2051,503,26,15000,19.694596711041505
"Laingsburg city, Michigan",574,503,71,26,44200,12.369337979094077
"Lawrence village, Michigan",414,369,45,26,46440,10.869565217391305
"Mattawan village, Michigan",1041,928,113,26,52380,10.854947166186358
"Paw Paw village, Michigan",1626,1324,302,26,62980,18.57318573185732
"Belleville city, Michigan",1914,1769,145,26,07020,7.575757575757576
"Dearborn Heights city, Michigan",21749,20428,1321,26,21020,6.073842475516115
"Gibraltar city, Michigan",2032,1769,263,26,32020,12.94291338582677
"Grosse Pointe Farms city, Michigan",3503,3323,180,26,35520,5.138452754781616
"Highland Park city, Michigan",7063,4619,2444,26,38180,34.60285997451508
"Northville city, Michigan",2625,2555,70,26,58980,2.666666666666667
"Bangor city, Michigan",821,658,163,26,05140,19.853836784409257
"Ann Arbor city, Michigan",50688,47791,2897,26,03000,5.715356691919192
"Beechwood CDP, Michigan",1243,1182,61,26,06880,4.907481898632341
"Plymouth city, Michigan",4510,4270,240,26,65060,5.321507760532151
"Berkley city, Michigan",6990,6643,347,26,07660,4.964234620886981
"Allendale CDP, Michigan",5808,5480,328,26,01340,5.647382920110193
"River Rouge city, Michigan",3889,2870,1019,26,68760,26.202108511185397
"Trenton city, Michigan",8127,7860,267,26,80420,3.2853451458102625
"Kentwood city, Michigan",21169,20343,826,26,42820,3.9019320704804197
"Armada village, Michigan",719,699,20,26,03520,2.781641168289291
"Vicksburg village, Michigan",1324,1254,70,26,82300,5.287009063444108
"Grand Rapids city, Michigan",80226,74202,6024,26,34000,7.508787674818637
"Eastpointe city, Michigan",13619,12483,1136,26,24290,8.341287906601073
"New Baltimore city, Michigan",4947,4705,242,26,57100,4.891853648675966
"New Haven village, Michigan",1633,1547,86,26,57380,5.2663808940600125
"St. Clair Shores city, Michigan",28232,26639,1593,26,70760,5.642533295551147
"Sterling Heights city, Michigan",51742,50023,1719,26,76460,3.3222527153956167
"Onaway city, Michigan",460,360,100,26,60680,21.73913043478261
"Berrien Springs village, Michigan",724,644,80,26,07860,11.049723756906078
"Niles city, Michigan",5319,4670,649,26,57760,12.201541643166008
"Boyne Falls village, Michigan",225,169,56,26,09840,24.88888888888889
"Charlevoix city, Michigan",2213,1309,904,26,14780,40.84952553095346
"Watervliet city, Michigan",799,694,105,26,84500,13.141426783479348
"Indian River CDP, Michigan",1687,957,730,26,40480,43.27208061647896
"Wolverine village, Michigan",116,92,24,26,88240,20.689655172413794
"Otsego city, Michigan",1887,1670,217,26,61620,11.499735029146795
"Wayland city, Michigan",1580,1562,18,26,84880,1.139240506329114
"Crystal Falls city, Michigan",896,732,164,26,19140,18.303571428571427
"Westwood CDP, Michigan",4412,4106,306,26,86380,6.935630099728014
"Caledonia village, Michigan",587,572,15,26,12480,2.555366269165247
"Cedar Springs city, Michigan",1379,1298,81,26,14200,5.873821609862219
"Sparta village, Michigan",1747,1621,126,26,75420,7.212364052661706
"Walker city, Michigan",10350,9973,377,26,82960,3.6425120772946857
"Yale city, Michigan",900,805,95,26,89000,10.555555555555555
"Carney village, Michigan",89,84,5,26,13400,5.617977528089887
"Lincoln village, Michigan",254,166,88,26,47560,34.645669291338585
"Algonac city, Michigan",2019,1768,251,26,01180,12.431896978702328
"Level Park-Oak Park CDP, Michigan",1779,1608,171,26,47230,9.612141652613827
"Prescott village, Michigan",124,86,38,26,66300,30.64516129032258
"Three Oaks village, Michigan",804,679,125,26,79720,15.547263681592039
"Zilwaukee city, Michigan",680,635,45,26,89320,6.61764705882353
"Baraga village, Michigan",614,501,113,26,05320,18.403908794788272
"McBride village, Michigan",90,74,16,26,50000,17.77777777777778
"Harper Woods city, Michigan",5980,5339,641,26,36700,10.719063545150503
"Southfield city, Michigan",35304,32235,3069,26,74900,8.69306594153637
"Gladwin city, Michigan",1297,1212,85,26,32320,6.553585196607556
"Metamora village, Michigan",273,260,13,26,53340,4.761904761904762
"White Pigeon village, Michigan",648,584,64,26,86920,9.876543209876543
"Sterling village, Michigan",238,209,29,26,76420,12.184873949579831
"Traverse City city, Michigan",7528,6848,680,26,80340,9.032943676939425
"Clarksville village, Michigan",211,187,24,26,16140,11.374407582938389
"Ionia city, Michigan",3273,2883,390,26,40860,11.915673693858846
"Mount Pleasant city, Michigan",9239,7911,1328,26,56020,14.373849983764478
"Shepherd village, Michigan",741,666,75,26,72960,10.121457489878543
"Canadian Lakes CDP, Michigan",2305,1396,909,26,13010,39.436008676789584
"Madison Heights city, Michigan",13721,12816,905,26,50560,6.595729174258436
"Britton village, Michigan",245,239,6,26,10760,2.4489795918367347
"Clayton village, Michigan",128,121,7,26,16280,5.46875
"Onsted village, Michigan",477,427,50,26,60840,10.482180293501047
"Alpena city, Michigan",4996,4507,489,26,01740,9.787830264211369
"Ossineke CDP, Michigan",572,391,181,26,61500,31.643356643356647
"Fennville city, Michigan",702,669,33,26,27740,4.700854700854701
"Hopkins village, Michigan",252,238,14,26,39180,5.555555555555555
"Albion city, Michigan",3642,2922,720,26,00980,19.769357495881383
"Beecher CDP, Michigan",4580,3566,1014,26,06820,22.139737991266376
"Burton city, Michigan",12541,11509,1032,26,12060,8.229008850968821
"Pleasant Ridge city, Michigan",1114,1035,79,26,64900,7.091561938958707
"Gaylord city, Michigan",1907,1776,131,26,31720,6.869428421604614
"Fairgrove village, Michigan",255,219,36,26,27080,14.117647058823529
"Nashville village, Michigan",834,721,113,26,56680,13.549160671462829
"Edwardsburg village, Michigan",546,493,53,26,25040,9.706959706959708
"Marcellus village, Michigan",499,436,63,26,51460,12.625250501002002
"Vandalia village, Michigan",148,130,18,26,81680,12.162162162162163
"Lake Linden village, Michigan",538,457,81,26,44780,15.055762081784389
"Mason city, Michigan",3432,3213,219,26,52180,6.381118881118882
"Stony Point CDP, Michigan",684,670,14,26,76720,2.046783625730994
"Brown City city, Michigan",562,541,21,26,11180,3.7366548042704624
"Fruitport village, Michigan",576,530,46,26,31000,7.986111111111111
"Montague city, Michigan",1165,1024,141,26,55100,12.103004291845494
"Ravenna village, Michigan",487,468,19,26,67280,3.9014373716632447
"Roosevelt Park city, Michigan",1716,1649,67,26,69520,3.904428904428905
"Wolverine Lake village, Michigan",2007,1924,83,26,88260,4.135525660189337
"Fenton city, Michigan",5608,5247,361,26,27760,6.437232524964337
"Flint city, Michigan",53598,40035,13563,26,29000,25.30504869584686
"Otter Lake village, Michigan",171,141,30,26,61760,17.543859649122805
"Three Rivers city, Michigan",3249,2980,269,26,79760,8.279470606340412
"Houghton city, Michigan",2824,2470,354,26,39360,12.53541076487252
"Woodland Beach CDP, Michigan",850,781,69,26,88480,8.117647058823529
"Farwell village, Michigan",395,337,58,26,27500,14.683544303797468
"Breedsville village, Michigan",76,72,4,26,10180,5.263157894736842
"Hartford city, Michigan",959,867,92,26,36960,9.593326381647548
"South Haven city, Michigan",3423,2075,1348,26,74980,39.380660239555944
"Pearl Beach CDP, Michigan",1629,1431,198,26,63200,12.154696132596685
"Newaygo city, Michigan",856,761,95,26,57080,11.098130841121495
"Byron Center CDP, Michigan",2422,2289,133,26,12280,5.491329479768786
"Forest Hills CDP, Michigan",10180,9839,341,26,29580,3.3497053045186638
"Richmond city, Michigan",2420,2171,249,26,68380,10.289256198347108
"St. Clair city, Michigan",2475,2322,153,26,70680,6.181818181818182
"Powers village, Michigan",156,131,25,26,66140,16.025641025641026
"Center Line city, Michigan",3807,3539,268,26,14320,7.0396637772524295
"Romeo village, Michigan",1756,1660,96,26,69400,5.466970387243736
"Robin Glen-Indiantown CDP, Michigan",377,311,66,26,68990,17.50663129973475
"Au Gres city, Michigan",646,451,195,26,04120,30.185758513931887
"Omer city, Michigan",178,134,44,26,60660,24.719101123595504
"Beaverton city, Michigan",696,626,70,26,06660,10.057471264367816
"Breckenridge village, Michigan",590,542,48,26,10160,8.135593220338983
"Frankfort city, Michigan",999,498,501,26,30260,50.150150150150154
"Ironwood city, Michigan",3105,2467,638,26,41060,20.547504025764894
"Coleman city, Michigan",664,604,60,26,17100,9.036144578313253
"Howard City village, Michigan",634,574,60,26,39500,9.46372239747634
"Bridgeport CDP, Michigan",3070,2771,299,26,10440,9.739413680781759
"Colon village, Michigan",723,549,174,26,17360,24.066390041493776
"Mendon village, Michigan",358,327,31,26,52980,8.659217877094973
"Durand city, Michigan",1603,1494,109,26,23500,6.799750467872738
"Bronson city, Michigan",976,887,89,26,10860,9.118852459016393
"Central Lake village, Michigan",585,430,155,26,14400,26.495726495726498
"Ellsworth village, Michigan",172,154,18,26,25420,10.465116279069768
"Sault Ste. Marie city, Michigan",6341,5735,606,26,71740,9.556852231509225
"Pellston village, Michigan",391,343,48,26,63300,12.27621483375959
"Brooklyn village, Michigan",587,555,32,26,11000,5.45144804088586
"Grosse Pointe city, Michigan",2349,2150,199,26,35480,8.471690080885482
"Grass Lake village, Michigan",509,472,37,26,34480,7.269155206286837
"Vandercook Lake CDP, Michigan",1971,1776,195,26,81740,9.89345509893455
"Garden City city, Michigan",11277,10681,596,26,31420,5.285093553249977
"Grosse Pointe Park city, Michigan",4662,4304,358,26,35540,7.679107679107679
"Clawson city, Michigan",5934,5708,226,26,16160,3.808560835861139
"Farmington Hills city, Michigan",36214,33957,2257,26,27440,6.23239631081902
"Schoolcraft village, Michigan",638,602,36,26,71860,5.6426332288401255
"Evart city, Michigan",795,671,124,26,26640,15.59748427672956
"Tustin village, Michigan",101,91,10,26,80960,9.900990099009901
"Rose City city, Michigan",287,231,56,26,69680,19.51219512195122
"Skidway Lake CDP, Michigan",2667,1574,1093,26,74200,40.98237720284965
"West Branch city, Michigan",1096,1028,68,26,85580,6.204379562043796
"Comstock Park CDP, Michigan",4651,4446,205,26,17700,4.407654267899376
"Cutlerville CDP, Michigan",6536,6259,277,26,19500,4.238066095471236
"East Grand Rapids city, Michigan",4128,4083,45,26,23980,1.0901162790697674
"DeWitt city, Michigan",1763,1719,44,26,22120,2.4957458876914353
"Lake Isabella village, Michigan",1091,784,307,26,44715,28.139321723189738
"Douglas city, Michigan",1108,491,617,26,22740,55.68592057761733
"Chelsea city, Michigan",2280,2215,65,26,15020,2.850877192982456
"Advance CDP, Michigan",315,163,152,26,00480,48.25396825396825
"Alba CDP, Michigan",185,128,57,26,00900,30.810810810810814
"Alden CDP, Michigan",169,54,115,26,01060,68.04733727810651
"Amasa CDP, Michigan",206,131,75,26,01960,36.407766990291265
"Arcadia CDP, Michigan",387,114,273,26,03300,70.54263565891473
"Attica CDP, Michigan",468,299,169,26,04020,36.11111111111111
"Bath CDP, Michigan",917,898,19,26,05880,2.0719738276990185
"Bay Port CDP, Michigan",319,223,96,26,06120,30.094043887147336
"Bay View CDP, Michigan",497,102,395,26,06260,79.47686116700201
"Bear Lake CDP, Michigan",644,182,462,26,06430,71.73913043478261
"Bendon CDP, Michigan",118,88,30,26,07220,25.423728813559322
"Boon CDP, Michigan",82,69,13,26,09560,15.853658536585366
"Brethren CDP, Michigan",308,148,160,26,10300,51.94805194805194
"Brutus CDP, Michigan",72,48,24,26,11380,33.33333333333333
"Caberfae CDP, Michigan",131,14,117,26,12290,89.31297709923665
"Carp Lake CDP, Michigan",582,200,382,26,13480,65.63573883161511
"Cedar CDP, Michigan",40,31,9,26,14020,22.5
"Chums Corner CDP, Michigan",426,384,42,26,15715,9.859154929577464
"Conway CDP, Michigan",145,93,52,26,17900,35.86206896551724
"Copper Harbor CDP, Michigan",126,40,86,26,18100,68.25396825396825
"Cross Village CDP, Michigan",114,40,74,26,18880,64.91228070175438
"Crystal Downs Country Club CDP, Michigan",153,45,108,26,19135,70.58823529411765
"Crystal Mountain CDP, Michigan",320,26,294,26,19195,91.875
"Delton CDP, Michigan",580,502,78,26,21560,13.448275862068964
"Dollar Bay CDP, Michigan",413,312,101,26,22520,24.455205811138015
"Dowling CDP, Michigan",193,169,24,26,22900,12.435233160621761
"Eagle Harbor CDP, Michigan",230,59,171,26,23600,74.34782608695653
"Eagle River CDP, Michigan",174,45,129,26,23740,74.13793103448276
"Eastport CDP, Michigan",300,93,207,26,24300,69.0
"Filer City CDP, Michigan",35,22,13,26,28060,37.142857142857146
"Fostoria CDP, Michigan",252,224,28,26,29920,11.11111111111111
"Glen Arbor CDP, Michigan",262,82,180,26,32360,68.70229007633588
"Grawn CDP, Michigan",378,336,42,26,34620,11.11111111111111
"Hardwood Acres CDP, Michigan",129,129,0,26,36585,0.0
"Haring CDP, Michigan",174,174,0,26,36590,0.0
"Henderson CDP, Michigan",158,122,36,26,37620,22.78481012658228
"Hickory Corners CDP, Michigan",105,105,0,26,37960,0.0
"Jasper CDP, Michigan",129,117,12,26,41540,9.30232558139535
"Horton Bay CDP, Michigan",424,245,179,26,39340,42.21698113207547
"Interlochen CDP, Michigan",197,159,38,26,40800,19.289340101522843
"Ironton CDP, Michigan",144,47,97,26,41040,67.36111111111111
"Jennings CDP, Michigan",128,112,16,26,41720,12.5
"K. I. Sawyer CDP, Michigan",1543,1067,476,26,43558,30.848995463383023
"Lake Leelanau CDP, Michigan",82,57,25,26,44760,30.48780487804878
"Lake Victoria CDP, Michigan",359,341,18,26,45190,5.013927576601671
"Leland CDP, Michigan",425,196,229,26,46800,53.88235294117647
"Levering CDP, Michigan",118,86,32,26,47240,27.11864406779661
"Loomis CDP, Michigan",99,76,23,26,49400,23.232323232323232
"Lupton CDP, Michigan",191,148,43,26,49720,22.5130890052356
"Manistee Lake CDP, Michigan",646,214,432,26,50755,66.87306501547987
"Maple City CDP, Michigan",81,63,18,26,50920,22.22222222222222
"Maple Grove CDP, Michigan",159,47,112,26,50970,70.44025157232704
"Marenisco CDP, Michigan",119,79,40,26,51540,33.61344537815126
"Nessen City CDP, Michigan",57,24,33,26,56960,57.89473684210527
"New Troy CDP, Michigan",273,258,15,26,57660,5.4945054945054945
"Norwood CDP, Michigan",108,75,33,26,59320,30.555555555555557
"Oak Hill CDP, Michigan",371,266,105,26,59740,28.30188679245283
"Oden CDP, Michigan",291,153,138,26,60180,47.42268041237113
"Omena CDP, Michigan",306,78,228,26,60640,74.50980392156863
"Parkdale CDP, Michigan",352,250,102,26,62500,28.97727272727273
"Pilgrim CDP, Michigan",261,14,247,26,64100,94.6360153256705
"Ponshewaing CDP, Michigan",76,32,44,26,65420,57.89473684210527
"Presque Isle Harbor CDP, Michigan",634,310,324,26,66343,51.10410094637224
"Rapid City CDP, Michigan",859,615,244,26,67140,28.405122235157158
"St. James CDP, Michigan",253,84,169,26,70900,66.79841897233202
"Sand Lake CDP, Michigan",1825,758,1067,26,71340,58.46575342465753
"Snover CDP, Michigan",190,164,26,26,74380,13.684210526315791
"South Boardman CDP, Michigan",311,188,123,26,74740,39.549839228295816
"Stronach CDP, Michigan",71,71,0,26,76820,0.0
"Village of Grosse Pointe Shores city, Michigan",1287,1165,122,26,82453,9.47940947940948
"Vineyard Lake CDP, Michigan",684,343,341,26,82490,49.853801169590646
"Wacousta CDP, Michigan",605,574,31,26,82680,5.12396694214876
"Walloon Lake CDP, Michigan",304,167,137,26,83140,45.06578947368421
"Watersmeet CDP, Michigan",294,184,110,26,84360,37.41496598639456
"Wedgewood CDP, Michigan",109,82,27,26,85110,24.770642201834864
"Wellston CDP, Michigan",223,97,126,26,85300,56.502242152466366
"White Pine CDP, Michigan",347,218,129,26,86960,37.17579250720461
"Zeba CDP, Michigan",225,168,57,26,89240,25.333333333333336
"Dexter city, Michigan",1764,1680,84,26,22160,4.761904761904762
"Ovid city, Michigan",709,667,42,26,61860,5.923836389280677
"Bay Shore CDP, Michigan",402,295,107,26,06180,26.616915422885572
"Caro city, Michigan",2022,1794,228,26,13420,11.275964391691394
"Caseville city, Michigan",813,414,399,26,13760,49.07749077490775
"Lakes of the North CDP, Michigan",1085,412,673,26,45144,62.02764976958526
"Jonesville city, Michigan",1039,970,69,26,41920,6.641000962463909
"Ontonagon village, Michigan",1001,770,231,26,60860,23.076923076923077
"Constantine village, Michigan",918,832,86,26,17840,9.368191721132897
"Bancroft village, Michigan",222,179,43,26,05080,19.36936936936937
"Morrice village, Michigan",469,415,54,26,55560,11.513859275053305
"Vernon village, Michigan",320,305,15,26,82020,4.6875
"Perrinton village, Michigan",246,237,9,26,63660,3.6585365853658534
"St. Louis city, Michigan",1416,1294,122,26,71000,8.615819209039548
"Kingsley village, Michigan",627,566,61,26,43340,9.728867623604467
"Harbor Beach city, Michigan",1033,864,169,26,36460,16.36011616650532
"Beulah village, Michigan",371,83,288,26,08100,77.62803234501348
"Port Austin village, Michigan",774,361,413,26,65680,53.35917312661499
"Port Hope village, Michigan",190,114,76,26,65800,40.0
"Sebewaing village, Michigan",883,731,152,26,72180,17.214043035107586
"New Era village, Michigan",188,168,20,26,57280,10.638297872340425
"Freeport village, Michigan",189,180,9,26,30580,4.761904761904762
"Carleton village, Michigan",1083,944,139,26,13220,12.834718374884579
"Dundee village, Michigan",2123,1867,256,26,23380,12.058407913330193
"Luna Pier city, Michigan",713,598,115,26,49700,16.129032258064516
"South Rockwood village, Michigan",792,749,43,26,75280,5.42929292929293
"Temperance CDP, Michigan",3726,3543,183,26,79240,4.911433172302738
"Carsonville village, Michigan",223,194,29,26,13620,13.004484304932735
"Mackinac Island city, Michigan",1056,447,609,26,50280,57.67045454545454
"St. Ignace city, Michigan",1405,1218,187,26,70840,13.309608540925266
"Eastlake village, Michigan",271,205,66,26,24060,24.354243542435423
"Fountain village, Michigan",91,66,25,26,29940,27.472527472527474
"Free Soil village, Michigan",63,48,15,26,30600,23.809523809523807
"Trowbridge Park CDP, Michigan",972,934,38,26,80660,3.909465020576132
"Maple Rapids village, Michigan",257,251,6,26,51200,2.3346303501945527
"Spring Arbor CDP, Michigan",791,687,104,26,75620,13.147914032869783
"Burr Oak village, Michigan",298,277,21,26,11920,7.046979865771812
"Fowler village, Michigan",494,477,17,26,30040,3.4412955465587043
"Bay City city, Michigan",15881,13880,2001,26,06020,12.59996221900384
"Le Roy village, Michigan",114,102,12,26,47100,10.526315789473683
"Reed City city, Michigan",1203,1110,93,26,67820,7.73067331670823
"Auburn city, Michigan",1009,960,49,26,04080,4.856293359762141
"Pinconning city, Michigan",626,587,39,26,64160,6.230031948881789
"Gaastra city, Michigan",213,153,60,26,31160,28.169014084507044
"Kalamazoo city, Michigan",32200,28665,3535,26,42160,10.978260869565219
"Parchment city, Michigan",871,809,62,26,62340,7.1182548794489096
"Grant city, Michigan",423,381,42,26,34360,9.929078014184398
"Kent City village, Michigan",402,368,34,26,42780,8.45771144278607
"Lowell city, Michigan",1560,1508,52,26,49540,3.3333333333333335
"Port Huron city, Michigan",13703,12381,1322,26,65820,9.64752244034153
"Daggett village, Michigan",125,88,37,26,19560,29.599999999999998
"Essexville city, Michigan",1448,1366,82,26,26420,5.662983425414365
"Augusta village, Michigan",385,359,26,26,04160,6.753246753246753
"South Lyon city, Michigan",5309,4951,358,26,75100,6.743266151817669
"Climax village, Michigan",344,312,32,26,16440,9.30232558139535
"Camden village, Michigan",226,220,6,26,12760,2.6548672566371683
"Laurium village, Michigan",1137,869,268,26,46360,23.57080035180299
"Edgemont Park CDP, Michigan",1116,1061,55,26,24880,4.92831541218638
"Lansing city, Michigan",55325,48926,6399,26,46000,11.56619972887483
"Walled Lake city, Michigan",3687,3554,133,26,83060,3.607268782207757
"Goodrich village, Michigan",697,664,33,26,32980,4.734576757532281
"Lake Fenton CDP, Michigan",2416,2290,126,26,44520,5.21523178807947
"Standish city, Michigan",724,664,60,26,76120,8.287292817679557
"Twining village, Michigan",78,69,9,26,81020,11.538461538461538
"Greenville city, Michigan",3733,3483,250,26,35100,6.6970265202250205
"Allegan city, Michigan",1795,1703,92,26,01260,5.125348189415042
"Plainwell city, Michigan",1737,1568,169,26,64740,9.729418537708694
"Marshall city, Michigan",3512,3294,218,26,51940,6.207289293849659
"Tekonsha village, Michigan",309,275,34,26,79160,11.003236245954692
"Benton Heights CDP, Michigan",1566,1396,170,26,07540,10.855683269476373
"Manistique city, Michigan",1561,1220,341,26,50760,21.844971172325433
"Byron village, Michigan",206,189,17,26,12260,8.25242718446602
"Milan city, Michigan",2388,2168,220,26,53920,9.212730318257957
"Lennon village, Michigan",194,187,7,26,46880,3.608247422680412
"Middletown CDP, Michigan",378,369,9,26,53730,2.380952380952381
"Manchester village, Michigan",1110,987,123,26,50660,11.081081081081082
"Ypsilanti city, Michigan",8686,7784,902,26,89140,10.3845268247755
"Ecorse city, Michigan",4647,3499,1148,26,24740,24.704110178609856
"Hamtramck city, Michigan",7573,6120,1453,26,36280,19.186583916545622
"Beverly Hills village, Michigan",4329,4155,174,26,08160,4.0194040194040195
"Birmingham city, Michigan",10180,9117,1063,26,08640,10.442043222003928
"Lake Orion village, Michigan",1551,1345,206,26,44940,13.281753707285624
"Milford village, Michigan",2820,2693,127,26,53960,4.50354609929078
"Novi city, Michigan",24421,23117,1304,26,59440,5.339666680316121
"Oxford village, Michigan",1585,1515,70,26,62020,4.416403785488959
"Kingston village, Michigan",179,169,10,26,43380,5.58659217877095
"Middleville village, Michigan",1314,1271,43,26,53760,3.272450532724505
"Dowagiac city, Michigan",2821,2524,297,26,22880,10.528181495923432
"Litchfield city, Michigan",602,528,74,26,47980,12.29235880398671
"Reading city, Michigan",411,373,38,26,67500,9.245742092457421
"Waldron village, Michigan",239,195,44,26,82880,18.410041841004183
"Hancock city, Michigan",2203,1872,331,26,36300,15.024965955515206
"Williamston city, Michigan",1871,1662,209,26,87420,11.17049706039551
"Lambertville CDP, Michigan",3968,3749,219,26,45420,5.519153225806452
"Maybee village, Michigan",247,242,5,26,52440,2.0242914979757085
"Petersburg city, Michigan",507,484,23,26,63800,4.536489151873767
"North Muskegon city, Michigan",1829,1553,276,26,58640,15.09021323127392
"Hesperia village, Michigan",402,371,31,26,37860,7.711442786069651
"Flushing city, Michigan",3614,3349,265,26,29200,7.332595462091865
"Akron village, Michigan",215,183,32,26,00700,14.883720930232558
"Unionville village, Michigan",232,215,17,26,81420,7.327586206896551
"Pentwater village, Michigan",963,400,563,26,63540,58.46313603322949
"Shelby village, Michigan",851,771,80,26,72840,9.400705052878966
"Walkerville village, Michigan",105,73,32,26,83020,30.476190476190478
"Marquette city, Michigan",8610,7607,1003,26,51900,11.64924506387921
"Hudsonville city, Michigan",2698,2658,40,26,39800,1.4825796886582654
"Rockwood city, Michigan",1432,1373,59,26,69180,4.120111731843576
"Woodhaven city, Michigan",5500,5251,249,26,88380,4.527272727272727
"Wyandotte city, Michigan",12088,11166,922,26,88900,7.627399073461285
"Lexington village, Michigan",1092,617,475,26,47280,43.498168498168496
"Marlette city, Michigan",861,761,100,26,51820,11.614401858304298
"Whitehall city, Michigan",1266,1188,78,26,86780,6.161137440758294
"Copemish village, Michigan",99,60,39,26,18040,39.39393939393939
"Custer village, Michigan",126,109,17,26,19420,13.492063492063492
"Ishpeming city, Michigan",3191,2797,394,26,41220,12.34722657474146
"Negaunee city, Michigan",2072,1849,223,26,56860,10.762548262548261
"West Ishpeming CDP, Michigan",1177,1103,74,26,85700,6.287170773152082
"Ferrysburg city, Michigan",1606,1299,307,26,27960,19.115815691158154
"Grand Haven city, Michigan",5723,4875,848,26,33340,14.817403459723922
"Houghton Lake CDP, Michigan",3145,1579,1566,26,39400,49.793322734499206
"Riverview city, Michigan",5487,5145,342,26,68880,6.232914160743576
"Taylor city, Michigan",25676,23706,1970,26,79000,7.67253466272005
"Eaton Rapids city, Michigan",2410,2191,219,26,24540,9.08713692946058
"Coopersville city, Michigan",1677,1617,60,26,18020,3.5778175313059033
"Centreville village, Michigan",527,490,37,26,14460,7.020872865275142
"Sturgis city, Michigan",4833,4310,523,26,76960,10.821435961100766
"Holland city, Michigan",12649,11774,875,26,38640,6.917542888765911
"Norton Shores city, Michigan",10874,9929,945,26,59140,8.690454294647784
"Harvey CDP, Michigan",737,613,124,26,37080,16.824966078697422
"Leslie city, Michigan",788,685,103,26,47180,13.071065989847716
"Palmer CDP, Michigan",174,166,8,26,62180,4.597701149425287
"St. Helen CDP, Michigan",2623,1202,1421,26,70800,54.17460922607701
"Forestville village, Michigan",195,39,156,26,29660,80.0
"Okemos CDP, Michigan",10057,9541,516,26,60340,5.130754698220145
"Detroit Beach CDP, Michigan",992,872,120,26,22040,12.096774193548388
"Twin Lake CDP, Michigan",846,688,158,26,81040,18.67612293144208
"Spring Lake village, Michigan",1383,1121,262,26,75820,18.944323933477946
"Posen village, Michigan",136,116,20,26,66000,14.705882352941178
"Westland city, Michigan",37554,35144,2410,26,86000,6.417425573840337
"Lake City city, Michigan",491,321,170,26,44480,34.623217922606926
"Marion village, Michigan",365,334,31,26,51660,8.493150684931507
"Plymouth city, Minnesota",32294,31002,1292,27,51730,4.000743172106273
"St. Anthony city (Hennepin and Ramsey Counties), Minnesota",4036,3891,145,27,56680,3.5926660059464814
"Crosby city, Minnesota",1316,1154,162,27,13924,12.310030395136778
"Cuyuna city, Minnesota",152,123,29,27,14428,19.078947368421055
"Emily city, Minnesota",1087,321,766,27,19286,70.46918123275069
"Ironton city, Minnesota",312,286,26,27,31274,8.333333333333332
"Jenkins city, Minnesota",185,149,36,27,31832,19.45945945945946
"Manhattan Beach city, Minnesota",63,29,34,27,39806,53.96825396825397
"Austin city, Minnesota",11004,9928,1076,27,02908,9.778262450018175
"Brownsdale city, Minnesota",310,279,31,27,08164,10.0
"Rose Creek city, Minnesota",192,183,9,27,55600,4.6875
"Badger city, Minnesota",190,170,20,27,03160,10.526315789473683
"Federal Dam city, Minnesota",133,46,87,27,20798,65.41353383458647
"Grasston city, Minnesota",84,75,9,27,25424,10.714285714285714
"Pemberton city, Minnesota",109,104,5,27,50200,4.587155963302752
"Lynd city, Minnesota",229,186,43,27,38708,18.777292576419214
"Barry city, Minnesota",6,2,4,27,03718,66.66666666666666
"Fairmont city, Minnesota",5268,4649,619,27,20330,11.750189825360668
"Ihlen city, Minnesota",39,25,14,27,30806,35.8974358974359
"Brook Park city, Minnesota",42,38,4,27,07984,9.523809523809524
"Rock Creek city, Minnesota",635,586,49,27,54934,7.716535433070866
"Beltrami city, Minnesota",57,48,9,27,05014,15.789473684210526
"Blackduck city, Minnesota",371,335,36,27,06256,9.703504043126685
"Solway city, Minnesota",39,29,10,27,61114,25.64102564102564
"Forada city, Minnesota",110,92,18,27,21608,16.363636363636363
"Herman city, Minnesota",293,228,65,27,28646,22.18430034129693
"Mabel city, Minnesota",406,347,59,27,38888,14.532019704433496
"Ostrander city, Minnesota",115,112,3,27,49030,2.608695652173913
"Whalan city, Minnesota",44,34,10,27,69808,22.727272727272727
"Wykoff city, Minnesota",199,190,9,27,71950,4.522613065326634
"Wyoming city, Minnesota",2819,2775,44,27,72022,1.5608371763036537
"Carlton city, Minnesota",485,469,16,27,10018,3.2989690721649487
"Cloquet city, Minnesota",4917,4605,312,27,12160,6.345332519829164
"Wright city, Minnesota",80,62,18,27,71824,22.5
"Stephen city, Minnesota",297,275,22,27,62698,7.4074074074074066
"Elizabeth city, Minnesota",73,63,10,27,18566,13.698630136986301
"Pelican Rapids city, Minnesota",989,846,143,27,50164,14.459049544994945
"Laporte city, Minnesota",113,87,26,27,35612,23.008849557522122
"Viking city, Minnesota",52,47,5,27,67090,9.615384615384617
"Windom city, Minnesota",2136,1943,193,27,70798,9.035580524344569
"Hanska city, Minnesota",192,181,11,27,27008,5.729166666666666
"Clarkfield city, Minnesota",442,382,60,27,11656,13.574660633484163
"Marshall city, Minnesota",5820,5263,557,27,40688,9.57044673539519
"Thief River Falls city, Minnesota",4184,3924,260,27,64570,6.21414913957935
"Cromwell city, Minnesota",181,119,62,27,13780,34.25414364640884
"Wilder city, Minnesota",21,21,0,27,70258,0.0
"Kettle River city, Minnesota",81,76,5,27,32966,6.172839506172839
"Chaska city, Minnesota",10004,9625,379,27,10972,3.788484606157537
"Brownsville city, Minnesota",288,250,38,27,08218,13.194444444444445
"Spicer city, Minnesota",699,573,126,27,61690,18.025751072961373
"Waterville city, Minnesota",1025,816,209,27,68584,20.390243902439025
"Crosslake city, Minnesota",2847,971,1876,27,13978,65.89392342817
"Elkton city, Minnesota",53,48,5,27,18728,9.433962264150944
"Gibbon city, Minnesota",413,366,47,27,23678,11.380145278450362
"Green Isle city, Minnesota",219,219,0,27,25658,0.0
"Winthrop city, Minnesota",645,575,70,27,71122,10.852713178294573
"Brooks city, Minnesota",72,72,0,27,08038,0.0
"Litchfield city, Minnesota",2970,2810,160,27,37448,5.387205387205387
"St. Michael city, Minnesota",5434,5271,163,27,57346,2.9996319470003683
"Borup city, Minnesota",57,35,22,27,07030,38.59649122807017
"Rice Lake CDP, Minnesota",86,74,12,27,54056,13.953488372093023
"Hill City city, Minnesota",534,313,221,27,29096,41.38576779026217
"McGrath city, Minnesota",50,20,30,27,38996,60.0
"Tamarack city, Minnesota",66,51,15,27,64156,22.727272727272727
"Amboy city, Minnesota",292,265,27,27,01324,9.246575342465754
"Eagle Lake city, Minnesota",1124,1075,49,27,17378,4.359430604982206
"Kerkhoven city, Minnesota",367,296,71,27,32876,19.346049046321525
"Comstock city, Minnesota",49,36,13,27,12862,26.53061224489796
"Johnson city, Minnesota",5,5,0,27,32012,0.0
"Felton city, Minnesota",92,77,15,27,20834,16.304347826086957
"Glyndon city, Minnesota",498,443,55,27,24182,11.04417670682731
"Hamburg city, Minnesota",224,213,11,27,26666,4.910714285714286
"Mayer city, Minnesota",641,633,8,27,41138,1.24804992199688
"Watertown city, Minnesota",1794,1624,170,27,68548,9.47603121516165
"Georgetown city, Minnesota",43,36,7,27,23498,16.27906976744186
"Moorhead city, Minnesota",17449,15999,1450,27,43864,8.309931801249355
"Foley city, Minnesota",959,909,50,27,21536,5.213764337851929
"Clearbrook city, Minnesota",267,214,53,27,11746,19.850187265917604
"Eagan city, Minnesota",27176,26553,623,27,17288,2.2924639387695027
"Callaway city, Minnesota",89,74,15,27,09280,16.853932584269664
"Lakeville city, Minnesota",22144,21627,517,27,35180,2.3347182080924855
"Rosemount city, Minnesota",8484,8396,88,27,55726,1.0372465818010372
"Chickamaw Beach city, Minnesota",114,59,55,27,11296,48.24561403508772
"Lake Shore city, Minnesota",1124,454,670,27,34928,59.60854092526691
"Longville city, Minnesota",210,108,102,27,38114,48.57142857142857
"Hutchinson city, Minnesota",6568,6289,279,27,30644,4.247868453105968
"Ogilvie city, Minnesota",194,174,20,27,48166,10.309278350515463
"St. Clair city, Minnesota",328,312,16,27,56824,4.878048780487805
"Skyline city, Minnesota",148,147,1,27,60754,0.6756756756756757
"Waubun city, Minnesota",187,168,19,27,68674,10.16042780748663
"North Oaks city, Minnesota",2053,2010,43,27,47104,2.0944958597174863
"Fulda city, Minnesota",615,570,45,27,22958,7.317073170731707
"Magnolia city, Minnesota",99,92,7,27,39338,7.07070707070707
"Hanley Falls city, Minnesota",173,161,12,27,26972,6.9364161849710975
"Benson city, Minnesota",1570,1471,99,27,05212,6.305732484076433
"Mapleview city, Minnesota",97,68,29,27,40346,29.896907216494846
"Plummer city, Minnesota",150,139,11,27,51712,7.333333333333333
"Coates city, Minnesota",84,82,2,27,12376,2.380952380952381
"Clontarf city, Minnesota",69,60,9,27,12124,13.043478260869565
"Ogema city, Minnesota",84,70,14,27,48130,16.666666666666664
"Hilltop city, Minnesota",371,361,10,27,29258,2.6954177897574128
"Sturgeon Lake city, Minnesota",233,152,81,27,63220,34.763948497854074
"Mountain Iron city, Minnesota",1387,1315,72,27,44548,5.191059841384282
"Bethel city, Minnesota",160,157,3,27,05554,1.875
"Hibbing city, Minnesota",7853,6813,1040,27,28790,13.243346491786578
"Waverly city, Minnesota",573,519,54,27,68764,9.424083769633508
"Maple Lake city, Minnesota",848,803,45,27,40220,5.306603773584905
"Medina city, Minnesota",2277,2234,43,27,41480,1.8884497145366712
"Bemidji city, Minnesota",6527,6122,405,27,05068,6.204994637658955
"Spring Hill city, Minnesota",37,37,0,27,61888,0.0
"Isle city, Minnesota",541,347,194,27,31472,35.85951940850277
"Dalton city, Minnesota",142,128,14,27,14626,9.859154929577464
"Argyle city, Minnesota",339,311,28,27,02134,8.259587020648967
"Orono city, Minnesota",3287,3084,203,27,48580,6.175844234864618
"Plainview city, Minnesota",1417,1271,146,27,51424,10.303458009880028
"Iona city, Minnesota",79,57,22,27,31094,27.848101265822784
"Frost city, Minnesota",131,102,29,27,22940,22.137404580152673
"Stacy city, Minnesota",657,640,17,27,62320,2.5875190258751903
"New Germany city, Minnesota",190,176,14,27,45556,7.368421052631578
"Quamba city, Minnesota",63,49,14,27,52756,22.22222222222222
"Janesville city, Minnesota",965,908,57,27,31706,5.9067357512953365
"Baxter city, Minnesota",3359,3184,175,27,04042,5.209883894016077
"Henderson city, Minnesota",401,379,22,27,28394,5.486284289276807
"Garvin city, Minnesota",80,65,15,27,23228,18.75
"Bagley city, Minnesota",704,640,64,27,03196,9.090909090909092
"Rogers city, Minnesota",4397,4163,234,27,55186,5.321810325221742
"Harmony city, Minnesota",548,501,47,27,27188,8.576642335766424
"Shafer city, Minnesota",432,394,38,27,59314,8.796296296296296
"Carver city, Minnesota",1538,1454,84,27,10144,5.461638491547465
"Clear Lake city, Minnesota",203,197,6,27,11764,2.955665024630542
"Kimball city, Minnesota",397,355,42,27,33164,10.579345088161208
"Bricelyn city, Minnesota",167,125,42,27,07678,25.149700598802394
"Corcoran city, Minnesota",2127,2060,67,27,13168,3.149976492712741
"Courtland city, Minnesota",281,276,5,27,13582,1.7793594306049825
"St. James city, Minnesota",1976,1794,182,27,57040,9.210526315789473
"Comfrey city, Minnesota",193,180,13,27,12772,6.7357512953367875
"Henning city, Minnesota",433,390,43,27,28520,9.930715935334874
"Norcross city, Minnesota",30,18,12,27,46492,40.0
"Kasson city, Minnesota",2529,2402,127,27,32498,5.021747726374061
"Alexandria city, Minnesota",7183,6540,643,27,00928,8.951691493804818
"Revere city, Minnesota",32,28,4,27,53908,12.5
"Dakota city, Minnesota",154,140,14,27,14518,9.090909090909092
"Woodbury city, Minnesota",25789,25098,691,27,71428,2.6794369692504554
"Lucan city, Minnesota",86,77,9,27,38420,10.465116279069768
"Stewart city, Minnesota",291,262,29,27,62788,9.965635738831615
"Alberta city, Minnesota",63,55,8,27,00676,12.698412698412698
"Ortonville city, Minnesota",1154,968,186,27,48706,16.11785095320624
"Lismore city, Minnesota",116,90,26,27,37412,22.413793103448278
"Taconite city, Minnesota",379,305,74,27,64048,19.525065963060687
"Nicollet city, Minnesota",469,462,7,27,46150,1.4925373134328357
"Arden Hills city, Minnesota",3160,3117,43,27,02026,1.360759493670886
"Nassau city, Minnesota",33,25,8,27,45016,24.242424242424242
"Randall city, Minnesota",290,263,27,27,53080,9.310344827586208
"Hanover city, Minnesota",1083,1078,5,27,26990,0.46168051708217916
"Grove City city, Minnesota",266,256,10,27,26126,3.7593984962406015
"Correll city, Minnesota",34,22,12,27,13384,35.294117647058826
"Elbow Lake CDP, Minnesota",74,34,40,27,18440,54.054054054054056
"Hitterdal city, Minnesota",94,83,11,27,29402,11.702127659574469
"Sabin city, Minnesota",239,207,32,27,56554,13.389121338912133
"Blaine city, Minnesota",24022,23091,931,27,06382,3.8756140204812257
"Centerville city, Minnesota",1341,1322,19,27,10648,1.4168530947054436
"Circle Pines city, Minnesota",1998,1884,114,27,11494,5.7057057057057055
"Coon Rapids city, Minnesota",24577,23978,599,27,13114,2.437238068112463
"Sunfish Lake city, Minnesota",208,189,19,27,63544,9.134615384615383
"West St. Paul city, Minnesota",8494,8170,324,27,69700,3.8144572639510246
"Silver Bay city, Minnesota",1101,842,259,27,60250,23.524069028156223
"Hatfield city, Minnesota",19,13,6,27,27566,31.57894736842105
"Two Harbors city, Minnesota",1918,1780,138,27,65956,7.194994786235662
"Gary city, Minnesota",114,110,4,27,23246,3.508771929824561
"Halstad city, Minnesota",349,287,62,27,26630,17.765042979942695
"Denham city, Minnesota",27,16,11,27,15670,40.74074074074074
"Rutledge city, Minnesota",111,69,42,27,56518,37.83783783783784
"Climax city, Minnesota",141,121,20,27,11962,14.184397163120568
"Fertile city, Minnesota",541,454,87,27,20978,16.081330868761555
"Fisher city, Minnesota",191,185,6,27,21158,3.1413612565445024
"Gully city, Minnesota",44,36,8,27,26270,18.181818181818183
"McIntosh city, Minnesota",316,275,41,27,39050,12.974683544303797
"Detroit Lakes city, Minnesota",5005,4063,942,27,15832,18.821178821178822
"Pine Point CDP, Minnesota",148,110,38,27,51234,25.675675675675674
"White Earth CDP, Minnesota",250,200,50,27,70006,20.0
"Columbia Heights city, Minnesota",8436,8019,417,27,12700,4.943100995732575
"Ramsey city, Minnesota",9175,8984,191,27,53026,2.081743869209809
"Ceylon city, Minnesota",178,141,37,27,10792,20.786516853932586
"Granada city, Minnesota",126,113,13,27,24884,10.317460317460316
"Gonvick city, Minnesota",145,123,22,27,24344,15.172413793103448
"Miesville city, Minnesota",59,57,2,27,42092,3.389830508474576
"New Trier city, Minnesota",32,32,0,27,46024,0.0
"Perley city, Minnesota",44,28,16,27,50506,36.36363636363637
"Randolph city, Minnesota",170,164,6,27,53098,3.5294117647058822
"Beaver Bay city, Minnesota",178,90,88,27,04456,49.43820224719101
"Ada city, Minnesota",873,733,140,27,00172,16.036655211912944
"Jordan city, Minnesota",2143,2143,0,27,32174,0.0
"Henriette city, Minnesota",42,42,0,27,28574,0.0
"Kerrick city, Minnesota",29,24,5,27,32912,17.24137931034483
"Clara City city, Minnesota",650,585,65,27,11548,10.0
"Lake Lillian city, Minnesota",140,128,12,27,34676,8.571428571428571
"New Prague city, Minnesota",3036,2825,211,27,45808,6.949934123847168
"Gilbert city, Minnesota",915,836,79,27,23714,8.633879781420765
"Hoyt Lakes city, Minnesota",1051,960,91,27,30302,8.658420551855375
"Iron Junction city, Minnesota",56,45,11,27,31238,19.642857142857142
"Prior Lake city, Minnesota",9927,9526,401,27,52594,4.039488264329607
"Audubon city, Minnesota",264,251,13,27,02728,4.924242424242424
"Lexington city, Minnesota",764,727,37,27,36836,4.842931937172775
"Beardsley city, Minnesota",138,106,32,27,04204,23.18840579710145
"Graceville city, Minnesota",334,299,35,27,24758,10.479041916167663
"Barnesville city, Minnesota",1079,1004,75,27,03574,6.950880444856349
"Dilworth city, Minnesota",1683,1653,30,27,15976,1.7825311942959003
"Watson city, Minnesota",93,75,18,27,68656,19.35483870967742
"Monticello city, Minnesota",5061,4984,77,27,43774,1.5214384508990317
"Montrose city, Minnesota",1148,1072,76,27,43810,6.620209059233449
"Eveleth city, Minnesota",1844,1614,230,27,19934,12.472885032537961
"Bovey city, Minnesota",389,340,49,27,07048,12.596401028277635
"Paynesville city, Minnesota",1153,1098,55,27,49966,4.770164787510842
"Roscoe city, Minnesota",48,44,4,27,55510,8.333333333333332
"Farwell city, Minnesota",16,16,0,27,20690,0.0
"Westport city, Minnesota",27,27,0,27,69628,0.0
"Dundas city, Minnesota",573,535,38,27,17126,6.631762652705062
"Sleepy Eye city, Minnesota",1541,1446,95,27,60844,6.164828033744322
"Williams city, Minnesota",92,56,36,27,70402,39.130434782608695
"Naytahwaush CDP, Minnesota",179,120,59,27,45052,32.960893854748605
"Luverne city, Minnesota",2110,1936,174,27,38564,8.246445497630333
"Steen city, Minnesota",78,78,0,27,62662,0.0
"Wheaton city, Minnesota",858,762,96,27,69844,11.188811188811188
"Porter city, Minnesota",93,87,6,27,52144,6.451612903225806
"Mantorville city, Minnesota",429,414,15,27,39986,3.4965034965034967
"Browerville city, Minnesota",379,348,31,27,08110,8.179419525065963
"Osakis city, Minnesota",924,757,167,27,48796,18.073593073593074
"Staples city, Minnesota",1430,1271,159,27,62446,11.118881118881118
"Belgrade city, Minnesota",430,371,59,27,04762,13.72093023255814
"Clearwater city, Minnesota",750,705,45,27,11800,6.0
"Cold Spring city, Minnesota",1644,1644,0,27,12484,0.0
"Holdingford city, Minnesota",292,278,14,27,29582,4.794520547945205
"St. Anthony city (Stearns County), Minnesota",37,35,2,27,56698,5.405405405405405
"St. Rosa city, Minnesota",24,19,5,27,58072,20.833333333333336
"Cohasset city, Minnesota",1333,1091,242,27,12412,18.154538634658664
"Deer River city, Minnesota",423,390,33,27,15310,7.801418439716312
"Warba city, Minnesota",74,59,15,27,68080,20.27027027027027
"Zemple city, Minnesota",40,40,0,27,72184,0.0
"Lafayette city, Minnesota",252,209,43,27,33920,17.063492063492063
"Mankato city, Minnesota",17543,16247,1296,27,39878,7.387561990537536
"Erskine city, Minnesota",251,223,28,27,19700,11.155378486055776
"Winger city, Minnesota",98,82,16,27,70870,16.3265306122449
"Savage city, Minnesota",10380,10195,185,27,58738,1.7822736030828517
"Lake Park city, Minnesota",334,298,36,27,34784,10.778443113772456
"Lino Lakes city, Minnesota",6994,6835,159,27,37322,2.2733771804403777
"Wolf Lake city, Minnesota",13,4,9,27,71338,69.23076923076923
"East Bethel city, Minnesota",4338,4228,110,27,17486,2.5357307514983862
"Ham Lake city, Minnesota",5738,5591,147,27,26738,2.56186824677588
"Fridley city, Minnesota",11090,10768,322,27,22814,2.903516681695221
"Roosevelt city, Minnesota",57,53,4,27,55438,7.017543859649122
"Roseau city, Minnesota",1374,1167,207,27,55546,15.065502183406112
"Battle Lake city, Minnesota",429,339,90,27,03970,20.97902097902098
"New York Mills city, Minnesota",607,517,90,27,46060,14.827018121911037
"Ottertail city, Minnesota",365,225,140,27,49210,38.35616438356164
"Parkers Prairie city, Minnesota",447,395,52,27,49732,11.6331096196868
"Gem Lake city, Minnesota",178,165,13,27,23318,7.303370786516854
"Cambridge city, Minnesota",3457,3315,142,27,09370,4.107607752386462
"Humboldt city, Minnesota",23,12,11,27,30446,47.82608695652174
"Dawson city, Minnesota",847,761,86,27,14968,10.15348288075561
"Madison city, Minnesota",951,797,154,27,39266,16.19348054679285
"Flensburg city, Minnesota",104,98,6,27,21266,5.769230769230769
"Little Falls city, Minnesota",3919,3754,165,27,37556,4.210257718805818
"Motley city, Minnesota",389,315,74,27,44422,19.02313624678663
"Pierz city, Minnesota",654,611,43,27,50776,6.574923547400611
"Sobieski city, Minnesota",90,86,4,27,61006,4.444444444444445
"Crystal city, Minnesota",9664,9433,231,27,14158,2.390314569536424
"Deephaven city, Minnesota",1548,1464,84,27,15148,5.426356589147287
"Greenfield city, Minnesota",1090,1063,27,27,25622,2.4770642201834865
"Maple Plain city, Minnesota",766,739,27,27,40256,3.524804177545692
"Rockford city, Minnesota",1632,1607,25,27,55006,1.531862745098039
"St. Louis Park city, Minnesota",24419,23187,1232,27,57220,5.045251648306646
"Brainerd city, Minnesota",6558,5927,631,27,07300,9.62183592558707
"Finlayson city, Minnesota",155,138,17,27,21122,10.967741935483872
"Mendota Heights city, Minnesota",4701,4646,55,27,41696,1.169963837481387
"Edgerton city, Minnesota",601,539,62,27,18152,10.316139767054908
"Woodstock city, Minnesota",57,41,16,27,71680,28.07017543859649
"Hinckley city, Minnesota",842,691,151,27,29294,17.933491686460805
"Mentor city, Minnesota",114,96,18,27,41714,15.789473684210526
"Nielsville city, Minnesota",44,39,5,27,46258,11.363636363636363
"Trail city, Minnesota",40,29,11,27,65344,27.500000000000004
"Andover city, Minnesota",10824,10628,196,27,01486,1.810790835181079
"Elysian city, Minnesota",393,288,105,27,19160,26.717557251908396
"Kinney city, Minnesota",82,59,23,27,33416,28.04878048780488
"Meadowlands city, Minnesota",68,59,9,27,41372,13.23529411764706
"Holloway city, Minnesota",71,59,12,27,29672,16.901408450704224
"Waldorf city, Minnesota",113,92,21,27,67756,18.58407079646018
"Waseca city, Minnesota",3803,3651,152,27,68296,3.996844596371286
"Cedar Mills city, Minnesota",32,28,4,27,10468,12.5
"Isanti city, Minnesota",2109,2109,0,27,31328,0.0
"Harding city, Minnesota",56,47,9,27,27098,16.071428571428573
"Royalton city, Minnesota",535,515,20,27,56176,3.7383177570093453
"Wilmont city, Minnesota",192,167,25,27,70582,13.020833333333334
"Alpha city, Minnesota",66,56,10,27,01162,15.151515151515152
"Jackson city, Minnesota",1707,1498,209,27,31562,12.243702401874634
"Prinsburg city, Minnesota",202,195,7,27,52558,3.4653465346534658
"Regal city, Minnesota",23,23,0,27,53710,0.0
"Montgomery city, Minnesota",1265,1149,116,27,43738,9.1699604743083
"Clinton city, Minnesota",274,200,74,27,11980,27.00729927007299
"Hermantown city, Minnesota",3925,3677,248,27,28682,6.318471337579617
"Leonidas city, Minnesota",30,30,0,27,36530,0.0
"Orr city, Minnesota",168,128,40,27,48634,23.809523809523807
"Northrop city, Minnesota",102,94,8,27,47212,7.8431372549019605
"Vineland CDP, Minnesota",377,276,101,27,67180,26.790450928381965
"Houston city, Minnesota",515,480,35,27,30230,6.796116504854369
"Raymond city, Minnesota",344,311,33,27,53296,9.593023255813954
"Trimont city, Minnesota",338,302,36,27,65470,10.650887573964498
"Truman city, Minnesota",520,471,49,27,65668,9.423076923076923
"Willernie city, Minnesota",176,168,8,27,70366,4.545454545454546
"Birchwood Village city, Minnesota",390,373,17,27,06058,4.358974358974359
"Hugo city, Minnesota",5643,5463,180,27,30392,3.1897926634768736
"Marine on St. Croix city, Minnesota",352,318,34,27,40562,9.659090909090908
"Genola city, Minnesota",29,29,0,27,23444,0.0
"Hillman city, Minnesota",11,11,0,27,29150,0.0
"Kinbrae city, Minnesota",3,3,0,27,33236,0.0
"Round Lake city, Minnesota",216,189,27,27,56086,12.5
"Worthington city, Minnesota",4876,4530,346,27,71734,7.095980311730927
"Cologne city, Minnesota",641,626,15,27,12664,2.3400936037441498
"Waconia city, Minnesota",4408,4253,155,27,67432,3.5163339382940113
"Hokah city, Minnesota",297,258,39,27,29510,13.131313131313133
"Goodview city, Minnesota",1812,1729,83,27,24524,4.580573951434879
"Vesta city, Minnesota",151,124,27,27,66982,17.880794701986755
"Oronoco city, Minnesota",551,508,43,27,48598,7.80399274047187
"Rochester city, Minnesota",48648,45945,2703,27,54880,5.556240749876665
"Minnesota City city, Minnesota",70,59,11,27,43144,15.714285714285714
"Farmington city, Minnesota",7902,7786,116,27,20618,1.4679827891672994
"Montevideo city, Minnesota",2548,2351,197,27,43720,7.731554160125589
"Rice city, Minnesota",548,541,7,27,53998,1.2773722627737227
"Apple Valley city, Minnesota",20120,19655,465,27,01900,2.3111332007952288
"Hampton city, Minnesota",284,268,16,27,26864,5.633802816901409
"Hendrum city, Minnesota",162,143,19,27,28484,11.728395061728394
"Holland city, Minnesota",96,80,16,27,29618,16.666666666666664
"Pipestone city, Minnesota",2092,1882,210,27,51388,10.038240917782026
"Trosky city, Minnesota",45,44,1,27,65542,2.2222222222222223
"Bruno city, Minnesota",44,37,7,27,08290,15.909090909090908
"Pine City city, Minnesota",1588,1373,215,27,51064,13.53904282115869
"Crookston city, Minnesota",3341,2955,386,27,13870,11.553427117629452
"East Grand Forks city, Minnesota",3737,3497,240,27,17612,6.4222638480064225
"Fosston city, Minnesota",774,715,59,27,21986,7.622739018087856
"Shakopee city, Minnesota",13906,13272,634,27,59350,4.55918308643751
"Anoka city, Minnesota",7516,7076,440,27,01720,5.854177754124534
"Babbitt city, Minnesota",864,762,102,27,03106,11.805555555555555
"Tower city, Minnesota",349,243,106,27,65272,30.37249283667622
"Otsego city, Minnesota",5860,5572,288,27,49138,4.914675767918088
"Brookston city, Minnesota",49,43,6,27,08056,12.244897959183673
"Ely city, Minnesota",1984,1632,352,27,19142,17.741935483870968
"Proctor city, Minnesota",1367,1277,90,27,52630,6.583760058522311
"Dunnell city, Minnesota",89,80,9,27,17180,10.112359550561797
"Welcome city, Minnesota",358,288,70,27,69070,19.553072625698324
"Cokato city, Minnesota",1036,1009,27,27,12430,2.606177606177606
"Buhl city, Minnesota",527,493,34,27,08524,6.451612903225806
"Chisholm city, Minnesota",2348,2089,259,27,11386,11.030664395229984
"Duluth city, Minnesota",38485,36039,2446,27,17000,6.355723008964532
"McKinley city, Minnesota",96,68,28,27,39140,29.166666666666668
"Winton city, Minnesota",75,58,17,27,71140,22.666666666666664
"Underwood city, Minnesota",189,179,10,27,66172,5.291005291005291
"Akeley city, Minnesota",227,162,65,27,00496,28.634361233480178
"La Salle city, Minnesota",34,32,2,27,35702,5.88235294117647
"Claremont city, Minnesota",274,239,35,27,11566,12.773722627737227
"The Lakes CDP, Minnesota",789,307,482,27,64543,61.08998732572877
"Eden Prairie city, Minnesota",25485,24582,903,27,18116,3.543260741612713
"Edina city, Minnesota",22988,21663,1325,27,18188,5.7638768052897165
"North Mankato city, Minnesota",6089,5765,324,27,47068,5.321070783379865
"Beaver Creek city, Minnesota",201,186,15,27,04492,7.462686567164178
"Hills city, Minnesota",310,290,20,27,29204,6.451612903225806
"Mounds View city, Minnesota",5144,4951,193,27,44530,3.7519440124416796
"Shoreview city, Minnesota",11493,11170,323,27,59998,2.8104063342904375
"Verndale city, Minnesota",256,217,39,27,66874,15.234375
"Dexter city, Minnesota",138,134,4,27,15886,2.898550724637681
"Lyle city, Minnesota",204,188,16,27,38654,7.8431372549019605
"Arlington city, Minnesota",1017,939,78,27,02152,7.669616519174041
"Gaylord city, Minnesota",946,855,91,27,23300,9.619450317124736
"New Auburn city, Minnesota",257,221,36,27,45376,14.007782101167315
"Maynard city, Minnesota",222,165,57,27,41210,25.675675675675674
"Cosmos city, Minnesota",258,243,15,27,13420,5.813953488372093
"Dassel city, Minnesota",607,579,28,27,14878,4.612850082372323
"Sauk Rapids city, Minnesota",5555,5480,75,27,58684,1.3501350135013501
"Lilydale city, Minnesota",624,579,45,27,37016,7.211538461538461
"Darwin city, Minnesota",162,126,36,27,14842,22.22222222222222
"Wrenshall city, Minnesota",171,158,13,27,71788,7.602339181286549
"Leonard city, Minnesota",18,12,6,27,36494,33.33333333333333
"Shevlin city, Minnesota",69,62,7,27,59782,10.144927536231885
"Burnsville city, Minnesota",25693,24651,1042,27,08794,4.055579340676449
"Mendota city, Minnesota",94,93,1,27,41678,1.0638297872340425
"Belle Plaine city, Minnesota",2504,2270,234,27,04834,9.345047923322685
"Vermillion city, Minnesota",174,173,1,27,66802,0.5747126436781609
"Oak Grove city, Minnesota",3046,2988,58,27,47690,1.9041365725541695
"St. Francis city, Minnesota",2707,2564,143,27,56950,5.282600664942741
"Annandale city, Minnesota",1542,1442,100,27,01684,6.48508430609598
"Delano city, Minnesota",2168,2168,0,27,15454,0.0
"Cook city, Minnesota",326,229,97,27,13006,29.754601226993866
"Virginia city, Minnesota",4937,4247,690,27,67288,13.976098845452704
"Byron city, Minnesota",2103,1996,107,27,09154,5.087969567284832
"Ellendale city, Minnesota",321,305,16,27,18746,4.984423676012461
"Breckenridge city, Minnesota",1621,1560,61,27,07462,3.763109191856878
"Wolverton city, Minnesota",72,64,8,27,71392,11.11111111111111
"Altura city, Minnesota",194,184,10,27,01234,5.154639175257731
"Stockton city, Minnesota",277,267,10,27,62896,3.6101083032490973
"Winona city, Minnesota",11474,10552,922,27,71032,8.035558654348964
"Cottage Grove city, Minnesota",12527,12051,476,27,13456,3.7997924483116465
"Lakeland city, Minnesota",781,748,33,27,34622,4.225352112676056
"Lake St. Croix Beach city, Minnesota",494,435,59,27,34865,11.94331983805668
"Aitkin city, Minnesota",1251,1058,193,27,00460,15.42765787370104
"McGregor city, Minnesota",210,194,16,27,39014,7.6190476190476195
"Palisade city, Minnesota",152,129,23,27,49498,15.131578947368421
"Lake Crystal city, Minnesota",1104,1020,84,27,34190,7.608695652173914
"Balaton city, Minnesota",277,245,32,27,03250,11.552346570397113
"St. Hilaire city, Minnesota",109,107,2,27,57022,1.834862385321101
"Erhard city, Minnesota",45,40,5,27,19556,11.11111111111111
"Odin city, Minnesota",68,49,19,27,48094,27.941176470588236
"Granite Falls city, Minnesota",1277,1172,105,27,25280,8.22239624119029
"Kellogg city, Minnesota",208,208,0,27,32642,0.0
"Warren city, Minnesota",814,725,89,27,68170,10.933660933660933
"Delavan city, Minnesota",129,112,17,27,15472,13.178294573643413
"Winnebago city, Minnesota",701,605,96,27,70924,13.69472182596291
"Strandquist city, Minnesota",53,38,15,27,63112,28.30188679245283
"St. Peter city, Minnesota",3927,3804,123,27,58036,3.132161955691368
"Grand Marais city, Minnesota",839,638,201,27,24992,23.95709177592372
"Biscay city, Minnesota",50,46,4,27,06112,8.0
"Silver Lake city, Minnesota",410,381,29,27,60376,7.073170731707316
"Dent city, Minnesota",86,82,4,27,15724,4.651162790697675
"Perham city, Minnesota",1606,1591,15,27,50470,0.933997509339975
"Miltona city, Minnesota",182,166,16,27,42398,8.791208791208792
"Barrett city, Minnesota",197,173,24,27,03682,12.18274111675127
"Elbow Lake city, Minnesota",677,612,65,27,18458,9.601181683899556
"Dennison city, Minnesota",64,58,6,27,15706,9.375
"Lonsdale city, Minnesota",1276,1245,31,27,38150,2.4294670846394983
"Sacred Heart city, Minnesota",264,231,33,27,56572,12.5
"Hayfield city, Minnesota",631,598,33,27,27872,5.229793977812995
"Blue Earth city, Minnesota",1664,1521,143,27,06688,8.59375
"Kiester city, Minnesota",282,226,56,27,33056,19.858156028368796
"Blomkest city, Minnesota",61,61,0,27,06490,0.0
"Scanlon city, Minnesota",515,482,33,27,58936,6.407766990291262
"Caledonia city, Minnesota",1370,1290,80,27,09226,5.839416058394161
"Spring Grove city, Minnesota",673,608,65,27,61852,9.658246656760774
"Victoria city, Minnesota",3102,2923,179,27,67036,5.770470664087686
"Strathcona city, Minnesota",15,10,5,27,63130,33.33333333333333
"Brewster city, Minnesota",200,193,7,27,07660,3.5000000000000004
"Dundee city, Minnesota",64,45,19,27,17144,29.6875
"Braham city, Minnesota",814,771,43,27,07282,5.282555282555283
"Cottonwood city, Minnesota",601,517,84,27,13564,13.976705490848584
"Goodridge city, Minnesota",86,80,6,27,24470,6.976744186046512
"Morris city, Minnesota",2340,2058,282,27,44242,12.051282051282051
"Murdock city, Minnesota",127,112,15,27,44818,11.811023622047244
"Heron Lake city, Minnesota",384,341,43,27,28700,11.197916666666668
"Lakefield city, Minnesota",806,739,67,27,34316,8.312655086848634
"Cleveland city, Minnesota",294,279,15,27,11872,5.1020408163265305
"Odessa city, Minnesota",76,61,15,27,48058,19.736842105263158
"Deerwood city, Minnesota",331,243,88,27,15346,26.586102719033235
"Racine city, Minnesota",182,171,11,27,52882,6.043956043956044
"Waltham city, Minnesota",53,50,3,27,67918,5.660377358490567
"Little Rock CDP, Minnesota",336,263,73,27,37656,21.726190476190478
"Evansville city, Minnesota",316,292,24,27,19898,7.59493670886076
"Kensington city, Minnesota",133,108,25,27,32768,18.796992481203006
"Holt city, Minnesota",31,31,0,27,29870,0.0
"Walters city, Minnesota",52,50,2,27,67900,3.8461538461538463
"Alvarado city, Minnesota",208,181,27,27,01252,12.980769230769232
"Grygla city, Minnesota",104,86,18,27,26216,17.307692307692307
"Middle River city, Minnesota",149,141,8,27,41912,5.369127516778524
"Bingham Lake city, Minnesota",81,76,5,27,05896,6.172839506172839
"Elgin city, Minnesota",511,491,20,27,18530,3.9138943248532287
"Hammond city, Minnesota",46,32,14,27,26828,30.434782608695656
"Turtle River city, Minnesota",51,48,3,27,65794,5.88235294117647
"Lanesboro city, Minnesota",448,336,112,27,35450,25.0
"Peterson city, Minnesota",116,98,18,27,50596,15.517241379310345
"Rushford city, Minnesota",787,737,50,27,56284,6.353240152477764
"Brandon city, Minnesota",265,243,22,27,07336,8.30188679245283
"Ashby city, Minnesota",226,217,9,27,02422,3.982300884955752
"Fountain city, Minnesota",179,165,14,27,22094,7.82122905027933
"Belview city, Minnesota",184,169,15,27,05050,8.152173913043478
"Lamberton city, Minnesota",452,345,107,27,35288,23.672566371681416
"Seaforth city, Minnesota",47,39,8,27,59098,17.02127659574468
"Big Lake city, Minnesota",3653,3494,159,27,05752,4.352586914864495
"Oak Park Heights city, Minnesota",1952,1824,128,27,47914,6.557377049180328
"La Crescent city, Minnesota",2277,2253,24,27,33866,1.0540184453227932
"St. Charles city, Minnesota",1501,1392,109,27,56788,7.261825449700201
"Forest Lake city, Minnesota",7896,7379,517,27,21770,6.547619047619048
"St. Paul Park city, Minnesota",1947,1947,0,27,58018,0.0
"Lake Bronson city, Minnesota",133,109,24,27,34136,18.045112781954884
"Bowlus city, Minnesota",120,116,4,27,07066,3.3333333333333335
"Upsala city, Minnesota",213,206,7,27,66334,3.286384976525822
"Bigelow city, Minnesota",84,66,18,27,05644,21.428571428571427
"Chisago City city, Minnesota",2287,2022,265,27,11350,11.587232181897683
"Barnum city, Minnesota",277,269,8,27,03628,2.888086642599278
"Red Lake CDP, Minnesota",533,473,60,27,53458,11.25703564727955
"Garfield city, Minnesota",120,116,4,27,23120,3.3333333333333335
"Hoffman city, Minnesota",299,270,29,27,29474,9.698996655518394
"Manchester city, Minnesota",25,17,8,27,39716,32.0
"Twin Lakes city, Minnesota",85,79,6,27,65920,7.0588235294117645
"Walnut Grove city, Minnesota",363,296,67,27,67846,18.457300275482094
"Elk River city, Minnesota",8780,8463,317,27,18674,3.6104783599088837
"Stewartville city, Minnesota",2407,2357,50,27,62806,2.077274615704196
"Campbell city, Minnesota",95,75,20,27,09496,21.052631578947366
"Doran city, Minnesota",29,15,14,27,16156,48.275862068965516
"Bayport city, Minnesota",1155,1088,67,27,04114,5.800865800865801
"Grant city, Minnesota",1612,1555,57,27,25334,3.535980148883375
"Lakeland Shores city, Minnesota",129,121,8,27,34658,6.2015503875969
"Oakdale city, Minnesota",11661,11258,403,27,47680,3.455964325529543
"Taylors Falls city, Minnesota",525,451,74,27,64318,14.095238095238095
"Moose Lake city, Minnesota",744,605,139,27,43954,18.682795698924732
"Eitzen city, Minnesota",130,126,4,27,18368,3.076923076923077
"Delhi city, Minnesota",18,18,0,27,15544,0.0
"Owatonna city, Minnesota",11135,10442,693,27,49300,6.223619218679839
"Morgan city, Minnesota",440,353,87,27,44116,19.772727272727273
"Norwood Young America city, Minnesota",1547,1447,100,27,47520,6.464124111182936
"Hartland city, Minnesota",156,146,10,27,27404,6.41025641025641
"Le Roy city, Minnesota",469,429,40,27,36620,8.528784648187633
"Riverton city, Minnesota",65,53,12,27,54736,18.461538461538463
"Roseville city, Minnesota",15872,15158,714,27,55852,4.498487903225806
"Rockville city, Minnesota",1163,1011,152,27,55078,13.069647463456576
"Newport city, Minnesota",1474,1433,41,27,45790,2.7815468113975577
"Minneiska city, Minnesota",61,53,8,27,43036,13.114754098360656
"St. Vincent city, Minnesota",40,26,14,27,58144,35.0
"Rushmore city, Minnesota",184,142,42,27,56338,22.82608695652174
"Hollandale city, Minnesota",175,158,17,27,29636,9.714285714285714
"Pine Island city, Minnesota",1340,1313,27,27,51136,2.014925373134328
"Lake Elmo city, Minnesota",3125,3033,92,27,34244,2.944
"Warroad city, Minnesota",850,758,92,27,68224,10.823529411764705
"Wanda city, Minnesota",41,36,5,27,68008,12.195121951219512
"Afton city, Minnesota",1185,1142,43,27,00316,3.6286919831223625
"Rush City city, Minnesota",980,924,56,27,56266,5.714285714285714
"Glenwood city, Minnesota",1416,1295,121,27,24074,8.545197740112995
"Pease city, Minnesota",110,97,13,27,50056,11.818181818181818
"Falcon Heights city, Minnesota",2317,2204,113,27,20420,4.8769961156668105
"Richmond city, Minnesota",652,638,14,27,54268,2.147239263803681
"Dovray city, Minnesota",45,33,12,27,16300,26.666666666666668
"Spring Lake Park city, Minnesota",2998,2807,191,27,61996,6.370913942628419
"Albertville city, Minnesota",2754,2754,0,27,00730,0.0
"Shelly city, Minnesota",98,58,40,27,59566,40.816326530612244
"Vining city, Minnesota",38,21,17,27,67216,44.73684210526316
"Mazeppa city, Minnesota",347,331,16,27,41282,4.610951008645533
"Brooklyn Center city, Minnesota",11008,10466,542,27,07948,4.923691860465116
"Long Beach city, Minnesota",235,139,96,27,37970,40.85106382978723
"Butterfield city, Minnesota",253,214,39,27,08992,15.41501976284585
"Madelia city, Minnesota",1151,971,180,27,39230,15.638575152041703
"West Concord city, Minnesota",353,320,33,27,69304,9.34844192634561
"Newfolden city, Minnesota",167,159,8,27,45520,4.790419161676647
"East Gull Lake city, Minnesota",830,440,390,27,17630,46.98795180722892
"Hackensack city, Minnesota",180,127,53,27,26378,29.444444444444446
"Pillager city, Minnesota",216,196,20,27,50902,9.25925925925926
"Plato city, Minnesota",139,122,17,27,51460,12.23021582733813
"Cannon Falls city, Minnesota",1767,1709,58,27,09730,3.2823995472552348
"Evan city, Minnesota",44,39,5,27,19880,11.363636363636363
"Goodhue city, Minnesota",461,446,15,27,24398,3.2537960954446854
"Northome city, Minnesota",123,101,22,27,47122,17.88617886178862
"Ranier city, Minnesota",323,250,73,27,53134,22.60061919504644
"Mahnomen city, Minnesota",598,518,80,27,39392,13.377926421404682
"Chandler city, Minnesota",153,148,5,27,10900,3.2679738562091507
"Wood Lake city, Minnesota",212,198,14,27,71446,6.60377358490566
"Ponemah CDP, Minnesota",183,160,23,27,51892,12.568306010928962
"Tenstrike city, Minnesota",115,80,35,27,64444,30.434782608695656
"Freeport city, Minnesota",326,320,6,27,22652,1.8404907975460123
"St. Cloud city, Minnesota",27678,26264,1414,27,56896,5.108750632271118
"Donaldson city, Minnesota",17,10,7,27,16030,41.17647058823529
"Karlstad city, Minnesota",466,361,105,27,32444,22.532188841201716
"Foreston city, Minnesota",241,220,21,27,21824,8.71369294605809
"Bock city, Minnesota",46,31,15,27,06814,32.608695652173914
"Milaca city, Minnesota",1388,1225,163,27,42110,11.743515850144092
"Renville city, Minnesota",638,519,119,27,53890,18.65203761755486
"Excelsior city, Minnesota",1272,1168,104,27,20078,8.176100628930817
"Medicine Lake city, Minnesota",189,184,5,27,41462,2.6455026455026456
"Minnetrista city, Minnesota",2643,2503,140,27,43306,5.297010972379872
"Arco city, Minnesota",67,46,21,27,01972,31.343283582089555
"Ivanhoe city, Minnesota",363,301,62,27,31526,17.079889807162534
"Tyler city, Minnesota",618,543,75,27,66046,12.135922330097088
"Fergus Falls city, Minnesota",6845,6242,603,27,20906,8.80934989043097
"Richville city, Minnesota",49,31,18,27,54340,36.734693877551024
"Redby CDP, Minnesota",370,332,38,27,53386,10.27027027027027
"Minnesota Lake city, Minnesota",335,268,67,27,43198,20.0
"Wells city, Minnesota",1101,995,106,27,69106,9.627611262488648
"Oslo city, Minnesota",133,110,23,27,48976,17.293233082706767
"Brooklyn Park city, Minnesota",29146,27455,1691,27,07966,5.801825293350717
"Woodland city, Minnesota",186,159,27,27,71500,14.516129032258066
"Chanhassen city, Minnesota",9426,9093,333,27,10918,3.532781667727562
"Minnetonka Beach city, Minnesota",250,221,29,27,43270,11.600000000000001
"Tonka Bay city, Minnesota",657,581,76,27,65164,11.56773211567732
"Vergas city, Minnesota",179,155,24,27,66766,13.40782122905028
"Lake City city, Minnesota",2687,2323,364,27,34172,13.546706363974693
"Lewisville city, Minnesota",116,108,8,27,36818,6.896551724137931
"Center City city, Minnesota",346,288,58,27,10576,16.76300578034682
"North Branch city, Minnesota",3816,3739,77,27,46798,2.017819706498952
"Kandiyohi city, Minnesota",216,210,6,27,32372,2.7777777777777777
"Red Lake Falls city, Minnesota",729,677,52,27,53476,7.133058984910837
"Milan city, Minnesota",156,134,22,27,42146,14.102564102564102
"Okabena city, Minnesota",114,108,6,27,48184,5.263157894736842
"Pennock city, Minnesota",186,178,8,27,50344,4.301075268817205
"Remer city, Minnesota",224,189,35,27,53782,15.625
"Heidelberg city, Minnesota",51,46,5,27,28214,9.803921568627452
"Kasota city, Minnesota",346,331,15,27,32462,4.335260115606936
"Bena city, Minnesota",68,51,17,27,05104,25.0
"Walker city, Minnesota",602,484,118,27,67792,19.601328903654487
"Brownton city, Minnesota",372,310,62,27,08254,16.666666666666664
"Good Thunder city, Minnesota",250,233,17,27,24506,6.800000000000001
"Spring Valley city, Minnesota",1179,1084,95,27,62104,8.057675996607294
"Funkley city, Minnesota",12,8,4,27,22976,33.33333333333333
"Kelliher city, Minnesota",159,118,41,27,32606,25.78616352201258
"Wendell city, Minnesota",69,53,16,27,69142,23.18840579710145
"Glenville city, Minnesota",284,271,13,27,24056,4.577464788732395
"Millville city, Minnesota",89,76,13,27,42290,14.606741573033707
"Wabasha city, Minnesota",1350,1158,192,27,67378,14.222222222222221
"Zumbro Falls city, Minnesota",99,89,10,27,72310,10.1010101010101
"Ormsby city, Minnesota",61,45,16,27,48562,26.229508196721312
"Dodge Center city, Minnesota",1036,1004,32,27,15994,3.088803088803089
"Easton city, Minnesota",102,90,12,27,17738,11.76470588235294
"Nevis city, Minnesota",241,186,55,27,45340,22.821576763485478
"Park Rapids city, Minnesota",1974,1696,278,27,49768,14.083080040526848
"Storden city, Minnesota",123,99,24,27,63022,19.51219512195122
"Cass Lake city, Minnesota",364,295,69,27,10252,18.956043956043956
"Glencoe city, Minnesota",2166,2120,46,27,23948,2.1237303785780237
"New Ulm city, Minnesota",6128,5706,422,27,46042,6.886422976501305
"Springfield city, Minnesota",1038,878,160,27,61816,15.414258188824661
"Canby city, Minnesota",904,756,148,27,09604,16.371681415929203
"Red Wing city, Minnesota",7539,7141,398,27,53620,5.2792147499668385
"Avoca city, Minnesota",84,50,34,27,03052,40.476190476190474
"Wanamingo city, Minnesota",510,510,0,27,67972,0.0
"International Falls city, Minnesota",3115,2663,452,27,31040,14.510433386837882
"Bejou city, Minnesota",38,32,6,27,04672,15.789473684210526
"St. Leo city, Minnesota",70,58,12,27,57202,17.142857142857142
"Onamia city, Minnesota",422,365,57,27,48310,13.507109004739338
"Kenyon city, Minnesota",827,796,31,27,32840,3.7484885126964933
"Dumont city, Minnesota",60,53,7,27,17090,11.666666666666666
"Zumbrota city, Minnesota",1582,1474,108,27,72328,6.826801517067003
"Littlefork city, Minnesota",301,284,17,27,37592,5.647840531561462
"Hadley city, Minnesota",33,33,0,27,26450,0.0
"Lake Wilson city, Minnesota",140,126,14,27,35198,10.0
"Kenneth city, Minnesota",33,30,3,27,32750,9.090909090909092
"Hazel Run city, Minnesota",29,29,0,27,28016,0.0
"Elmore city, Minnesota",328,231,97,27,18998,29.573170731707314
"Greenwald city, Minnesota",108,108,0,27,25874,0.0
"Long Prairie city, Minnesota",1427,1315,112,27,38060,7.848633496846531
"Albany city, Minnesota",1020,1001,19,27,00622,1.8627450980392157
"Eden Valley city, Minnesota",514,440,74,27,18134,14.396887159533073
"New Munich city, Minnesota",135,130,5,27,45772,3.7037037037037033
"Waite Park city, Minnesota",3696,3497,199,27,67612,5.384199134199134
"Calumet city, Minnesota",241,214,27,27,09316,11.20331950207469
"Nashwauk city, Minnesota",611,514,97,27,44980,15.875613747954173
"Nimrod city, Minnesota",64,37,27,27,46294,42.1875
"Bloomington city, Minnesota",37313,35833,1480,27,06616,3.966446010773725
"Vernon Center city, Minnesota",161,149,12,27,66910,7.453416149068323
"Ghent city, Minnesota",152,133,19,27,23660,12.5
"Taunton city, Minnesota",70,66,4,27,64264,5.714285714285714
"Chokio city, Minnesota",217,180,37,27,11440,17.050691244239633
"New Richland city, Minnesota",535,480,55,27,45862,10.2803738317757
"Bellingham city, Minnesota",138,105,33,27,04960,23.91304347826087
"Buckman city, Minnesota",110,95,15,27,08416,13.636363636363635
