,GEO_ID,name,rentersless30,renters3050,renters5080,renters80100,renters100up,ownersless30,owners3050,owners5080,owners80100,owners100up,runitsless30,runits3050,runits5080,runits80up,ounitsless50,ounits5080,ounits80100,ounits100up,less30rentgap,3050rentgap,80uprentgap,less50owngap,5080owngap,80100owngap,100upowngap
0,05000US01001,"Autauga County, Alabama",1275,875,789,675,2005,1089,1454,2244,2115,9155,800,1085,2585,1160,6010,3744,2750,3024,475,-1796,1520,-3467,-1500,-635,6131
1,05000US01003,"Baldwin County, Alabama",3830,3339,4575,2735,6199,4009,4955,8559,7925,32499,3560,3895,9420,3790,12260,17099,7935,21045,270,-4845,5144,-3296,-8540,-10,11454
2,05000US01005,"Barbour County, Alabama",1100,694,690,247,720,398,553,1090,1039,3104,890,1080,1340,135,2823,1340,460,1323,210,-650,832,-1872,-250,579,1781
3,05000US01007,"Bibb County, Alabama",529,284,528,88,277,459,624,1184,1024,2290,510,650,484,60,2980,1358,360,569,19,44,305,-1897,-174,664,1721
4,05000US01009,"Blount County, Alabama",1374,979,1125,229,755,1649,1663,3478,3253,7295,1610,2120,570,140,8204,4634,1549,2080,-236,555,844,-4892,-1156,1704,5215
5,05000US01011,"Bullock County, Alabama",519,180,269,45,98,340,200,443,318,1440,330,270,400,105,1755,325,65,429,189,-131,38,-1215,118,253,1011
6,05000US01013,"Butler County, Alabama",572,397,242,300,604,334,769,758,709,2630,645,605,680,174,2424,1115,470,1095,-73,-438,730,-1321,-357,239,1535
7,05000US01015,"Calhoun County, Alabama",3415,2359,3024,1204,3810,2129,2515,4619,4665,18910,2375,4320,6135,970,14245,7345,4000,6525,1040,-3111,4044,-9601,-2726,665,12385
8,05000US01017,"Chambers County, Alabama",844,630,969,342,1809,590,1230,1550,1264,4798,725,965,1980,920,4635,2135,864,1754,119,-1011,1231,-2815,-585,400,3044
9,05000US01019,"Cherokee County, Alabama",625,405,560,199,574,594,800,1469,1380,4740,580,760,725,294,3140,1875,1135,2590,45,-165,479,-1746,-406,245,2150
10,05000US01021,"Chilton County, Alabama",929,805,920,529,955,1140,1280,1879,1589,7378,925,1200,1755,260,6145,2469,1265,3020,4,-835,1224,-3725,-590,324,4358
11,05000US01023,"Choctaw County, Alabama",377,268,171,79,174,447,484,912,857,2089,350,394,309,30,2635,760,250,730,27,-138,223,-1704,152,607,1359
12,05000US01025,"Clarke County, Alabama",1270,323,534,269,885,795,730,900,749,3353,1390,950,765,170,3050,1200,689,1469,-120,-231,984,-1525,-300,60,1884
13,05000US01027,"Clay County, Alabama",269,198,278,130,363,378,395,840,669,2115,510,470,265,20,1970,915,359,904,-241,13,473,-1197,-75,310,1211
14,05000US01029,"Cleburne County, Alabama",410,262,319,118,365,389,484,750,650,2295,480,450,414,125,1655,999,395,1264,-70,-95,358,-782,-249,255,1031
15,05000US01031,"Coffee County, Alabama",1549,1250,1584,739,1665,886,1114,1963,1532,7731,1490,2390,2025,895,4728,3450,2074,2893,59,-441,1509,-2728,-1487,-542,4838
16,05000US01033,"Colbert County, Alabama",1554,1255,1285,539,1330,1334,1709,2020,2055,9255,1405,2060,2195,315,7680,4260,1525,2835,149,-910,1554,-4637,-2240,530,6420
17,05000US01035,"Conecuh County, Alabama",254,388,133,109,174,500,500,683,604,1640,300,405,315,45,2235,865,310,325,-46,-182,238,-1235,-182,294,1315
18,05000US01037,"Coosa County, Alabama",137,199,159,157,190,200,449,618,553,1624,365,225,235,10,1745,850,275,595,-228,-76,337,-1096,-232,278,1029
19,05000US01039,"Covington County, Alabama",855,610,878,321,1159,889,1014,2030,1823,6300,905,1165,1520,225,5219,2440,1245,2929,-50,-642,1255,-3316,-410,578,3371
20,05000US01041,"Crenshaw County, Alabama",363,323,308,120,443,322,507,570,578,2002,530,590,385,54,2289,704,319,535,-167,-77,509,-1460,-134,259,1467
21,05000US01043,"Cullman County, Alabama",1845,1245,1735,823,2185,1657,1919,3473,2863,14135,1660,1860,3405,910,7565,5610,2860,7578,185,-1670,2098,-3989,-2137,3,6557
22,05000US01045,"Dale County, Alabama",1739,1630,1145,672,2410,908,912,1550,1392,6733,1465,2660,2430,1035,5362,2754,1274,2165,274,-1285,2047,-3542,-1204,118,4568
23,05000US01047,"Dallas County, Alabama",2585,1174,1360,485,1149,892,995,1648,1438,5144,1330,2245,2770,390,5495,1699,974,1775,1255,-1410,1244,-3608,-51,464,3369
24,05000US01049,"DeKalb County, Alabama",1670,1494,1434,624,2100,1403,1914,3015,2969,9869,2280,2080,2630,325,7705,4230,2250,4534,-610,-1196,2399,-4388,-1215,719,5335
25,05000US01051,"Elmore County, Alabama",1665,1429,1715,775,2275,1440,1684,2965,2445,13334,1350,2080,3795,640,7109,6040,3170,5674,315,-2080,2410,-3985,-3075,-725,7660
26,05000US01053,"Escambia County, Alabama",1054,754,733,339,848,975,1109,1574,1455,4909,885,1165,1510,180,4325,2550,1083,1660,169,-777,1007,-2241,-976,372,3249
27,05000US01055,"Etowah County, Alabama",2289,2380,2349,924,3010,1849,2860,4128,3723,16488,2370,3165,4730,705,12414,6725,3405,5929,-81,-2381,3229,-7705,-2597,318,10559
28,05000US01057,"Fayette County, Alabama",420,329,344,139,380,447,579,983,904,2799,540,555,480,40,2895,1240,300,1005,-120,-136,479,-1869,-257,604,1794
29,05000US01059,"Franklin County, Alabama",619,903,724,192,1133,463,775,1249,1263,4573,940,1020,1450,180,3830,2155,765,1404,-321,-726,1145,-2592,-906,498,3169
30,05000US01061,"Geneva County, Alabama",597,630,634,276,674,742,1203,1035,980,4212,955,940,795,125,4394,1620,575,1498,-358,-161,825,-2449,-585,405,2714
31,05000US01063,"Greene County, Alabama",439,132,158,33,197,433,324,409,288,820,430,294,195,50,1400,310,175,170,9,-37,180,-643,99,113,650
32,05000US01065,"Hale County, Alabama",670,180,289,105,165,708,544,738,672,1789,770,380,260,10,2505,809,415,550,-100,29,260,-1253,-71,257,1239
33,05000US01067,"Henry County, Alabama",267,237,198,113,365,482,609,793,699,2983,285,464,400,44,2415,1245,574,1463,-18,-202,434,-1324,-452,125,1520
34,05000US01069,"Houston County, Alabama",3054,2519,2775,1455,4189,1546,2233,3560,3398,15777,1920,3280,7020,1775,9542,6317,3852,6538,1134,-4245,3869,-5763,-2757,-454,9239
35,05000US01071,"Jackson County, Alabama",1373,1140,988,577,1294,1228,1460,2308,2008,8828,1585,1345,2065,385,6250,3869,1530,3673,-212,-1077,1486,-3562,-1561,478,5155
36,05000US01073,"Jefferson County, Alabama",28030,17454,19080,8754,23870,14253,15380,25519,20874,94384,16645,24120,43965,12460,67585,41185,18709,40515,11385,-24885,20164,-37952,-15666,2165,53869
37,05000US01075,"Lamar County, Alabama",494,317,267,93,288,227,489,938,899,2365,535,655,250,14,2815,924,260,594,-41,17,367,-2099,14,639,1771
38,05000US01077,"Lauderdale County, Alabama",2803,2374,2895,1010,3120,1739,2470,4160,3708,15348,2865,4350,4640,339,9943,7550,2655,6785,-62,-1745,3791,-5734,-3390,1053,8563
39,05000US01079,"Lawrence County, Alabama",769,509,534,259,554,1085,1099,1739,1500,5555,990,1115,400,99,5350,2360,1115,1640,-221,134,714,-3166,-621,385,3915
40,05000US01081,"Lee County, Alabama",7930,4105,4160,2080,5815,3159,3140,4130,4135,21369,3255,6550,11265,3005,11868,9685,4660,9520,4675,-7105,4890,-5569,-5555,-525,11849
41,05000US01083,"Limestone County, Alabama",2945,1674,1330,650,810,2660,2885,4410,3595,12275,2940,3755,599,105,11850,7515,3045,3200,5,731,1355,-6305,-3105,550,9075
42,05000US01085,"Lowndes County, Alabama",532,258,207,59,88,595,436,630,509,1154,600,470,69,10,2234,338,240,380,-68,138,137,-1203,292,269,774
43,05000US01087,"Macon County, Alabama",935,545,428,278,579,581,479,923,769,2634,650,850,1085,185,3045,1128,264,749,285,-657,672,-1985,-205,505,1885
44,05000US01089,"Madison County, Alabama",13479,8670,10390,3795,9900,7402,7574,12867,11527,59090,7890,21080,15740,1510,36505,30435,13860,17145,5589,-5350,12185,-21529,-17568,-2333,41945
45,05000US01091,"Marengo County, Alabama",825,360,453,93,570,849,535,902,824,2825,780,650,660,190,2795,1135,499,1345,45,-207,473,-1411,-233,325,1480
46,05000US01093,"Marion County, Alabama",694,760,734,293,557,668,970,1824,1848,4854,1015,1195,725,100,4725,2068,760,2035,-321,9,750,-3087,-244,1088,2819
47,05000US01095,"Marshall County, Alabama",2349,2262,2279,940,2324,1457,2335,3858,3258,14480,2100,2900,4445,705,8633,6819,2909,6798,249,-2166,2559,-4841,-2961,349,7682
48,05000US01097,"Mobile County, Alabama",12970,10205,9710,5065,13785,7994,8543,14619,12019,62518,7555,7690,27040,9450,38400,33640,11592,21075,5415,-17330,9400,-21863,-19021,427,41443
49,05000US01099,"Monroe County, Alabama",1675,460,398,138,529,565,679,765,725,2559,1735,910,460,95,2514,1004,424,1079,-60,-62,572,-1270,-239,301,1480
50,05000US01101,"Montgomery County, Alabama",10044,6705,6605,3229,10130,4238,4381,8023,6203,31717,4430,7545,19955,4784,24400,13995,5589,10619,5614,-13350,8575,-15781,-5972,614,21098
51,05000US01103,"Morgan County, Alabama",3350,2460,2855,1185,3194,2415,2555,5110,4310,19820,2600,5190,4615,645,12685,9480,4030,7440,750,-1760,3734,-7715,-4370,280,12380
52,05000US01105,"Perry County, Alabama",403,150,94,0,109,385,364,570,454,705,350,249,124,24,1325,485,90,385,53,-30,85,-576,85,364,320
53,05000US01107,"Pickens County, Alabama",639,413,415,87,472,518,835,699,614,3089,925,540,440,95,2675,1385,664,978,-286,-25,464,-1322,-686,-50,2111
54,05000US01109,"Pike County, Alabama",1804,814,1123,308,972,467,427,1048,1043,4699,805,1240,2160,795,2943,1620,823,2070,999,-1037,485,-2049,-572,220,2629
55,05000US01111,"Randolph County, Alabama",679,392,499,252,603,399,724,860,928,3765,575,820,865,169,3404,1154,385,1624,104,-366,686,-2281,-294,543,2141
56,05000US01113,"Russell County, Alabama",2284,1455,1818,1153,2599,1150,1620,2164,1889,6983,1380,1815,4740,1384,5849,4300,1594,2220,904,-2922,2368,-3079,-2136,295,4763
57,05000US01115,"St. Clair County, Alabama",1485,1260,1294,549,1754,2784,2530,4304,3709,13844,1255,2850,2070,200,10560,8864,3069,3950,230,-776,2103,-5246,-4560,640,9894
58,05000US01117,"Shelby County, Alabama",2355,2325,3360,1600,6015,3260,4115,6704,6429,42198,1765,2740,8150,3015,10555,20490,10199,21049,590,-4790,4600,-3180,-13786,-3770,21149
59,05000US01119,"Sumter County, Alabama",974,248,268,99,185,602,417,589,435,1418,645,480,590,75,2040,510,180,569,329,-322,209,-1021,79,255,849
60,05000US01121,"Talladega County, Alabama",2030,1820,1805,640,2465,1690,2015,3775,3170,12903,1990,2200,3665,945,10620,5365,2319,5394,40,-1860,2160,-6915,-1590,851,7509
61,05000US01123,"Tallapoosa County, Alabama",1314,994,784,594,935,863,1175,1564,1500,7115,1010,1340,1900,355,5145,2435,1100,3450,304,-1116,1174,-3107,-871,400,3665
62,05000US01125,"Tuscaloosa County, Alabama",7095,4670,4730,2540,7545,2769,3184,6280,5505,28234,4060,5795,13080,3650,12120,14095,6970,12070,3035,-8350,6435,-6167,-7815,-1465,16164
63,05000US01127,"Walker County, Alabama",1559,1500,1283,487,1307,1279,2118,2815,2140,10873,1440,1775,2520,380,9525,3953,1795,4143,119,-1237,1414,-6128,-1138,345,6730
64,05000US01129,"Washington County, Alabama",246,262,80,134,324,420,645,619,590,2750,399,330,269,64,2530,1030,500,885,-153,-189,394,-1465,-411,90,1865
65,05000US01131,"Wilcox County, Alabama",561,192,265,72,353,377,291,358,314,1163,915,315,180,43,1394,410,144,480,-354,85,382,-726,-52,170,683
66,05000US01133,"Winston County, Alabama",491,409,634,132,493,514,877,1419,1453,3650,965,555,550,75,3855,1305,520,1770,-474,84,550,-2464,114,933,1880
67,05000US02013,"Aleutians East Borough, Alaska",61,35,34,48,150,41,73,69,68,254,145,75,89,12,284,132,14,67,-84,-55,186,-170,-63,54,187
68,05000US02016,"Aleutians West Census Area, Alaska",63,67,154,102,495,40,44,30,42,241,485,119,119,139,166,44,51,137,-422,35,458,-82,-14,-9,104
69,05000US02020,"Anchorage Municipality, Alaska",7190,6305,9175,6000,13600,2824,3893,6924,6974,44005,3855,8630,19615,10190,8125,13820,15450,27230,3335,-10440,9410,-1408,-6896,-8476,16775
70,05000US02050,"Bethel Census Area, Alaska",405,250,218,177,599,605,555,564,464,909,650,235,345,445,1418,559,405,504,-245,-127,331,-258,5,59,405
71,05000US02060,"Bristol Bay Borough, Alaska",26,12,40,30,73,26,34,34,34,127,53,53,44,8,89,69,23,29,-27,-4,95,-29,-35,11,98
72,05000US02068,"Denali Borough, Alaska",28,12,25,14,72,60,49,65,55,307,65,45,38,0,239,93,89,158,-37,-13,86,-130,-28,-34,149
73,05000US02070,"Dillingham Census Area, Alaska",126,92,101,42,180,118,102,163,151,395,234,84,130,100,312,193,149,233,-108,-29,122,-92,-30,2,162
74,05000US02090,"Fairbanks North Star Borough, Alaska",1850,2530,3225,2040,5310,1030,908,3104,2465,14389,1240,2180,6645,4870,3350,8069,5190,5219,610,-3420,2480,-1412,-4965,-2725,9170
75,05000US02100,"Haines Borough, Alaska",62,50,81,4,139,26,134,142,77,455,68,89,165,4,113,214,123,352,-6,-84,139,47,-72,-46,103
76,05000US02105,"Hoonah-Angoon Census Area, Alaska",42,60,42,30,73,53,76,130,101,300,83,53,74,4,159,150,93,230,-41,-32,99,-30,-20,8,70
77,05000US02110,"Juneau City and Borough, Alaska",869,605,625,582,1569,187,357,637,973,5896,900,930,1610,800,1069,618,1849,4655,-31,-985,1351,-525,19,-876,1241
78,05000US02122,"Kenai Peninsula Borough, Alaska",1315,1000,1239,678,2049,1444,1767,2165,1929,8552,1270,1585,2715,695,2888,4914,3017,5175,45,-1476,2032,323,-2749,-1088,3377
79,05000US02130,"Ketchikan Gateway Borough, Alaska",403,338,513,212,533,188,230,452,436,1964,260,314,1070,365,528,739,783,1268,143,-557,380,-110,-287,-347,696
80,05000US02150,"Kodiak Island Borough, Alaska",370,319,304,169,702,144,155,438,298,1710,450,245,785,379,515,605,544,1060,-80,-481,492,-216,-167,-246,650
81,05000US02158,"Kusilvak Census Area, Alaska",167,110,87,18,79,352,364,288,239,193,294,119,42,4,870,190,110,124,-127,45,93,-154,98,129,69
82,05000US02164,"Lake and Peninsula Borough, Alaska",36,22,31,16,41,46,84,64,64,80,58,54,19,8,163,65,23,44,-22,12,49,-33,-1,41,36
83,05000US02170,"Matanuska-Susitna Borough, Alaska",1800,1309,1603,751,1742,2117,1966,3366,3290,13188,1195,2010,3250,749,4293,9450,4797,5404,605,-1647,1744,-210,-6084,-1507,7784
84,05000US02180,"Nome Census Area, Alaska",233,226,238,131,333,347,335,329,319,580,304,209,265,365,898,429,193,245,-71,-27,99,-216,-100,126,335
85,05000US02185,"North Slope Borough, Alaska",169,72,171,82,503,67,165,213,173,557,279,199,354,160,488,375,100,110,-110,-183,425,-256,-162,73,447
86,05000US02188,"Northwest Arctic Borough, Alaska",145,96,141,55,347,181,197,206,161,398,190,175,164,269,533,249,99,184,-45,-23,133,-155,-43,62,214
87,05000US02195,"Petersburg Borough, Alaska",109,48,86,47,122,71,61,200,150,455,109,110,160,18,282,231,149,217,0,-74,151,-150,-31,1,238
88,05000US02198,"Prince of Wales-Hyder Census Area, Alaska",138,130,138,62,191,235,236,294,259,742,225,190,185,29,744,373,253,386,-87,-47,224,-273,-79,6,356
89,05000US02220,"Sitka City and Borough, Alaska",256,239,300,223,512,114,62,226,216,1320,325,215,760,239,249,282,234,1300,-69,-460,496,-73,-56,-18,20
90,05000US02230,"Skagway Municipality, Alaska",24,34,60,55,97,28,12,28,46,157,38,28,124,18,28,37,39,136,-14,-64,134,12,-9,7,21
91,05000US02240,"Southeast Fairbanks Census Area, Alaska",102,112,126,45,225,201,122,227,261,778,174,90,245,88,474,463,269,398,-72,-119,182,-151,-236,-8,380
92,05000US02261,"Valdez-Cordova Census Area, Alaska",129,146,91,22,367,218,171,161,118,1392,224,245,230,59,611,532,428,605,-95,-139,330,-222,-371,-310,787
93,05000US02275,"Wrangell City and Borough, Alaska",92,117,56,42,77,45,111,91,121,387,115,130,104,4,172,284,75,205,-23,-48,115,-16,-193,46,182
94,05000US02282,"Yakutat City and Borough, Alaska",20,26,24,12,45,16,16,36,32,80,32,19,44,8,44,50,20,43,-12,-20,49,-12,-14,12,37
95,05000US02290,"Yukon-Koyukuk Census Area, Alaska",238,93,101,46,119,304,273,261,233,418,339,144,89,8,972,263,89,98,-101,12,157,-395,-2,144,320
96,05000US04001,"Apache County, Arizona",857,594,628,457,1829,3441,2044,2054,1807,6530,1260,1400,1120,580,8045,3245,1165,3060,-403,-492,1706,-2560,-1191,642,3470
97,05000US04003,"Cochise County, Arizona",2730,2845,2409,1405,5875,2594,2604,4940,4135,21024,2095,2090,6985,4110,9768,8604,4600,12310,635,-4576,3170,-4570,-3664,-465,8714
98,05000US04005,"Coconino County, Arizona",4600,3085,3795,2014,5860,3183,2015,4195,3349,16599,2665,2695,6920,7080,7653,3740,3155,14340,1935,-3125,794,-2455,455,194,2259
99,05000US04007,"Gila County, Arizona",1095,995,1149,424,2195,1310,1319,2395,2335,9088,1140,810,2000,1910,4573,2325,1589,7874,-45,-851,709,-1944,70,746,1214
100,05000US04009,"Graham County, Arizona",897,640,669,184,1125,774,604,1079,1113,4295,880,480,1550,595,3139,2279,894,1379,17,-881,714,-1761,-1200,219,2916
101,05000US04011,"Greenlee County, Arizona",93,109,218,234,1119,96,165,309,283,779,970,544,214,49,1010,320,100,185,-877,4,1304,-749,-11,183,594
102,05000US04012,"La Paz County, Arizona",402,324,703,288,537,365,722,1138,1233,3735,449,580,695,550,3410,1130,800,1879,-47,8,275,-2323,8,433,1856
103,05000US04013,"Maricopa County, Arizona",110810,87635,118890,67000,196675,59439,66829,123405,105755,575135,35645,80490,307110,157770,167080,219730,143440,398640,75165,-188220,105905,-40812,-96325,-37685,176495
104,05000US04015,"Mohave County, Arizona",3800,4020,5588,3135,10039,3909,4804,10059,8075,33038,2710,3155,13660,7045,17449,11785,7545,22354,1090,-8072,6129,-8736,-1726,530,10684
105,05000US04017,"Navajo County, Arizona",2519,1810,1854,934,3535,3184,2347,3015,2800,13310,2785,1990,3635,2245,8934,4730,2730,8070,-266,-1781,2224,-3403,-1715,70,5240
106,05000US04019,"Pima County, Arizona",33860,26699,29970,16100,45070,16709,20525,35899,31727,148934,13205,24110,79510,34870,66715,65260,37450,82869,20655,-49540,26300,-29481,-29361,-5723,66065
107,05000US04021,"Pinal County, Arizona",8475,6379,7980,3700,10055,8839,9211,17152,13883,51245,6825,7950,18785,3025,34675,34054,11695,19210,1650,-10805,10730,-16625,-16902,2188,32035
108,05000US04023,"Santa Cruz County, Arizona",1200,864,1325,430,1279,700,919,1693,1104,6285,780,1020,2480,825,1973,3135,1315,4470,420,-1155,884,-354,-1442,-211,1815
109,05000US04025,"Yavapai County, Arizona",4530,4570,5940,3255,9360,5164,6439,9995,9205,38004,3490,3830,12665,7680,12365,11630,9994,34495,1040,-6725,4935,-762,-1635,-789,3509
110,05000US04027,"Yuma County, Arizona",3880,3845,4400,2140,9010,3109,3879,7855,6493,29059,3170,2065,8255,9805,14403,14970,6934,13289,710,-3855,1345,-7415,-7115,-441,15770
111,05000US05001,"Arkansas County, Arkansas",630,484,640,353,744,283,443,778,773,2883,975,525,1190,180,2670,1115,354,774,-345,-550,917,-1944,-337,419,2109
112,05000US05003,"Ashley County, Arkansas",545,565,396,296,335,434,548,1159,1058,3360,445,695,930,59,3830,1200,495,670,100,-534,572,-2848,-41,563,2690
113,05000US05005,"Baxter County, Arkansas",527,892,1004,585,1524,680,1189,2530,1975,7813,795,740,2530,465,3375,4609,1815,4400,-268,-1526,1644,-1506,-2079,160,3413
114,05000US05007,"Benton County, Arkansas",4495,5205,6210,3480,11254,2899,4524,8739,7584,37983,3075,9270,15450,2839,16470,20875,8079,16050,1420,-9240,11895,-9047,-12136,-495,21933
115,05000US05009,"Boone County, Arkansas",829,565,1145,454,1190,589,874,1663,1459,6293,670,945,2075,475,3399,3723,1284,2719,159,-930,1169,-1936,-2060,175,3574
116,05000US05011,"Bradley County, Arkansas",449,374,257,118,527,189,309,515,356,1610,445,500,655,140,1645,475,340,444,4,-398,505,-1147,40,16,1166
117,05000US05013,"Calhoun County, Arkansas",111,127,47,18,58,89,228,304,304,885,68,149,130,4,1094,370,105,165,43,-83,72,-777,-66,199,720
118,05000US05015,"Carroll County, Arkansas",243,564,560,270,794,442,940,1454,1234,4644,355,755,1075,250,2775,1845,985,2984,-112,-515,814,-1393,-391,249,1660
119,05000US05017,"Chicot County, Arkansas",514,329,199,23,379,455,294,439,368,1428,485,350,520,95,2035,385,139,394,29,-321,307,-1286,54,229,1034
120,05000US05019,"Clark County, Arkansas",950,653,834,204,708,329,404,949,769,3288,940,1025,1300,89,2915,1285,554,899,10,-466,823,-2182,-336,215,2389
121,05000US05021,"Clay County, Arkansas",484,453,368,227,390,362,662,713,702,2278,460,635,720,95,2804,925,284,590,24,-352,522,-1780,-212,418,1688
122,05000US05023,"Cleburne County, Arkansas",469,615,665,180,732,558,880,1215,1020,4454,615,795,1125,120,2929,2214,775,2344,-146,-460,792,-1491,-999,245,2110
123,05000US05025,"Cleveland County, Arkansas",167,86,198,110,295,163,178,337,341,1473,295,189,365,0,1210,480,250,525,-128,-167,405,-869,-143,91,948
124,05000US05027,"Columbia County, Arkansas",1115,373,699,190,800,554,925,805,900,3240,920,920,1110,250,3654,820,740,1120,195,-411,740,-2175,-15,160,2120
125,05000US05029,"Conway County, Arkansas",553,660,389,184,595,385,545,984,730,3351,815,600,850,125,2580,1585,573,1204,-262,-461,654,-1650,-601,157,2147
126,05000US05031,"Craighead County, Arkansas",3170,2995,3519,1817,5105,980,1700,2555,2634,15630,1935,2980,9065,2625,6755,6975,4020,6009,1235,-5546,4297,-4075,-4420,-1386,9621
127,05000US05033,"Crawford County, Arkansas",1204,810,1435,618,1730,1044,1598,2914,2909,10494,800,1445,3110,450,6748,5255,2483,3730,404,-1675,1898,-4106,-2341,426,6764
128,05000US05035,"Crittenden County, Arkansas",2364,1934,1604,795,1384,773,1259,1748,1584,5834,1575,2875,3375,250,5805,2849,954,1230,789,-1771,1929,-3773,-1101,630,4604
129,05000US05037,"Cross County, Arkansas",515,413,530,188,549,179,394,890,750,2689,610,425,1005,150,2575,970,250,844,-95,-475,587,-2002,-80,500,1845
130,05000US05039,"Dallas County, Arkansas",130,144,333,165,199,184,273,357,342,1085,135,320,515,14,1400,489,90,180,-5,-182,350,-943,-132,252,905
131,05000US05041,"Desha County, Arkansas",638,583,464,105,393,320,397,530,515,1580,780,655,720,39,2230,565,119,195,-142,-256,459,-1513,-35,396,1385
132,05000US05043,"Drew County, Arkansas",805,440,429,205,530,399,405,689,525,2870,510,670,1120,105,2195,1045,555,990,295,-691,630,-1391,-356,-30,1880
133,05000US05045,"Faulkner County, Arkansas",4043,3285,3805,1739,3638,1985,2273,3675,3280,16689,1610,5705,8340,848,8289,11420,3265,4845,2433,-4535,4529,-4031,-7745,15,11844
134,05000US05047,"Franklin County, Arkansas",564,366,291,192,397,438,433,713,512,2962,390,405,945,69,2280,1438,540,873,174,-654,520,-1409,-725,-28,2089
135,05000US05049,"Fulton County, Arkansas",348,363,207,72,138,155,535,693,748,2195,330,450,325,19,1700,820,345,1120,18,-118,191,-1010,-127,403,1075
136,05000US05051,"Garland County, Arkansas",2840,2795,2524,1007,4055,1748,2229,3621,3280,16749,1865,1695,7045,2615,8143,6970,3649,9180,975,-4521,2447,-4166,-3349,-369,7569
137,05000US05053,"Grant County, Arkansas",290,293,299,90,419,528,784,590,669,3079,270,500,615,4,2498,1770,480,754,20,-316,505,-1186,-1180,189,2325
138,05000US05055,"Greene County, Arkansas",973,1059,985,510,1954,675,979,1820,1689,6679,725,1245,3120,399,5134,3169,1559,1760,248,-2135,2065,-3480,-1349,130,4919
139,05000US05057,"Hempstead County, Arkansas",465,575,640,178,610,484,587,767,718,3282,490,655,1185,135,3150,1200,443,729,-25,-545,653,-2079,-433,275,2553
140,05000US05059,"Hot Spring County, Arkansas",824,518,535,409,795,460,1064,1609,1407,5134,570,730,1710,80,4529,2390,884,1490,254,-1175,1124,-3005,-781,523,3644
141,05000US05061,"Howard County, Arkansas",343,415,428,155,373,218,364,579,514,1910,480,475,655,85,1505,815,340,790,-137,-227,443,-923,-236,174,1120
142,05000US05063,"Independence County, Arkansas",658,1018,1073,459,988,504,864,1594,1384,6210,670,1250,1925,335,4200,2435,1485,2255,-12,-852,1112,-2832,-841,-101,3955
143,05000US05065,"Izard County, Arkansas",272,208,214,119,284,283,372,819,661,2258,355,350,389,15,2299,900,309,720,-83,-175,388,-1644,-81,352,1538
144,05000US05067,"Jackson County, Arkansas",544,339,347,127,484,304,592,837,725,2195,320,590,785,115,3125,765,180,465,224,-438,496,-2229,72,545,1730
145,05000US05069,"Jefferson County, Arkansas",2119,2000,1884,909,3084,1315,1605,2790,2260,10140,1400,1590,5510,1495,9365,4360,1475,2620,719,-3626,2498,-6445,-1570,785,7520
146,05000US05071,"Johnson County, Arkansas",630,655,609,378,614,435,975,1330,1298,3599,620,735,1240,290,2920,2280,749,1195,10,-631,702,-1510,-950,549,2404
147,05000US05073,"Lafayette County, Arkansas",303,102,95,98,172,232,226,391,317,1060,395,255,115,20,1280,370,135,285,-92,-20,250,-822,21,182,775
148,05000US05075,"Lawrence County, Arkansas",519,403,470,151,629,247,573,650,523,2600,525,980,640,18,2554,1010,370,525,-6,-170,762,-1734,-360,153,2075
149,05000US05077,"Lee County, Arkansas",599,348,215,109,294,147,313,344,308,979,715,315,540,4,1284,285,115,285,-116,-325,399,-824,59,193,694
150,05000US05079,"Lincoln County, Arkansas",228,246,207,73,223,233,229,560,488,1625,340,255,320,55,1990,415,234,350,-112,-113,241,-1528,145,254,1275
151,05000US05081,"Little River County, Arkansas",264,470,413,84,385,218,408,599,684,2159,425,585,525,80,2265,739,300,380,-161,-112,389,-1639,-140,384,1779
152,05000US05083,"Logan County, Arkansas",520,399,441,229,610,366,580,1229,1024,3188,420,920,805,54,2905,1660,755,849,100,-364,785,-1959,-431,269,2339
153,05000US05085,"Lonoke County, Arkansas",1540,1720,1980,858,2190,1188,1275,2660,2260,11130,1650,3135,2925,570,7290,7015,2230,2000,-110,-945,2478,-4827,-4355,30,9130
154,05000US05087,"Madison County, Arkansas",394,415,328,124,214,564,674,700,795,2239,635,590,200,35,2412,1265,365,725,-241,128,303,-1174,-565,430,1514
155,05000US05089,"Marion County, Arkansas",342,368,332,148,246,469,449,909,840,2693,280,445,670,40,1745,1209,770,1699,62,-338,354,-827,-300,70,994
156,05000US05091,"Miller County, Arkansas",1665,1070,1460,710,1324,864,970,1429,1598,6483,930,1400,3640,245,5069,2809,1395,1740,735,-2180,1789,-3235,-1380,203,4743
157,05000US05093,"Mississippi County, Arkansas",1648,1593,1429,704,2122,529,1019,1560,1305,5554,1390,1835,3920,373,5535,2270,909,1260,258,-2491,2453,-3987,-710,396,4294
158,05000US05095,"Monroe County, Arkansas",423,244,223,133,257,146,297,309,259,1124,425,470,374,8,1485,334,95,185,-2,-151,382,-1042,-25,164,939
159,05000US05097,"Montgomery County, Arkansas",136,173,165,68,181,216,389,644,578,1530,279,245,174,12,1409,495,435,855,-143,-9,237,-804,149,143,675
160,05000US05099,"Nevada County, Arkansas",152,309,221,14,173,206,248,390,298,1540,330,170,320,64,1890,379,185,180,-178,-99,123,-1436,11,113,1360
161,05000US05101,"Newton County, Arkansas",94,118,113,22,119,244,375,469,499,1285,215,155,94,0,1239,745,130,675,-121,19,141,-620,-276,369,610
162,05000US05103,"Ouachita County, Arkansas",969,760,618,195,742,655,914,934,1024,3549,860,960,1245,214,4268,1110,525,929,109,-627,723,-2699,-176,499,2620
163,05000US05105,"Perry County, Arkansas",179,169,143,59,143,246,380,670,605,1375,185,435,59,4,1730,730,325,330,-6,84,198,-1104,-60,280,1045
164,05000US05107,"Phillips County, Arkansas",1090,1023,781,418,789,290,473,579,459,1989,890,1315,1620,269,2630,815,159,349,200,-839,938,-1867,-236,300,1640
165,05000US05109,"Pike County, Arkansas",198,225,299,80,203,231,387,605,520,1772,315,410,240,14,1945,750,254,538,-117,59,269,-1327,-145,266,1234
166,05000US05111,"Poinsett County, Arkansas",706,745,692,343,864,364,565,940,964,3590,890,990,1360,99,3720,1610,460,525,-184,-668,1108,-2791,-670,504,3065
167,05000US05113,"Polk County, Arkansas",338,348,635,137,444,574,844,1204,1013,2794,525,595,665,115,2975,1510,545,1305,-187,-30,466,-1557,-306,468,1489
168,05000US05115,"Pope County, Arkansas",1810,1270,1815,723,2004,910,1505,2360,2480,9057,1170,1625,4250,585,4915,4659,2344,4010,640,-2435,2142,-2500,-2299,136,5047
169,05000US05117,"Prairie County, Arkansas",299,155,198,118,368,194,268,474,448,1544,400,325,415,4,1835,545,254,180,-101,-217,482,-1373,-71,194,1364
170,05000US05119,"Pulaski County, Arkansas",14995,11220,14050,7515,16140,7058,8139,12383,10748,55025,7365,16440,32935,7190,34385,29645,10449,20395,7630,-18885,16465,-19188,-17262,299,34630
171,05000US05121,"Randolph County, Arkansas",619,458,313,241,425,368,498,932,819,2944,390,750,810,110,2784,1190,390,964,229,-497,556,-1918,-258,429,1980
172,05000US05123,"St. Francis County, Arkansas",1189,700,760,179,1029,371,714,759,638,2909,980,900,1795,189,3874,965,244,570,209,-1035,1019,-2789,-206,394,2339
173,05000US05125,"Saline County, Arkansas",1329,1630,2745,1135,3050,1775,2330,5515,4745,20379,1410,3160,4630,685,11710,12115,3805,6555,-81,-1885,3500,-7605,-6600,940,13824
174,05000US05127,"Scott County, Arkansas",278,260,195,127,178,279,319,440,524,1560,345,450,215,29,1740,519,270,510,-67,-20,276,-1142,-79,254,1050
175,05000US05129,"Searcy County, Arkansas",209,164,86,62,154,263,332,370,524,1259,225,260,159,45,1249,635,215,604,-16,-73,171,-654,-265,309,655
176,05000US05131,"Sebastian County, Arkansas",4244,4005,3824,2110,6089,1614,2365,4592,3443,18634,1980,4850,10945,2465,10190,8950,3890,7730,2264,-7121,5734,-6211,-4358,-447,10904
177,05000US05133,"Sevier County, Arkansas",299,258,318,114,495,379,478,629,539,2648,435,550,474,25,2555,894,404,670,-136,-156,584,-1698,-265,135,1978
178,05000US05135,"Sharp County, Arkansas",488,414,528,135,367,415,709,1129,657,2669,390,720,780,40,3054,1104,470,915,98,-252,462,-1930,25,187,1754
179,05000US05137,"Stone County, Arkansas",209,380,145,165,225,279,645,725,595,1770,340,205,490,85,1580,610,374,1240,-131,-345,305,-656,115,221,530
180,05000US05139,"Union County, Arkansas",1068,840,875,360,1164,1255,1094,1583,1543,6840,845,965,1945,544,6620,2285,1099,2039,223,-1070,980,-4271,-702,444,4801
181,05000US05141,"Van Buren County, Arkansas",428,348,404,188,225,434,523,922,895,2687,544,345,550,139,2350,1189,535,1484,-116,-146,274,-1393,-267,360,1203
182,05000US05143,"Washington County, Arkansas",9090,7300,10064,4770,8190,3040,3640,6000,6130,27344,3885,16290,16400,2850,12290,16250,5450,11680,5205,-6336,10110,-5610,-10250,680,15664
183,05000US05145,"White County, Arkansas",1980,2090,1855,880,2780,1349,1774,3035,2485,11684,1710,2365,4530,985,8054,4969,2994,3970,270,-2675,2675,-4931,-1934,-509,7714
184,05000US05147,"Woodruff County, Arkansas",323,329,134,35,177,164,233,279,249,1005,275,365,329,10,1275,325,115,170,48,-195,202,-878,-46,134,835
185,05000US05149,"Yell County, Arkansas",517,288,604,233,548,274,445,1025,830,3060,565,600,770,260,2365,1110,725,1330,-48,-166,521,-1646,-85,105,1730
186,05000US06001,"Alameda County, California",67065,40385,38270,26855,94830,21315,23449,27839,27513,204910,29365,40060,83385,114595,16965,9930,13250,263485,37700,-45115,7090,27799,17909,14263,-58575
187,05000US06003,"Alpine County, California",10,20,12,12,16,36,22,35,27,151,19,8,14,14,24,19,34,205,-9,-2,14,34,16,-7,-54
188,05000US06005,"Amador County, California",574,835,633,215,1019,732,1020,1579,1594,6404,360,280,1935,695,1469,1275,1594,6843,214,-1302,539,283,304,0,-439
189,05000US06007,"Butte County, California",8450,6109,7625,3590,9545,3742,4865,6638,6668,30545,2695,3440,16990,12200,8005,7085,6750,29850,5755,-9365,935,602,-447,-82,695
190,05000US06009,"Calaveras County, California",810,689,1020,250,1120,1225,1574,2330,1729,7594,565,545,1695,1085,2000,2130,1920,8180,245,-675,285,799,200,-191,-586
191,05000US06011,"Colusa County, California",424,437,504,289,863,259,309,616,516,2857,290,520,1210,499,643,883,800,2288,134,-706,653,-75,-267,-284,569
192,05000US06013,"Contra Costa County, California",33385,21890,19750,14094,45270,19014,22024,27195,25070,164488,13540,20790,46195,53865,21620,20130,25325,190370,19845,-26445,5499,19418,7065,-255,-25882
193,05000US06015,"Del Norte County, California",1035,680,538,391,1042,774,694,1034,930,2980,530,690,1775,695,1780,934,980,2520,505,-1237,738,-312,100,-50,460
194,05000US06017,"El Dorado County, California",3380,3070,3370,1555,4765,3693,4175,6724,5418,33319,2095,2840,7055,4140,4020,3955,4610,40070,1285,-3685,2180,3848,2769,808,-6751
195,05000US06019,"Fresno County, California",35655,27170,27830,12654,38525,8823,12994,21305,17984,102293,13115,17745,67410,43555,23790,33115,26005,78979,22540,-39580,7624,-1973,-11810,-8021,23314
196,05000US06021,"Glenn County, California",1154,799,704,454,1080,456,628,856,858,3188,755,945,1935,569,835,1065,1210,2610,399,-1231,965,249,-209,-352,578
197,05000US06023,"Humboldt County, California",5069,4660,5315,2290,6135,2134,2899,4323,4434,17737,2385,2435,10410,8230,3339,1663,3170,22840,2684,-5095,195,1694,2660,1264,-5103
198,05000US06025,"Imperial County, California",5590,4145,3690,1448,4825,2235,2420,4019,3064,14739,3155,3910,9160,3475,6418,7835,4690,7130,2435,-5470,2798,-1763,-3816,-1626,7609
199,05000US06027,"Inyo County, California",376,524,767,244,988,373,528,803,722,2830,445,765,1245,460,1660,515,410,2599,-69,-478,772,-759,288,312,231
200,05000US06029,"Kern County, California",25390,20605,22670,11425,33350,9529,12929,22532,17214,93975,9135,16145,54680,33470,32185,36105,26245,60040,16255,-32010,11305,-9727,-13573,-9031,33935
201,05000US06031,"Kings County, California",3868,3495,4700,2179,6175,1199,1634,2869,2314,14042,2355,2985,9495,5590,4069,5870,4404,7944,1513,-4795,2764,-1236,-3001,-2090,6098
202,05000US06033,"Lake County, California",2365,1770,2029,654,2169,1930,2219,2785,2465,8990,1355,1335,3580,2705,4575,3410,2355,7765,1010,-1551,118,-426,-625,110,1225
203,05000US06035,"Lassen County, California",745,480,547,425,997,480,499,979,804,3848,550,685,1415,560,1740,1695,1030,2068,195,-868,862,-761,-716,-226,1780
204,05000US06037,"Los Angeles County, California",504295,329355,340385,162635,446185,136770,152700,237910,185780,835015,150025,229100,832585,571130,95555,106825,125940,1200120,354270,-492200,37690,193915,131085,59840,-365105
205,05000US06039,"Madera County, California",3834,3615,3775,1629,3900,2039,2145,4250,3790,16680,2340,1890,7965,4575,4080,5685,4795,13640,1494,-4190,954,104,-1435,-1005,3040
206,05000US06041,"Marin County, California",9775,6019,6605,3755,11408,5849,5730,8488,7294,41605,4775,4415,16475,11875,3045,2614,2075,59945,5000,-9870,3288,8534,5874,5219,-18340
207,05000US06043,"Mariposa County, California",530,419,269,293,659,429,473,729,660,3155,475,355,880,469,675,755,815,3289,55,-611,483,227,-26,-155,-134
208,05000US06045,"Mendocino County, California",3140,2835,2755,1360,3849,1554,1839,2975,2585,12325,2465,1480,4365,5635,2894,905,1470,15229,675,-1610,-426,499,2070,1115,-2904
209,05000US06047,"Merced County, California",8590,6864,8340,4470,9810,2484,3738,6853,5455,23804,4920,5705,19080,8345,7365,10600,6345,17390,3670,-10740,5935,-1143,-3747,-890,6414
210,05000US06049,"Modoc County, California",290,139,228,60,254,228,415,544,434,1225,200,330,438,10,1070,605,409,785,90,-210,304,-427,-61,25,440
211,05000US06051,"Mono County, California",109,191,580,335,929,208,173,380,291,1669,384,295,1000,474,315,390,415,1789,-275,-420,790,66,-10,-124,-120
212,05000US06053,"Monterey County, California",9520,10860,14590,6865,20225,3671,4789,8568,7608,40600,4135,4615,21805,31515,5135,3725,4530,51500,5385,-7215,-4425,3325,4843,3078,-10900
213,05000US06055,"Napa County, California",3080,3365,3290,1975,6375,2015,2479,3892,3944,19669,1935,1670,6435,8055,2935,1189,1579,25540,1145,-3145,295,1559,2703,2365,-5871
214,05000US06057,"Nevada County, California",2184,1910,1774,1240,3299,2045,3028,4267,3829,17785,1275,765,4105,4270,2469,1405,2330,24310,909,-2331,269,2604,2862,1499,-6525
215,05000US06059,"Orange County, California",103550,75780,90390,45900,120790,48870,52675,87965,73790,340590,30435,32875,204820,168295,37110,26315,40160,490010,73115,-114430,-1605,64435,61650,33630,-149420
216,05000US06061,"Placer County, California",7565,5100,7930,4485,15340,6054,6519,10507,10188,66702,2870,3265,15595,18680,5390,5845,8820,79540,4695,-7665,1145,7183,4662,1368,-12838
217,05000US06063,"Plumas County, California",595,550,325,252,539,390,513,1025,869,3665,370,505,1160,235,905,1250,825,3315,225,-835,556,-2,-225,44,350
218,05000US06065,"Riverside County, California",48390,41555,50675,26015,82285,32309,37169,66080,55130,283545,17725,19275,84355,127580,55485,60059,49584,306920,30665,-33680,-19280,13993,6021,5546,-23375
219,05000US06067,"Sacramento County, California",60280,41640,47145,24410,63280,20129,24913,42240,36750,177735,18855,38115,129795,50010,34340,56625,52065,156145,41425,-82650,37680,10702,-14385,-15315,21590
220,05000US06069,"San Benito County, California",1089,1293,1103,994,1865,488,624,1509,1289,7384,785,940,2425,2170,610,574,665,9298,304,-1322,689,502,935,624,-1914
221,05000US06071,"San Bernardino County, California",55350,42240,49970,26075,80670,25443,31433,52019,45235,224295,18025,21830,104045,110420,52440,59719,43095,221175,37325,-54075,-3675,4436,-7700,2140,3120
222,05000US06073,"San Diego County, California",110835,89670,105500,56800,159790,44225,47220,80675,68340,361805,37600,43705,218680,222615,43135,29259,47770,475470,73235,-113180,-6025,48310,51416,20570,-113665
223,05000US06075,"San Francisco County, California",60795,25280,29620,17645,91630,13440,12026,18825,15679,77720,43640,38955,62910,79455,4420,3130,3054,124350,17155,-33290,29820,21046,15695,12625,-46630
224,05000US06077,"San Joaquin County, California",19090,18275,19330,10325,32065,7158,8498,15112,13422,83260,7665,8115,43190,40100,14340,18485,14308,78810,11425,-23860,2290,1316,-3373,-886,4450
225,05000US06079,"San Luis Obispo County, California",9575,6190,8895,4175,13174,4274,4983,8110,7430,39614,3805,3750,18070,16370,4365,2460,2980,54080,5770,-9175,979,4892,5650,4450,-14466
226,05000US06081,"San Mateo County, California",21305,16825,20244,11509,35520,13404,13163,22090,19169,92445,8320,12085,43620,41380,6125,3384,3395,144479,12985,-23376,5649,20442,18706,15774,-52034
227,05000US06083,"Santa Barbara County, California",14140,11535,14910,6765,21360,5067,5804,10459,8863,47314,5620,6840,21255,34995,5875,6660,6974,56635,8520,-6345,-6870,4996,3799,1889,-9321
228,05000US06085,"Santa Clara County, California",59675,38735,36000,24470,112720,30155,29030,35325,33775,234260,26730,31535,77615,135710,22510,7809,10425,319720,32945,-41615,1480,36675,27516,23350,-85460
229,05000US06087,"Santa Cruz County, California",11175,7145,7230,3435,9555,4434,5023,7908,7140,33963,4465,5150,13990,14945,3415,2614,2550,48820,6710,-6760,-1955,6042,5294,4590,-14857
230,05000US06089,"Shasta County, California",5795,4585,6125,2535,7365,3164,3679,6705,5539,26670,2100,2985,11965,9335,6045,6923,7600,24255,3695,-5840,565,798,-218,-2061,2415
231,05000US06091,"Sierra County, California",48,50,62,8,73,165,83,128,122,424,14,49,139,35,370,160,75,360,34,-77,46,-122,-32,47,64
232,05000US06093,"Siskiyou County, California",1579,1460,1399,622,1524,1190,1258,2268,1863,6569,1205,1380,2950,1035,2675,2854,2174,5015,374,-1551,1111,-227,-586,-311,1554
233,05000US06095,"Solano County, California",11600,8790,11389,6310,20885,4748,6219,11544,9964,57803,4635,4655,23550,26140,8710,11360,12865,56130,6965,-12161,1055,2257,184,-2901,1673
234,05000US06097,"Sonoma County, California",13385,10655,15905,8935,26570,6924,8083,14284,12954,75335,7190,5090,24735,38430,9545,3495,4530,98115,6195,-8830,-2925,5462,10789,8424,-22780
235,05000US06099,"Stanislaus County, California",14110,12870,15645,7354,23550,5220,6690,13268,10528,63823,6640,5840,34380,26680,11930,15745,16164,55200,7470,-18735,4224,-20,-2477,-5636,8623
236,05000US06101,"Sutter County, California",2255,2515,3185,1719,4155,1024,1303,2221,1825,12414,1060,1450,6550,4765,2355,3380,2992,9970,1195,-3365,1109,-28,-1159,-1167,2444
237,05000US06103,"Tehama County, California",1990,1910,1710,494,1693,1038,2000,2385,2400,8660,1145,1580,3975,1085,3045,3465,2900,6825,845,-2265,1102,-7,-1080,-500,1835
238,05000US06105,"Trinity County, California",555,473,303,191,182,399,461,603,449,1982,305,345,835,220,445,409,355,2663,250,-532,153,415,194,94,-681
239,05000US06107,"Tulare County, California",14945,12430,12700,4960,14110,5989,7734,12314,9365,42384,6590,11725,27825,13030,15255,20829,14140,26900,8355,-15125,6040,-1532,-8515,-4775,15484
240,05000US06109,"Tuolumne County, California",1430,949,1480,730,2220,1263,1174,2025,1945,9592,845,855,3370,1735,1840,1285,2309,10448,585,-1890,1215,597,740,-364,-856
241,05000US06111,"Ventura County, California",19960,17340,21469,10335,30244,11139,14368,23860,20329,105094,9335,8410,37275,44340,10855,8615,13820,138820,10625,-15806,-3761,14652,15245,6509,-33726
242,05000US06113,"Yolo County, California",10715,5705,6910,3495,8205,2567,2710,4510,4123,24631,3715,5835,15355,10130,3749,4150,4924,25464,7000,-8445,1570,1528,360,-801,-833
243,05000US06115,"Yuba County, California",2205,2115,2219,1213,3035,999,954,2085,1980,9619,1235,1340,4845,3390,2808,3168,2259,7020,970,-2626,858,-855,-1083,-279,2599
244,05000US08001,"Adams County, Colorado",11714,10599,14785,7100,13105,7532,10045,17779,14935,57134,3985,12115,30140,11050,19685,35120,21444,29960,7729,-15355,9155,-2108,-17341,-6509,27174
245,05000US08003,"Alamosa County, Colorado",1019,413,493,188,499,364,570,612,402,1472,645,1010,840,109,1115,1265,539,530,374,-347,578,-181,-653,-137,942
246,05000US08005,"Arapahoe County, Colorado",16675,14990,21320,10444,24440,7788,10155,20489,18029,93135,5225,11805,48230,22615,15659,37970,28295,66430,11450,-26910,12269,2284,-17481,-10266,26705
247,05000US08007,"Archuleta County, Colorado",150,424,270,160,469,279,544,705,614,2090,180,275,695,324,518,665,505,2639,-30,-425,305,305,40,109,-549
248,05000US08009,"Baca County, Colorado",95,94,87,68,104,165,188,283,156,436,260,134,50,12,860,164,50,117,-165,37,160,-507,119,106,319
249,05000US08011,"Bent County, Colorado",251,132,133,29,102,137,175,273,252,388,165,355,145,0,930,90,50,144,86,-12,131,-618,183,202,244
250,05000US08013,"Boulder County, Colorado",14375,8700,6138,4125,13885,6015,6725,5954,7035,52025,5065,11545,14620,15990,8050,7115,9805,53395,9310,-8482,2020,4690,-1161,-2770,-1370
251,05000US08014,"Broomfield County, Colorado",1140,1017,1770,1070,3615,698,1078,1913,1819,11879,430,640,3000,4560,904,2784,2710,10950,710,-1230,125,872,-871,-891,929
252,05000US08015,"Chaffee County, Colorado",324,309,564,153,460,493,533,919,709,3694,240,600,650,320,510,505,705,4595,84,-86,293,516,414,4,-901
253,05000US08017,"Cheyenne County, Colorado",36,27,59,30,57,57,50,105,72,328,89,85,19,4,350,113,50,60,-53,40,83,-243,-8,22,268
254,05000US08019,"Clear Creek County, Colorado",203,174,239,77,298,257,174,739,634,1868,190,440,280,90,418,599,565,1828,13,-41,285,13,140,69,40
255,05000US08021,"Conejos County, Colorado",236,186,109,67,73,343,402,448,383,934,350,220,90,4,1198,714,123,328,-114,19,136,-453,-266,260,606
256,05000US08023,"Costilla County, Colorado",190,142,53,20,33,191,174,254,241,343,220,159,70,0,529,260,100,220,-30,-17,53,-164,-6,141,123
257,05000US08025,"Crowley County, Colorado",71,79,65,52,62,173,98,223,242,273,69,93,120,39,660,165,39,63,2,-55,75,-389,58,203,210
258,05000US08027,"Custer County, Colorado",95,72,133,10,83,244,132,293,234,753,50,189,124,15,261,290,230,1135,45,9,78,115,3,4,-382
259,05000US08029,"Delta County, Colorado",1004,785,669,283,760,895,808,1819,1269,4233,635,900,1645,334,1615,2220,1245,3750,369,-976,709,88,-401,24,483
260,05000US08031,"Denver County, Colorado",35305,21680,28143,14895,43364,10195,12755,20755,16790,86310,16105,25390,61255,40625,15860,30435,18595,80300,19200,-33112,17634,7090,-9680,-1805,6010
261,05000US08033,"Dolores County, Colorado",27,34,39,8,48,69,80,131,97,217,49,50,44,0,289,90,59,150,-22,-5,56,-140,41,38,67
262,05000US08035,"Douglas County, Colorado",2090,2338,3499,3094,12325,3048,3553,7074,7029,70179,1155,890,7490,13830,2340,7790,12760,68214,935,-3991,1589,4261,-716,-5731,1965
263,05000US08037,"Eagle County, Colorado",633,893,1259,698,1760,527,789,1604,1369,8559,439,955,2460,1400,1270,1340,1068,9080,194,-1201,1058,46,264,301,-521
264,05000US08039,"Elbert County, Colorado",161,138,223,84,282,494,489,1034,797,5263,253,250,220,183,783,965,1014,5322,-92,3,183,200,69,-217,-59
265,05000US08041,"El Paso County, Colorado",17685,17240,21855,10965,24040,9999,11765,23139,19848,96039,5875,22565,47770,15555,21325,55225,29955,53429,11810,-25915,19450,439,-32086,-10107,42610
266,05000US08043,"Fremont County, Colorado",1132,898,783,455,920,1030,1323,2639,1985,6197,735,1265,1945,264,3290,4459,1670,3384,397,-1162,1111,-937,-1820,315,2813
267,05000US08045,"Garfield County, Colorado",1144,840,1520,1010,2620,680,1015,1950,1494,8813,560,1075,3040,2470,1965,1500,1605,9085,584,-1520,1160,-270,450,-111,-272
268,05000US08047,"Gilpin County, Colorado",85,75,118,80,180,102,183,300,240,1205,80,85,280,90,280,343,350,1190,5,-162,170,5,-43,-110,15
269,05000US08049,"Grand County, Colorado",273,254,417,213,624,278,402,403,420,2436,265,305,985,220,470,770,664,2244,8,-568,617,210,-367,-244,192
270,05000US08051,"Gunnison County, Colorado",394,578,653,299,755,319,339,301,431,2473,250,655,1190,595,389,439,418,2749,144,-537,459,269,-138,13,-276
271,05000US08053,"Hinsdale County, Colorado",12,38,23,18,22,26,30,47,26,140,20,65,24,0,33,14,23,224,-8,-1,40,23,33,3,-84
272,05000US08055,"Huerfano County, Colorado",224,258,272,27,105,257,302,448,422,948,290,340,244,20,1039,583,165,685,-66,28,112,-480,-135,257,263
273,05000US08057,"Jackson County, Colorado",44,18,43,25,57,28,45,54,76,193,100,55,23,0,149,74,78,143,-56,20,82,-76,-20,-2,50
274,05000US08059,"Jefferson County, Colorado",12105,11435,15955,8170,18855,8779,9788,21645,19785,104650,4365,11975,33975,16220,9570,32335,29944,90385,7740,-18020,10805,8997,-10690,-10159,14265
275,05000US08061,"Kiowa County, Colorado",28,14,52,23,33,59,64,115,98,170,57,60,14,8,320,67,14,58,-29,38,48,-197,48,84,112
276,05000US08063,"Kit Carson County, Colorado",138,244,284,82,155,176,210,425,379,1115,305,290,255,50,975,484,205,448,-167,29,187,-589,-59,174,667
277,05000US08065,"Lake County, Colorado",140,365,224,250,419,145,119,380,320,1114,115,475,665,155,455,404,360,689,25,-441,514,-191,-24,-40,425
278,05000US08067,"La Plata County, Colorado",1510,939,1714,898,1885,960,1247,2188,2174,8810,905,1660,2620,1755,1900,1650,1659,10135,605,-906,1028,307,538,515,-1325
279,05000US08069,"Larimer County, Colorado",10770,9525,10240,5040,10320,5115,6639,12127,10473,51719,4360,9915,23280,8330,7005,18600,16115,43940,6410,-13040,7030,4749,-6473,-5642,7779
280,05000US08071,"Las Animas County, Colorado",634,505,379,189,445,434,492,782,670,1923,665,645,755,94,1520,1129,460,1155,-31,-376,540,-594,-347,210,768
281,05000US08073,"Lincoln County, Colorado",109,102,92,72,83,113,95,204,165,553,120,145,130,59,450,279,105,189,-11,-38,96,-242,-75,60,364
282,05000US08075,"Logan County, Colorado",863,565,674,192,820,460,418,832,855,2677,480,1105,1205,305,1779,1688,770,939,383,-531,707,-901,-856,85,1738
283,05000US08077,"Mesa County, Colorado",5160,3640,3660,1913,5620,2687,3194,6164,5500,24545,2540,4110,9385,3975,5435,11285,7720,16765,2620,-5725,3558,446,-5121,-2220,7780
284,05000US08079,"Mineral County, Colorado",12,19,24,0,8,18,44,56,56,176,14,35,0,4,48,52,50,219,-2,24,4,14,4,6,-43
285,05000US08081,"Moffat County, Colorado",394,290,320,64,470,263,345,710,519,1920,335,660,390,150,1190,1244,525,770,59,-70,384,-582,-534,-6,1150
286,05000US08083,"Montezuma County, Colorado",665,635,699,350,774,720,889,1209,1034,3769,810,905,1145,275,1650,1764,990,3220,-145,-446,849,-41,-555,44,549
287,05000US08085,"Montrose County, Colorado",1064,1159,1190,487,1320,1065,1529,1879,1909,5835,1070,1475,2220,454,2390,2705,1920,4985,-6,-1030,1353,204,-826,-11,850
288,05000US08087,"Morgan County, Colorado",637,604,990,499,1050,306,518,1320,1084,3817,700,1325,1385,395,2104,1965,1033,1784,-63,-395,1154,-1280,-645,51,2033
289,05000US08089,"Otero County, Colorado",954,638,505,204,390,677,703,834,929,1966,620,1040,895,115,3143,833,363,500,334,-390,479,-1763,1,566,1466
290,05000US08091,"Ouray County, Colorado",130,62,190,64,234,187,106,167,157,891,80,124,295,165,125,83,142,1232,50,-105,133,168,84,15,-341
291,05000US08093,"Park County, Colorado",218,423,318,99,330,605,615,1195,699,3048,159,475,564,185,700,1825,1200,2454,59,-246,244,520,-630,-501,594
292,05000US08095,"Phillips County, Colorado",103,54,124,33,228,97,123,195,275,573,155,260,119,14,535,270,120,289,-52,5,247,-315,-75,155,284
293,05000US08097,"Pitkin County, Colorado",220,540,735,323,754,474,304,670,714,2743,300,630,905,745,424,680,395,3355,-80,-170,332,354,-10,319,-612
294,05000US08099,"Prowers County, Colorado",568,359,394,122,273,322,281,601,488,1547,425,810,365,115,2015,645,285,338,143,29,280,-1412,-44,203,1209
295,05000US08101,"Pueblo County, Colorado",6910,4795,5075,1864,4729,3284,3699,7373,5860,21406,3415,7015,10370,2585,14084,13659,5383,7660,3495,-5295,4008,-7101,-6286,477,13746
296,05000US08103,"Rio Blanco County, Colorado",213,113,164,85,167,156,136,213,188,957,225,375,113,39,465,525,310,455,-12,51,213,-173,-312,-122,502
297,05000US08105,"Rio Grande County, Colorado",603,207,424,134,234,367,290,690,625,1356,615,675,265,50,1240,673,314,985,-12,159,318,-583,17,311,371
298,05000US08107,"Routt County, Colorado",539,502,574,288,1105,639,555,920,1029,3558,435,405,1320,855,1050,688,394,4635,104,-746,538,144,232,635,-1077
299,05000US08109,"Saguache County, Colorado",202,146,203,112,94,279,299,409,256,678,260,315,189,15,735,434,164,612,-58,14,191,-157,-25,92,66
300,05000US08111,"San Juan County, Colorado",4,4,29,16,27,8,42,26,16,81,4,8,62,10,23,44,10,119,0,-33,33,27,-18,6,-38
301,05000US08113,"San Miguel County, Colorado",197,242,273,194,438,170,180,273,210,1126,83,130,650,470,127,178,158,1605,114,-377,162,223,95,52,-479
302,05000US08115,"Sedgwick County, Colorado",111,48,38,22,84,72,95,119,112,371,103,128,54,4,463,139,74,58,8,-16,102,-296,-20,38,313
303,05000US08117,"Summit County, Colorado",430,423,755,540,1020,438,540,909,684,3895,325,315,1435,1085,169,505,648,5250,105,-680,475,809,404,36,-1355
304,05000US08119,"Teller County, Colorado",386,389,464,189,500,652,483,1285,1255,4797,200,460,955,324,1015,2087,1545,3885,186,-491,365,120,-802,-290,912
305,05000US08121,"Washington County, Colorado",73,116,202,74,129,94,157,214,210,832,210,205,138,19,720,354,164,249,-137,64,184,-469,-140,46,583
306,05000US08123,"Weld County, Colorado",5585,5089,6745,3064,7895,3634,4978,8893,7974,47329,4130,6260,12200,5780,10210,16370,11725,33700,1455,-5455,5179,-1598,-7477,-3751,13629
307,05000US08125,"Yuma County, Colorado",295,354,397,144,353,195,251,347,394,1328,460,640,389,50,884,615,259,773,-165,8,447,-438,-268,135,555
308,05000US09001,"Fairfield County, Connecticut",35210,20910,12620,9630,30650,17285,20910,18130,20190,153644,18120,24310,31135,35445,26790,25260,31505,149425,17090,-18515,4835,11405,-7130,-11315,4219
309,05000US09003,"Hartford County, Connecticut",40745,23650,21624,12025,25465,13600,20134,28745,26308,140484,23150,41680,48005,10654,55760,74040,42860,56505,17595,-26381,26836,-22026,-45295,-16552,83979
310,05000US09005,"Litchfield County, Connecticut",4400,3504,3830,1779,3770,3778,5141,7332,7352,34334,2850,7560,5735,1140,14270,15754,10155,18335,1550,-1905,4409,-5351,-8422,-2803,15999
311,05000US09007,"Middlesex County, Connecticut",4830,2775,3685,1959,4285,3257,4075,4889,4869,32389,3240,5040,7025,2205,7035,13005,11310,19140,1590,-3340,4039,297,-8116,-6441,13249
312,05000US09009,"New Haven County, Connecticut",40920,24144,22720,10985,24610,14200,18405,28000,25555,122365,21300,33975,51110,16985,51920,57190,38390,60360,19620,-28390,18610,-19315,-29190,-12835,62005
313,05000US09011,"New London County, Connecticut",10105,6850,6910,4115,7785,5079,6360,9190,9330,42290,6300,12225,14325,2905,18425,22910,13740,18280,3805,-7415,8995,-6986,-13720,-4410,24010
314,05000US09013,"Tolland County, Connecticut",3855,2895,2905,1570,3940,1964,2934,4425,4770,26239,1885,4800,5935,2540,7615,14250,7970,10369,1970,-3030,2970,-2717,-9825,-3200,15870
315,05000US09015,"Windham County, Connecticut",4454,3044,2590,1230,2065,1915,2888,5334,4770,17195,3215,5245,4525,399,7815,14085,4929,4919,1239,-1935,2896,-3012,-8751,-159,12276
316,05000US10001,"Kent County, Delaware",3510,3365,3700,2269,6405,2910,3355,6017,5528,27559,2465,1960,8980,5840,7809,9814,9950,17652,1045,-5280,2834,-1544,-3797,-4422,9907
317,05000US10003,"New Castle County, Delaware",16140,10850,13650,6640,16775,10794,11640,20647,18232,81017,6790,12965,37060,7230,23670,48830,27375,40995,9350,-23410,16185,-1236,-28183,-9143,40022
318,05000US10005,"Sussex County, Delaware",3359,3120,4065,1870,5555,4767,6036,10909,9408,38903,3610,3355,7905,3115,12713,13875,9640,34140,-251,-3840,4310,-1910,-2966,-232,4763
319,05000US11001,"District of Columbia, District of Columbia",52450,20914,11815,12149,64860,10110,7940,5749,7274,84630,29480,34955,21195,76560,8234,5175,9885,94380,22970,-9380,449,9816,574,-2611,-9750
320,05000US12001,"Alachua County, Florida",14719,7640,8434,3955,10485,4420,4487,7247,6512,31638,5050,8105,23415,8670,16810,16510,6735,13740,9669,-14981,5770,-7903,-9263,-223,17898
321,05000US12003,"Baker County, Florida",464,249,455,228,465,398,740,949,1130,3749,565,580,650,60,3038,1420,864,1149,-101,-195,633,-1900,-471,266,2600
322,05000US12005,"Bay County, Florida",4780,4000,5370,2649,8985,3012,3282,6624,6079,25440,2125,2750,12665,8255,12320,10709,7135,14000,2655,-7295,3379,-6026,-4085,-1056,11440
323,05000US12007,"Bradford County, Florida",770,321,492,204,814,715,744,774,768,3449,600,590,1055,350,3330,1535,453,1154,170,-563,668,-1871,-761,315,2295
324,05000US12009,"Brevard County, Florida",11730,11265,13150,7025,20475,12169,14130,26114,21684,94825,5700,6865,34690,16410,51595,39790,23670,51270,6030,-21540,11090,-25296,-13676,-1986,43555
325,05000US12011,"Broward County, Florida",53185,44730,57705,27750,71670,45295,45419,67280,55140,220680,15915,13640,118205,107290,110415,97795,49875,171800,37270,-60500,-7870,-19701,-30515,5265,48880
326,05000US12013,"Calhoun County, Florida",141,107,158,110,245,360,474,779,623,1815,195,230,250,69,2019,1015,350,610,-54,-92,286,-1185,-236,273,1205
327,05000US12015,"Charlotte County, Florida",2320,2795,3795,2130,5265,3709,4799,9215,8304,34540,1555,1210,7190,6345,13480,13790,7860,25355,765,-3395,1050,-4972,-4575,444,9185
328,05000US12017,"Citrus County, Florida",2510,2275,2110,1170,3880,3785,4970,8920,7860,27630,1360,1190,6015,3365,17605,13165,6895,14580,1150,-3905,1685,-8850,-4245,965,13050
329,05000US12019,"Clay County, Florida",2719,3089,3724,2288,6580,3583,4454,7889,7364,31322,1700,2440,10840,3435,18080,19110,7585,9654,1019,-7116,5433,-10043,-11221,-221,21668
330,05000US12021,"Collier County, Florida",6070,7035,8340,4950,12125,6779,7765,15675,13795,60414,3870,3080,18275,13275,12400,13500,11125,65440,2200,-9935,3800,2144,2175,2670,-5026
331,05000US12023,"Columbia County, Florida",1260,1300,1120,705,2279,1705,1650,3279,2870,9769,995,1235,3645,800,7949,4575,1820,4225,265,-2525,2184,-4594,-1296,1050,5544
332,05000US12027,"DeSoto County, Florida",730,720,1015,214,970,510,1119,1379,1245,4256,585,855,1725,495,4220,1535,497,2035,145,-710,689,-2591,-156,748,2221
333,05000US12029,"Dixie County, Florida",349,264,262,195,355,500,489,1054,934,2448,440,284,564,119,3025,990,259,969,-91,-302,431,-2036,64,675,1479
334,05000US12031,"Duval County, Florida",31645,24045,34030,15935,41460,16235,15975,31939,26284,115740,14250,22760,78680,31420,79295,56940,24535,44975,17395,-44650,25975,-47085,-25001,1749,70765
335,05000US12033,"Escambia County, Florida",7594,7994,11755,5540,13165,5128,5782,13044,11948,39309,4370,8555,26240,6880,32970,22440,6439,11465,3224,-14485,11825,-22060,-9396,5509,27844
336,05000US12035,"Flagler County, Florida",1175,1265,2389,987,3239,2092,2744,4854,4550,17443,845,570,4315,3325,4644,8285,6365,11899,330,-1926,901,192,-3431,-1815,5544
337,05000US12037,"Franklin County, Florida",279,138,149,159,418,223,299,499,439,1849,255,180,415,305,919,739,290,1345,24,-266,272,-397,-240,149,504
338,05000US12039,"Gadsden County, Florida",1909,1159,1210,235,640,1243,1464,2620,1935,5510,1845,1945,1150,220,6800,2995,1040,1460,64,60,655,-4093,-375,895,4050
339,05000US12041,"Gilchrist County, Florida",369,250,253,59,238,578,819,954,945,2259,360,525,228,59,3160,1230,475,475,9,25,238,-1763,-276,470,1784
340,05000US12043,"Glades County, Florida",207,196,206,98,358,328,272,644,679,1588,150,149,550,230,1654,780,355,588,57,-344,226,-1054,-136,324,1000
341,05000US12045,"Gulf County, Florida",183,228,349,173,394,283,403,498,378,2386,280,189,400,469,1330,800,508,1639,-97,-51,98,-644,-302,-130,747
342,05000US12047,"Hamilton County, Florida",373,205,252,28,341,407,248,565,453,1747,345,350,444,59,2038,440,240,684,28,-192,310,-1383,125,213,1063
343,05000US12049,"Hardee County, Florida",359,547,649,300,594,500,470,840,972,2857,495,380,1245,315,2855,1068,369,1135,-136,-596,579,-1885,-228,603,1722
344,05000US12051,"Hendry County, Florida",720,770,990,479,1230,755,834,1393,1167,4139,840,785,1840,725,4290,1640,545,1540,-120,-850,984,-2701,-247,622,2599
345,05000US12053,"Hernando County, Florida",3040,2810,4100,1930,4165,5264,6504,11018,9644,25942,1685,2325,9860,2175,24974,17655,6563,8579,1355,-5760,3920,-13206,-6637,3081,17363
346,05000US12055,"Highlands County, Florida",1970,2070,2424,1095,2915,2131,2935,5819,5803,16059,1575,1590,4860,2435,15500,6895,3230,6609,395,-2436,1575,-10434,-1076,2573,9450
347,05000US12057,"Hillsborough County, Florida",39515,31660,41390,23025,77115,19879,22089,38174,32807,188095,14870,17435,93355,87050,74690,72635,43610,108465,24645,-51965,13090,-32722,-34461,-10803,79630
348,05000US12059,"Holmes County, Florida",378,472,294,132,264,578,663,790,728,3039,550,290,600,84,2589,1114,435,1387,-172,-306,312,-1348,-324,293,1652
349,05000US12061,"Indian River County, Florida",2070,3100,3385,1779,3658,2855,4299,7600,5940,25130,1025,1970,8125,2875,12840,9585,5620,17105,1045,-4740,2562,-5686,-1985,320,8025
350,05000US12063,"Jackson County, Florida",1359,1068,936,418,1323,852,1013,1924,1860,6698,1240,1295,2045,520,5660,2509,1069,2874,119,-1109,1221,-3795,-585,791,3824
351,05000US12065,"Jefferson County, Florida",384,343,157,78,298,360,560,824,510,2204,550,290,434,10,1955,1095,335,1074,-166,-277,366,-1035,-271,175,1130
352,05000US12067,"Lafayette County, Florida",130,79,104,4,82,160,205,354,323,975,165,63,130,53,880,340,225,415,-35,-26,33,-515,14,98,560
353,05000US12069,"Lake County, Florida",5430,5630,8110,3655,10990,6819,9078,15795,13629,52003,2930,3770,16565,10535,30695,25880,15369,24560,2500,-8455,4110,-14798,-10085,-1740,27443
354,05000US12071,"Lee County, Florida",13305,11815,16890,8605,29150,13924,14810,29080,24840,108605,5625,7665,40445,26030,45635,35640,26500,82310,7680,-23555,11725,-16901,-6560,-1660,26295
355,05000US12073,"Leon County, Florida",13940,8575,11780,5664,13275,3204,3580,6815,6599,39844,3935,7035,29965,12290,13945,18040,8640,19935,10005,-18185,6649,-7161,-11225,-2041,19909
356,05000US12075,"Levy County, Florida",799,885,733,605,940,912,1544,2101,2104,5918,1010,665,1950,340,5745,2329,1075,2943,-211,-1217,1205,-3289,-228,1029,2975
357,05000US12077,"Liberty County, Florida",80,57,229,54,170,157,198,384,329,850,205,195,175,10,1103,204,135,345,-125,54,214,-748,180,194,505
358,05000US12079,"Madison County, Florida",414,495,269,148,314,679,655,922,746,2400,435,365,730,105,2625,1064,488,1125,-21,-461,357,-1291,-142,258,1275
359,05000US12081,"Manatee County, Florida",7450,7775,8345,4534,12055,7439,9893,16090,14638,56550,2975,5280,19535,12365,30995,19135,11975,40805,4475,-11190,4224,-13663,-3045,2663,15745
360,05000US12083,"Marion County, Florida",5795,4995,6330,4080,12045,6120,9065,16269,14540,59000,3970,3565,14900,10800,36165,23545,12415,32330,1825,-8570,5325,-20980,-7276,2125,26670
361,05000US12085,"Martin County, Florida",2115,2344,2949,1484,5969,2858,4304,6730,6304,30324,1535,1025,6415,5875,10030,7455,4949,27195,580,-3466,1578,-2868,-725,1355,3129
362,05000US12086,"Miami-Dade County, Florida",120535,81430,83485,36400,88425,55725,53819,74595,58355,218684,44410,35985,176980,152895,86985,114705,62410,193140,76125,-93495,-28070,22559,-40110,-4055,25544
363,05000US12087,"Monroe County, Florida",2215,1995,2950,1348,3945,2013,1623,2669,2254,9800,1290,1070,4135,5980,1559,1745,1585,13585,925,-1185,-687,2077,924,669,-3785
364,05000US12089,"Nassau County, Florida",1223,1244,1569,875,1865,1684,1564,3375,2970,14687,695,1295,2865,1920,5870,6514,3169,8530,528,-1296,820,-2622,-3139,-199,6157
365,05000US12091,"Okaloosa County, Florida",4170,4070,6370,3430,10100,2795,3183,6364,6004,31279,2695,3295,14280,7835,9745,14505,8095,16969,1475,-7910,5695,-3767,-8141,-2091,14310
366,05000US12093,"Okeechobee County, Florida",730,475,1045,320,1134,698,909,1529,1525,5269,675,715,1420,900,4644,2300,860,2144,55,-375,554,-3037,-771,665,3125
367,05000US12095,"Orange County, Florida",35000,33225,42770,22095,72480,16609,18135,33524,28159,154750,8420,10330,87495,99340,58110,56310,39350,99605,26580,-44725,-4765,-23366,-22786,-11191,55145
368,05000US12097,"Osceola County, Florida",7510,6080,8550,4490,11474,4343,5469,10908,8734,30857,2025,1655,18785,15650,16145,18975,10615,14025,5485,-10235,314,-6333,-8067,-1881,16832
369,05000US12099,"Palm Beach County, Florida",34205,31170,35975,18465,51110,34434,39775,57834,48478,206304,13525,15535,71260,70595,89170,76515,43310,171625,20680,-35285,-1020,-14961,-18681,5168,34679
370,05000US12101,"Pasco County, Florida",9444,10110,11860,6489,17095,12008,14588,24229,21409,75499,4880,6650,27555,15900,59820,32705,19124,33624,4564,-15695,7684,-33224,-8476,2285,41875
371,05000US12103,"Pinellas County, Florida",24825,22345,29630,15285,49155,21664,25649,39790,35665,153180,10130,10270,65115,55730,78330,56530,37930,99800,14695,-35485,8710,-31017,-16740,-2265,53380
372,05000US12105,"Polk County, Florida",11995,10775,15325,8375,25410,9754,13043,23579,21494,93155,5440,6770,31130,28555,62005,35525,23270,39145,6555,-15805,5230,-39208,-11946,-1776,54010
373,05000US12107,"Putnam County, Florida",2084,1795,1514,669,1594,2130,2405,3439,2773,10249,1720,1700,2975,1225,11045,3974,1570,4665,364,-1461,1038,-6510,-535,1203,5584
374,05000US12109,"St. Johns County, Florida",2790,2820,4055,2240,7320,4144,3383,7538,7098,43880,1655,2015,8585,6985,9565,10240,10545,35050,1135,-4530,2575,-2038,-2702,-3447,8830
375,05000US12111,"St. Lucie County, Florida",5804,5780,6100,3445,9430,6980,7550,13430,11325,42865,2365,2710,12910,12570,25420,22515,12625,21025,3439,-6810,305,-10890,-9085,-1300,21840
376,05000US12113,"Santa Rosa County, Florida",2885,2480,2845,1650,5725,2679,3075,6050,5519,28944,1360,2940,7720,3550,12915,14425,6065,12670,1525,-4875,3825,-7161,-8375,-546,16274
377,05000US12115,"Sarasota County, Florida",7120,6984,9940,5690,17555,9415,12475,21550,18633,73990,3750,4155,21585,17815,27695,28185,17985,59600,3370,-11645,5430,-5805,-6635,648,14390
378,05000US12117,"Seminole County, Florida",7855,7340,10665,6625,22769,6904,6674,12544,10251,71460,3015,1745,21105,29395,21510,24255,17405,45255,4840,-10440,-1,-7932,-11711,-7154,26205
379,05000US12119,"Sumter County, Florida",940,893,1114,519,1709,3198,3498,7070,6740,27884,1130,1120,1560,1355,8350,3795,6020,30569,-190,-446,873,-1654,3275,720,-2685
380,05000US12121,"Suwannee County, Florida",1054,725,756,485,1440,875,1100,1495,1355,6240,1065,914,1970,515,5150,2055,975,2960,-11,-1214,1410,-3175,-560,380,3280
381,05000US12123,"Taylor County, Florida",285,229,205,219,600,410,560,1460,1390,2819,615,375,390,145,3060,1175,675,1170,-330,-185,674,-2090,285,715,1649
382,05000US12125,"Union County, Florida",291,174,181,237,395,213,322,380,395,1443,390,295,440,140,1230,529,379,583,-99,-259,492,-695,-149,16,860
383,05000US12127,"Volusia County, Florida",11845,10445,14715,6750,20440,10239,13133,24024,20844,83100,5015,4005,28225,26945,42595,39135,19645,48145,6830,-13510,245,-19223,-15111,1199,34955
384,05000US12129,"Wakulla County, Florida",640,190,395,123,825,550,505,1519,1164,5254,455,400,1140,175,3660,2695,1284,1605,185,-745,773,-2605,-1176,-120,3649
385,05000US12131,"Walton County, Florida",1500,1080,1195,860,2715,1574,1848,2790,2465,10129,1195,1275,2635,2225,5559,2379,2200,8410,305,-1440,1350,-2137,411,265,1719
386,05000US12133,"Washington County, Florida",447,254,379,299,424,744,699,1180,909,3523,580,344,685,200,3020,1394,595,1934,-133,-306,523,-1577,-214,314,1589
387,05000US13001,"Appling County, Georgia",495,298,389,200,510,373,658,763,833,2624,755,645,395,90,2850,880,495,589,-260,-6,620,-1819,-117,338,2035
388,05000US13003,"Atkinson County, Georgia",164,147,244,37,143,194,274,504,403,983,315,250,139,30,1415,360,60,264,-151,105,150,-947,144,343,719
389,05000US13005,"Bacon County, Georgia",235,325,279,45,290,244,359,335,270,1605,350,365,335,120,1675,455,219,465,-115,-56,215,-1072,-120,51,1140
390,05000US13007,"Baker County, Georgia",159,26,29,44,146,98,43,129,138,544,199,115,89,4,460,219,75,164,-40,-60,186,-319,-90,63,380
391,05000US13009,"Baldwin County, Georgia",2245,1750,1035,517,1780,429,765,1545,1160,5745,870,1595,3760,1105,3830,2080,910,2270,1375,-2725,1192,-2636,-535,250,3475
392,05000US13011,"Banks County, Georgia",235,342,377,273,427,425,379,774,699,2595,415,370,605,285,1695,1030,655,1475,-180,-228,415,-891,-256,44,1120
393,05000US13013,"Barrow County, Georgia",1360,1330,1475,874,1639,1450,1859,3825,2819,8549,1040,2415,2925,285,9235,6539,1014,1710,320,-1450,2228,-5926,-2714,1805,6839
394,05000US13015,"Bartow County, Georgia",2745,3060,2770,1485,2770,2460,2915,3980,3695,11675,1795,5320,5540,175,11880,7920,1740,3300,950,-2770,4080,-6505,-3940,1955,8375
395,05000US13017,"Ben Hill County, Georgia",635,523,462,165,710,580,304,633,555,1844,395,840,1100,155,2235,820,394,420,240,-638,720,-1351,-187,161,1424
396,05000US13019,"Berrien County, Georgia",615,329,419,168,685,569,500,730,829,2635,465,770,825,150,2530,1205,475,809,150,-406,703,-1461,-475,354,1826
397,05000US13021,"Bibb County, Georgia",7670,4965,4824,1929,7695,2234,2039,3639,3199,19983,3985,3965,12615,6530,11660,8695,3940,6950,3685,-7791,3094,-7387,-5056,-741,13033
398,05000US13023,"Bleckley County, Georgia",429,148,153,140,320,279,305,470,465,1679,305,380,475,20,1405,630,395,640,124,-322,440,-821,-160,70,1039
399,05000US13025,"Brantley County, Georgia",245,288,505,134,275,563,773,1135,789,2370,369,679,340,54,3375,950,300,590,-124,165,355,-2039,185,489,1780
400,05000US13027,"Brooks County, Georgia",374,284,415,158,445,488,604,775,735,2349,329,370,855,120,2274,1039,544,875,45,-440,483,-1182,-264,191,1474
401,05000US13029,"Bryan County, Georgia",875,485,680,318,1499,560,599,975,765,5704,445,685,1165,1560,2010,2185,1475,3098,430,-485,257,-851,-1210,-710,2606
402,05000US13031,"Bulloch County, Georgia",3285,2210,2519,1158,3280,879,1035,1395,1570,9733,1015,2005,5575,3880,4105,3815,2040,4474,2270,-3056,558,-2191,-2420,-470,5259
403,05000US13033,"Burke County, Georgia",890,519,434,138,496,714,720,864,634,2744,985,825,634,29,3369,1355,510,475,-95,-200,605,-1935,-491,124,2269
404,05000US13035,"Butts County, Georgia",544,564,573,274,459,370,632,1004,772,3095,315,455,1495,155,2384,1389,765,1315,229,-922,578,-1382,-385,7,1780
405,05000US13037,"Calhoun County, Georgia",221,103,127,48,104,143,192,217,223,525,335,124,129,14,944,167,70,94,-114,-2,138,-609,50,153,431
406,05000US13039,"Camden County, Georgia",1145,944,2120,825,2503,680,705,1594,1485,7268,620,1145,4435,1355,3374,3625,1740,2769,525,-2315,1973,-1989,-2031,-255,4499
407,05000US13043,"Candler County, Georgia",550,330,337,199,255,295,225,345,303,1390,265,675,535,204,1180,460,170,559,285,-198,250,-660,-115,133,831
408,05000US13045,"Carroll County, Georgia",4069,3495,3269,1420,2504,2580,3374,4960,4510,12225,2910,6685,4915,250,15600,7410,1239,2570,1159,-1646,3674,-9646,-2450,3271,9655
409,05000US13047,"Catoosa County, Georgia",1090,1305,1300,770,2130,1139,1555,2485,2585,11080,1080,1690,3260,540,5860,6605,2740,3375,10,-1960,2360,-3166,-4120,-155,7705
410,05000US13049,"Charlton County, Georgia",177,253,173,125,245,180,342,383,334,1430,350,350,260,14,1525,585,115,365,-173,-87,356,-1003,-202,219,1065
411,05000US13051,"Chatham County, Georgia",11085,7280,9165,5545,16429,3392,4654,7391,7107,37139,5810,6040,23595,14059,13955,16985,8115,20235,5275,-14430,7915,-5909,-9594,-1008,16904
412,05000US13053,"Chattahoochee County, Georgia",138,216,474,217,778,39,63,132,79,404,115,345,420,950,445,99,50,85,23,54,45,-343,33,29,319
413,05000US13055,"Chattooga County, Georgia",584,579,643,443,947,683,724,1075,854,3073,750,905,1410,114,3624,968,410,1185,-166,-767,1276,-2217,107,444,1888
414,05000US13057,"Cherokee County, Georgia",2995,3295,4245,2095,6985,4065,4060,7820,7370,41895,1590,3370,10955,3680,10380,24145,10305,19925,1405,-6710,5400,-2255,-16325,-2935,21970
415,05000US13059,"Clarke County, Georgia",9185,5060,5185,2705,6320,1132,1649,2284,1813,11332,2340,4940,15970,5215,4805,6278,2523,4820,6845,-10785,3810,-2024,-3994,-710,6512
416,05000US13061,"Clay County, Georgia",156,105,85,38,32,115,115,108,151,311,200,120,70,14,495,115,25,112,-44,15,56,-265,-7,126,199
417,05000US13063,"Clayton County, Georgia",12205,8835,11585,4700,8050,4464,5855,10210,7415,19625,2825,16660,24910,995,36915,8050,760,1359,9380,-13325,11755,-26596,2160,6655,18266
418,05000US13065,"Clinch County, Georgia",319,137,78,68,128,383,259,277,249,810,310,264,154,4,1180,200,110,350,9,-76,192,-538,77,139,460
419,05000US13067,"Cobb County, Georgia",16035,15659,20375,11830,33975,9155,11355,21074,18615,119450,4750,13145,61205,18745,37605,58105,24670,59165,11285,-40830,27060,-17095,-37031,-6055,60285
420,05000US13069,"Coffee County, Georgia",1535,638,817,474,1415,973,859,1490,1260,5080,1365,1545,1590,360,4765,1915,1030,1875,170,-773,1529,-2933,-425,230,3205
421,05000US13071,"Colquitt County, Georgia",1405,1195,1690,529,1502,604,1024,1506,1447,5149,760,2135,2585,840,4969,1774,880,1955,645,-895,1191,-3341,-268,567,3194
422,05000US13073,"Columbia County, Georgia",1005,1415,1468,1063,4859,1420,1685,3355,3340,27095,649,745,4520,3910,5895,12084,7325,11970,356,-3052,2012,-2790,-8729,-3985,15125
423,05000US13075,"Cook County, Georgia",539,225,407,122,600,353,534,749,644,2070,229,445,1020,185,2118,780,505,800,310,-613,537,-1231,-31,139,1270
424,05000US13077,"Coweta County, Georgia",3145,2395,3410,1250,3658,2579,2584,4720,4870,22685,1410,3635,7505,1310,8610,14894,5100,8340,1735,-4095,3598,-3447,-10174,-230,14345
425,05000US13079,"Crawford County, Georgia",246,168,282,113,284,387,325,523,428,2030,350,235,494,20,1735,805,480,605,-104,-212,377,-1023,-282,-52,1425
426,05000US13081,"Crisp County, Georgia",1185,785,450,296,675,428,545,869,795,2579,745,875,1595,180,2635,819,510,1124,440,-1145,791,-1662,50,285,1455
427,05000US13083,"Dade County, Georgia",354,333,410,113,283,524,520,840,670,2424,415,575,415,100,2095,1214,465,935,-61,-5,296,-1051,-374,205,1489
428,05000US13085,"Dawson County, Georgia",430,455,365,94,390,745,370,995,910,3925,275,660,640,160,1660,2145,735,2500,155,-275,324,-545,-1150,175,1425
429,05000US13087,"Decatur County, Georgia",1458,609,715,230,1129,472,680,924,729,3644,810,1160,1695,485,2504,1320,819,1570,648,-980,874,-1352,-396,-90,2074
430,05000US13089,"DeKalb County, Georgia",28200,20869,27185,13875,35570,10980,11838,20583,16698,90150,7765,20595,70550,26780,56060,33420,12055,49244,20435,-43365,22665,-33242,-12837,4643,40906
431,05000US13091,"Dodge County, Georgia",693,673,373,424,493,449,519,829,729,2979,1020,860,684,98,3184,904,460,719,-327,-311,819,-2216,-75,269,2260
432,05000US13093,"Dooly County, Georgia",573,388,443,130,325,238,363,479,514,1775,605,710,490,35,1940,659,305,465,-32,-47,420,-1339,-180,209,1310
433,05000US13095,"Dougherty County, Georgia",5075,3165,3745,1588,5539,1118,1329,1819,1690,10126,1680,3495,10730,3210,6389,4320,2010,3477,3395,-6985,3917,-3942,-2501,-320,6649
434,05000US13097,"Douglas County, Georgia",3295,2780,3630,2025,4820,2719,3010,5445,4170,17245,1265,3820,10190,1265,15770,10570,2785,3365,2030,-6560,5580,-10041,-5125,1385,13880
435,05000US13099,"Early County, Georgia",245,480,101,139,317,339,489,395,384,1298,305,365,435,185,1445,595,265,445,-60,-334,271,-617,-200,119,853
436,05000US13101,"Echols County, Georgia",60,182,145,55,118,102,134,123,108,492,59,170,295,44,675,72,30,149,1,-150,129,-439,51,78,343
437,05000US13103,"Effingham County, Georgia",795,675,1070,470,1535,589,1220,1990,1795,9705,660,865,2240,800,4510,5460,2275,2885,135,-1170,1205,-2701,-3470,-480,6820
438,05000US13105,"Elbert County, Georgia",700,550,344,129,448,404,730,890,839,2860,395,640,985,130,3055,1285,390,959,305,-641,447,-1921,-395,449,1901
439,05000US13107,"Emanuel County, Georgia",840,479,539,440,354,526,743,823,634,3040,715,780,1120,60,3164,1220,530,809,125,-581,734,-1895,-397,104,2231
440,05000US13109,"Evans County, Georgia",327,261,287,193,343,238,278,285,254,1564,335,355,630,110,1395,435,170,603,-8,-343,426,-879,-150,84,961
441,05000US13111,"Fannin County, Georgia",489,359,409,172,942,620,774,1169,1074,4595,670,330,975,384,1705,1119,974,4500,-181,-566,730,-311,50,100,95
442,05000US13113,"Fayette County, Georgia",1255,975,1344,820,3145,1430,1880,3275,3340,22645,815,755,3940,2020,3930,10390,5490,12525,440,-2596,1945,-620,-7115,-2150,10120
443,05000US13115,"Floyd County, Georgia",2760,2430,2925,1635,4380,1078,1597,2805,2560,13992,1925,2745,7625,1845,7505,5890,3130,5459,835,-4700,4170,-4830,-3085,-570,8533
444,05000US13117,"Forsyth County, Georgia",1935,1210,2189,1565,4189,2834,3039,5630,5149,43443,1035,1540,4825,3695,5144,13394,10650,30920,900,-2636,2059,729,-7764,-5501,12523
445,05000US13119,"Franklin County, Georgia",669,629,483,273,652,482,755,658,464,3273,610,660,1285,149,2519,1355,455,1414,59,-802,776,-1282,-697,9,1859
446,05000US13121,"Fulton County, Georgia",45645,29420,34635,18320,62685,12495,12670,21820,19404,138813,19660,29505,85650,55900,49135,35024,19675,102135,25985,-51015,25105,-23970,-13204,-271,36678
447,05000US13123,"Gilmer County, Georgia",542,550,588,205,1042,538,804,1395,1279,4949,455,620,1470,380,2415,1430,1248,3719,87,-882,867,-1073,-35,31,1230
448,05000US13125,"Glascock County, Georgia",42,61,51,32,57,81,62,123,99,488,53,129,44,4,530,189,44,89,-11,7,85,-387,-66,55,399
449,05000US13127,"Glynn County, Georgia",2625,1995,2430,1274,4520,1394,1510,2415,2395,13144,1795,1595,5675,3780,5580,4160,2580,8525,830,-3245,2014,-2676,-1745,-185,4619
450,05000US13129,"Gordon County, Georgia",1150,1283,1479,1145,2064,625,1025,1735,1429,8080,585,1410,4450,695,4120,3759,1650,3659,565,-2971,2514,-2470,-2024,-221,4421
451,05000US13131,"Grady County, Georgia",795,729,608,509,909,313,455,848,849,3335,460,535,1850,705,2215,1250,585,1640,335,-1242,713,-1447,-402,264,1695
452,05000US13133,"Greene County, Georgia",511,277,374,193,523,443,598,628,479,2862,315,550,730,309,1689,724,184,2489,196,-356,407,-648,-96,295,373
453,05000US13135,"Gwinnett County, Georgia",15585,18335,22555,10560,27690,11619,14468,28355,22934,114779,3640,8465,68200,14425,47325,82790,26825,35430,11945,-45645,23825,-21238,-54435,-3891,79349
454,05000US13137,"Habersham County, Georgia",774,685,720,389,1163,770,1185,1815,1580,6495,520,620,2075,525,2765,3535,2120,3320,254,-1355,1027,-810,-1720,-540,3175
455,05000US13139,"Hall County, Georgia",3605,3940,4320,2540,6135,2599,3219,6058,5263,26509,1910,4100,11400,3115,10570,12590,5070,15150,1695,-7080,5560,-4752,-6532,193,11359
456,05000US13141,"Hancock County, Georgia",138,138,193,40,125,314,320,520,365,1050,165,99,325,50,1485,345,95,499,-27,-132,115,-851,175,270,551
457,05000US13143,"Haralson County, Georgia",909,504,865,344,869,340,824,1274,1033,4594,695,845,1715,244,2855,1925,1274,1669,214,-850,969,-1691,-651,-241,2925
458,05000US13145,"Harris County, Georgia",389,212,393,204,650,473,745,1165,1105,7128,255,395,820,380,1880,2180,1545,4747,134,-427,474,-662,-1015,-440,2381
459,05000US13147,"Hart County, Georgia",670,505,444,273,615,589,795,995,1070,4285,480,585,1125,305,2415,1705,790,2554,190,-681,583,-1031,-710,280,1731
460,05000US13149,"Heard County, Georgia",484,264,261,153,158,403,470,548,475,1234,465,595,275,0,1985,665,199,314,19,-14,311,-1112,-117,276,920
461,05000US13151,"Henry County, Georgia",3450,3434,4424,2695,6325,4000,4250,8205,6930,30310,1215,2800,14520,1825,21615,20840,4815,6050,2235,-10096,7195,-13365,-12635,2115,24260
462,05000US13153,"Houston County, Georgia",4940,2929,4305,2070,5550,2270,2645,4220,4125,23003,1940,4725,11325,1815,13805,14070,3575,4483,3000,-7020,5805,-8890,-9850,550,18520
463,05000US13155,"Irwin County, Georgia",213,215,127,69,185,315,340,375,380,1275,265,294,250,4,1410,580,185,330,-52,-123,250,-755,-205,195,945
464,05000US13157,"Jackson County, Georgia",1264,979,985,380,1420,1070,1369,2208,2229,10060,740,1630,2220,410,5280,5040,2193,4515,524,-1235,1390,-2841,-2832,36,5545
465,05000US13159,"Jasper County, Georgia",425,320,340,105,165,549,644,774,590,1344,490,540,310,15,2220,1035,209,455,-65,30,255,-1027,-261,381,889
466,05000US13161,"Jeff Davis County, Georgia",349,305,315,179,245,223,369,614,489,2293,450,580,325,35,2145,719,325,635,-101,-10,389,-1553,-105,164,1658
467,05000US13163,"Jefferson County, Georgia",743,359,438,144,376,335,417,714,684,1893,475,830,675,89,2320,618,360,504,268,-237,431,-1568,96,324,1389
468,05000US13165,"Jenkins County, Georgia",365,180,165,80,270,295,200,675,515,974,375,415,225,40,1465,315,140,399,-10,-60,310,-970,360,375,575
469,05000US13167,"Johnson County, Georgia",344,156,137,119,195,146,294,389,379,1295,285,375,280,29,1550,455,180,215,59,-143,285,-1110,-66,199,1080
470,05000US13169,"Jones County, Georgia",415,414,373,224,614,365,458,1175,1155,5730,310,279,1030,419,3005,2100,1480,1900,105,-657,419,-2182,-925,-325,3830
471,05000US13171,"Lamar County, Georgia",520,419,460,209,308,510,294,465,444,2755,320,495,800,320,1205,1370,660,1200,200,-340,197,-401,-905,-216,1555
472,05000US13173,"Lanier County, Georgia",559,114,314,75,360,359,234,365,253,1149,330,339,470,295,1060,435,279,535,229,-156,140,-467,-70,-26,614
473,05000US13175,"Laurens County, Georgia",1900,1205,1189,545,1640,974,1205,1744,1630,6000,1425,1900,2525,635,5765,2225,1033,2080,475,-1336,1550,-3586,-481,597,3920
474,05000US13177,"Lee County, Georgia",358,276,338,270,1508,284,324,520,425,5935,149,230,1375,990,1225,1940,1505,2975,209,-1037,788,-617,-1420,-1080,2960
475,05000US13179,"Liberty County, Georgia",1565,1289,2840,1674,5368,593,735,1061,1216,6879,1030,830,4090,6805,3025,3889,1770,2135,535,-1250,237,-1697,-2828,-554,4744
476,05000US13181,"Lincoln County, Georgia",202,121,222,174,232,183,343,418,400,1339,250,200,334,164,1025,479,294,750,-48,-112,242,-499,-61,106,589
477,05000US13183,"Long County, Georgia",308,460,262,190,475,163,315,355,400,2565,210,470,710,300,1740,930,600,555,98,-448,365,-1262,-575,-200,2010
478,05000US13185,"Lowndes County, Georgia",4830,3005,3855,1719,5875,1720,1098,3015,2585,13507,2200,2860,9340,4875,6784,5390,3549,6080,2630,-5485,2719,-3966,-2375,-964,7427
479,05000US13187,"Lumpkin County, Georgia",1110,875,795,413,900,395,500,1199,1010,4550,595,655,2195,655,1800,1530,845,3314,515,-1400,658,-905,-331,165,1236
480,05000US13189,"McDuffie County, Georgia",1045,730,590,340,464,614,518,593,523,2755,775,1350,970,55,2740,1150,418,889,270,-380,749,-1608,-557,105,1866
481,05000US13191,"McIntosh County, Georgia",394,185,295,115,229,399,575,595,474,2519,150,315,595,150,1975,969,490,1215,244,-300,194,-1001,-374,-16,1304
482,05000US13193,"Macon County, Georgia",622,394,229,134,310,359,360,445,480,1355,505,580,524,69,2145,535,140,219,117,-295,375,-1426,-90,340,1136
483,05000US13195,"Madison County, Georgia",658,668,393,324,696,564,797,1445,1175,4344,749,785,1040,165,3325,2120,980,1405,-91,-647,855,-1964,-675,195,2939
484,05000US13197,"Marion County, Georgia",220,180,188,69,239,160,369,425,385,1170,335,310,240,12,1280,425,170,490,-115,-52,296,-751,0,215,680
485,05000US13199,"Meriwether County, Georgia",752,385,664,272,522,347,769,749,749,3199,460,520,1060,544,2630,1369,592,1043,292,-396,250,-1514,-620,157,2156
486,05000US13201,"Miller County, Georgia",201,226,165,18,161,119,109,198,212,920,190,190,319,95,765,360,95,319,11,-154,84,-537,-162,117,601
487,05000US13205,"Mitchell County, Georgia",734,483,450,327,714,518,545,1100,940,2444,605,860,1030,220,2805,1229,470,834,129,-580,821,-1742,-129,470,1610
488,05000US13207,"Monroe County, Georgia",558,339,569,168,575,825,475,1129,1039,4063,435,750,875,130,2600,1569,1020,2210,123,-306,613,-1300,-440,19,1853
489,05000US13209,"Montgomery County, Georgia",194,131,153,128,214,202,212,331,406,1304,225,205,370,20,1300,398,105,514,-31,-217,322,-886,-67,301,790
490,05000US13211,"Morgan County, Georgia",325,138,343,109,778,369,399,833,575,3043,415,305,720,260,1024,935,840,2233,-90,-377,627,-256,-102,-265,810
491,05000US13213,"Murray County, Georgia",485,865,1680,350,1179,599,839,1274,1535,5715,625,935,2710,284,4349,2830,1150,1420,-140,-1030,1245,-2911,-1556,385,4295
492,05000US13215,"Muscogee County, Georgia",8503,5525,7389,3878,12445,2560,3314,4248,3898,21866,3020,6320,16900,11485,11525,11050,4649,9300,5483,-9511,4838,-5651,-6802,-751,12566
493,05000US13217,"Newton County, Georgia",3190,2104,2609,674,2515,2474,2544,4625,3504,12149,1280,3530,5850,435,14415,6610,1880,2329,1910,-3241,2754,-9397,-1985,1624,9820
494,05000US13219,"Oconee County, Georgia",235,290,538,310,878,312,548,1124,1150,7648,185,240,1360,469,970,1835,1735,6008,50,-822,719,-110,-711,-585,1640
495,05000US13221,"Oglethorpe County, Georgia",389,323,269,130,172,304,549,625,619,2303,340,440,409,64,2139,1260,524,599,49,-140,238,-1286,-635,95,1704
496,05000US13223,"Paulding County, Georgia",2075,1645,3165,1304,3290,3375,2880,6960,5740,21895,1045,2835,6725,855,17100,16465,3300,3895,1030,-3560,3739,-10845,-9505,2440,18000
497,05000US13225,"Peach County, Georgia",784,869,770,280,775,420,565,715,650,4215,550,1040,1395,490,2535,1680,1250,1345,234,-625,565,-1550,-965,-600,2870
498,05000US13227,"Pickens County, Georgia",605,540,555,184,650,710,765,1605,1134,4830,530,945,990,90,2825,2535,915,2820,75,-435,744,-1350,-930,219,2010
499,05000US13229,"Pierce County, Georgia",314,719,258,90,443,504,423,695,689,2985,545,395,795,124,2228,1200,449,1260,-231,-537,409,-1301,-505,240,1725
500,05000US13231,"Pike County, Georgia",248,166,277,104,183,619,460,995,790,2333,290,340,360,8,1965,1738,555,855,-42,-83,279,-886,-743,235,1478
501,05000US13233,"Polk County, Georgia",1100,1134,1095,745,1220,390,735,1464,1179,6060,925,970,3010,400,3970,2810,1014,2070,175,-1915,1565,-2845,-1346,165,3990
502,05000US13235,"Pulaski County, Georgia",409,245,302,119,429,158,154,358,369,1510,275,390,710,139,955,540,325,569,134,-408,409,-643,-182,44,941
503,05000US13237,"Putnam County, Georgia",565,399,475,290,460,395,500,1120,699,3950,520,649,740,260,2230,1210,595,2995,45,-265,490,-1335,-90,104,955
504,05000US13239,"Quitman County, Georgia",77,59,18,12,68,87,103,161,139,305,60,55,140,4,520,170,35,138,17,-122,76,-330,-9,104,167
505,05000US13241,"Rabun County, Georgia",493,268,301,218,400,350,544,731,641,2709,515,340,710,120,1275,828,779,2195,-22,-409,498,-381,-97,-138,514
506,05000US13243,"Randolph County, Georgia",290,264,184,175,224,187,254,295,320,680,460,395,255,19,1020,275,100,335,-170,-71,380,-579,20,220,345
507,05000US13245,"Richmond County, Georgia",9845,6125,6375,3029,8560,3204,3500,6554,5743,21027,3645,6960,19370,3955,21530,11325,3334,3814,6200,-12995,7634,-14826,-4771,2409,17213
508,05000US13247,"Rockdale County, Georgia",2150,2095,2130,985,2070,1815,1925,3929,3170,10649,670,2510,5910,335,9669,7770,1870,1799,1480,-3780,2720,-5929,-3841,1300,8850
509,05000US13249,"Schley County, Georgia",190,80,121,72,188,106,124,148,139,775,185,120,315,39,580,249,125,315,5,-194,221,-350,-101,14,460
510,05000US13251,"Screven County, Georgia",368,394,404,92,369,327,323,693,464,2023,420,545,554,110,1963,885,185,669,-52,-150,351,-1313,-192,279,1354
511,05000US13253,"Seminole County, Georgia",252,229,119,117,254,249,229,443,399,1130,149,200,520,100,1285,445,235,515,103,-401,271,-807,-2,164,615
512,05000US13255,"Spalding County, Georgia",3105,2065,1950,699,1250,1604,1730,2925,2545,6229,1345,4160,3535,30,9200,3610,995,1355,1760,-1585,1919,-5866,-685,1550,4874
513,05000US13257,"Stephens County, Georgia",734,579,764,154,595,594,530,1155,965,3799,410,865,1305,225,3210,1740,870,1115,324,-541,524,-2086,-585,95,2684
514,05000US13259,"Stewart County, Georgia",227,109,114,29,104,156,259,199,189,519,185,209,140,35,900,135,70,105,42,-26,98,-485,64,119,414
515,05000US13261,"Sumter County, Georgia",1509,918,1309,284,1228,473,751,750,789,3983,715,1385,2455,700,3630,1233,540,1424,794,-1146,812,-2406,-483,249,2559
516,05000US13263,"Talbot County, Georgia",186,119,112,32,98,238,249,342,297,1182,169,170,168,33,1274,404,170,450,17,-56,97,-787,-62,127,732
517,05000US13265,"Taliaferro County, Georgia",60,46,42,18,57,53,90,81,76,217,44,103,48,18,330,70,24,69,16,-6,57,-187,11,52,148
518,05000US13267,"Tattnall County, Georgia",488,519,543,355,668,460,715,924,665,3030,764,945,760,89,2790,1240,570,995,-276,-217,934,-1615,-316,95,2035
519,05000US13269,"Taylor County, Georgia",340,178,183,104,280,277,389,478,393,1095,325,415,295,55,1615,484,130,295,15,-112,329,-949,-6,263,800
520,05000US13271,"Telfair County, Georgia",459,418,444,214,440,205,508,810,734,1344,650,640,665,15,2395,310,240,284,-191,-221,639,-1682,500,494,1060
521,05000US13273,"Terrell County, Georgia",384,345,234,28,376,230,169,214,213,1087,289,445,525,110,925,377,255,374,95,-291,294,-526,-163,-42,713
522,05000US13275,"Thomas County, Georgia",1150,1025,1430,627,1900,760,890,1890,1400,6717,1065,750,2775,1545,3545,2780,1603,3594,85,-1345,982,-1895,-890,-203,3123
523,05000US13277,"Tift County, Georgia",1489,1290,959,748,1965,710,804,1145,1005,5046,890,2220,2540,805,3375,1744,1085,2349,599,-1581,1908,-1861,-599,-80,2697
524,05000US13279,"Toombs County, Georgia",1024,974,944,334,854,589,540,934,819,3834,1100,1285,1410,355,2930,1780,689,1170,-76,-466,833,-1801,-846,130,2664
525,05000US13281,"Towns County, Georgia",97,168,218,111,281,365,254,610,479,2118,179,145,410,150,615,480,329,2390,-82,-192,242,4,130,150,-272
526,05000US13283,"Treutlen County, Georgia",170,154,88,54,300,229,254,244,239,914,275,345,150,0,1434,225,155,150,-105,-62,354,-951,19,84,764
527,05000US13285,"Troup County, Georgia",2665,1600,1700,1339,3300,765,1244,1665,1480,9338,1160,1790,4870,2770,4480,4124,2355,3435,1505,-3170,1869,-2471,-2459,-875,5903
528,05000US13287,"Turner County, Georgia",332,170,59,49,324,187,245,239,204,1395,89,375,405,70,1430,359,180,350,243,-346,303,-998,-120,24,1045
529,05000US13289,"Twiggs County, Georgia",280,66,162,18,97,303,361,423,378,984,290,160,155,30,1709,260,224,170,-10,7,85,-1045,163,154,814
530,05000US13291,"Union County, Georgia",435,388,323,140,464,424,465,1340,1385,3915,440,520,549,230,1105,1110,1550,3595,-5,-226,374,-216,230,-165,320
531,05000US13293,"Upson County, Georgia",1129,597,664,305,980,590,533,1055,1009,3665,605,1000,1670,395,3705,1680,570,935,524,-1006,890,-2582,-625,439,2730
532,05000US13295,"Walker County, Georgia",1880,1350,1544,755,1570,1660,2170,3324,2999,9304,1460,2235,3050,340,9355,4555,1943,3285,420,-1506,1985,-5525,-1231,1056,6019
533,05000US13297,"Walton County, Georgia",2410,1740,1655,825,1615,1499,2190,4110,3525,11540,1520,2995,3375,360,8095,8045,2530,3760,890,-1720,2080,-4406,-3935,995,7780
534,05000US13299,"Ware County, Georgia",1204,1054,1089,459,1295,835,719,1470,1260,4859,1205,1205,2340,375,4995,2185,845,1009,-1,-1251,1379,-3441,-715,415,3850
535,05000US13301,"Warren County, Georgia",298,161,117,63,117,129,190,284,254,780,215,195,279,55,1055,135,140,200,83,-162,125,-736,149,114,580
536,05000US13303,"Washington County, Georgia",563,680,294,177,592,568,529,656,712,2765,435,565,1095,219,2870,1085,309,944,128,-801,550,-1773,-429,403,1821
537,05000US13305,"Wayne County, Georgia",1060,685,632,358,1083,454,669,889,950,3999,920,1320,1360,219,2870,1720,745,1379,140,-728,1222,-1747,-831,205,2620
538,05000US13307,"Webster County, Georgia",58,16,69,0,73,93,94,104,129,410,75,95,65,4,595,100,45,114,-17,4,69,-408,4,84,296
539,05000US13309,"Wheeler County, Georgia",219,218,145,55,76,119,180,204,233,590,320,285,100,4,905,185,90,75,-101,45,127,-606,19,143,515
540,05000US13311,"White County, Georgia",593,513,525,405,1010,435,709,1154,1245,4859,395,360,1760,515,1970,1884,1409,3295,198,-1235,900,-826,-730,-164,1564
541,05000US13313,"Whitfield County, Georgia",1785,2940,3030,1609,4185,1043,2125,3135,3115,13195,1350,2965,8065,1170,6755,7260,2920,5370,435,-5035,4624,-3587,-4125,195,7825
542,05000US13315,"Wilcox County, Georgia",237,159,142,22,165,155,204,357,343,1048,260,230,210,15,1155,414,159,219,-23,-68,172,-796,-57,184,829
543,05000US13317,"Wilkes County, Georgia",276,343,322,69,266,221,338,409,390,1444,385,300,460,140,1509,469,230,535,-109,-138,195,-950,-60,160,909
544,05000US13319,"Wilkinson County, Georgia",254,120,135,36,205,221,267,328,307,1413,215,250,265,45,1645,534,208,164,39,-130,196,-1157,-206,99,1249
545,05000US13321,"Worth County, Georgia",759,241,654,300,608,369,429,770,735,3309,345,595,1455,164,2805,1235,449,969,414,-801,744,-2007,-465,286,2340
546,05000US15001,"Hawaii County, Hawaii",6354,3490,3660,2000,6624,5571,4729,6598,6428,22903,5185,3294,8094,5535,5034,8312,5494,27290,1169,-4434,3089,5266,-1714,934,-4387
547,05000US15003,"Honolulu County, Hawaii",29570,22840,32884,16610,36290,11894,12795,27249,24598,100769,17100,17285,51765,52045,5980,8370,14279,145949,12470,-18881,855,18709,18879,10319,-45180
548,05000US15005,"Kalawao County, Hawaii",4,4,8,18,22,0,0,0,0,0,35,8,4,8,0,0,0,0,-31,4,32,0,0,0,0
549,05000US15007,"Kauai County, Hawaii",1480,1380,1675,835,2983,1417,1159,2049,2020,8040,1625,1335,3175,2215,357,530,660,12975,-145,-1500,1603,2219,1519,1360,-4935
550,05000US15009,"Maui County, Hawaii",4034,3489,5385,2649,6595,2669,2533,4613,4094,18994,3360,3120,8850,6830,1555,1674,2278,27090,674,-3465,2414,3647,2939,1816,-8096
551,05000US16001,"Ada County, Idaho",11055,8435,11905,6415,14350,7115,7555,15270,12730,71645,4975,10880,30760,5530,12115,37880,20640,43060,6080,-18855,15235,2555,-22610,-7910,28585
552,05000US16003,"Adams County, Idaho",74,49,127,18,77,122,137,227,209,702,95,124,135,0,339,325,109,634,-21,-8,95,-80,-98,100,68
553,05000US16005,"Bannock County, Idaho",2410,1863,2350,1025,1925,1219,1438,3148,2963,13148,1040,3885,4165,510,5075,8790,3370,4418,1370,-1815,2440,-2418,-5642,-407,8730
554,05000US16007,"Bear Lake County, Idaho",148,93,84,48,123,75,200,277,252,1047,184,200,109,4,685,602,239,365,-36,-25,167,-410,-325,13,682
555,05000US16009,"Benewah County, Idaho",231,126,233,91,232,162,297,413,368,1389,245,270,365,34,788,800,434,809,-14,-132,289,-329,-387,-66,580
556,05000US16011,"Bingham County, Idaho",903,538,968,425,929,580,919,2104,1739,6450,1020,1370,1110,259,3585,4119,1859,1870,-117,-142,1095,-2086,-2015,-120,4580
557,05000US16013,"Blaine County, Idaho",614,504,434,315,880,313,646,799,629,3204,610,595,1110,420,640,764,440,4030,4,-676,775,319,35,189,-826
558,05000US16015,"Boise County, Idaho",119,110,147,23,109,181,296,538,298,1294,198,190,80,60,655,633,214,1099,-79,67,72,-178,-95,84,195
559,05000US16017,"Bonner County, Idaho",945,1075,959,443,1369,1008,1214,2068,2013,7030,745,1110,2305,629,1794,2124,1875,7345,200,-1346,1183,428,-56,138,-315
560,05000US16019,"Bonneville County, Idaho",2110,2450,2735,995,2980,1238,2095,4498,3774,16137,1030,4270,5020,965,6324,12215,4005,4974,1080,-2285,3010,-2991,-7717,-231,11163
561,05000US16021,"Boundary County, Idaho",252,279,240,104,294,354,248,674,519,1714,265,425,355,120,555,975,649,1210,-13,-115,278,47,-301,-130,504
562,05000US16023,"Butte County, Idaho",37,20,54,34,22,98,73,178,187,434,44,70,48,10,435,230,85,125,-7,6,46,-264,-52,102,309
563,05000US16025,"Camas County, Idaho",8,54,22,4,14,28,30,47,24,150,35,30,30,4,59,78,12,125,-27,-8,14,-1,-31,12,25
564,05000US16027,"Canyon County, Idaho",5920,4575,5775,2330,3868,3564,5530,10355,7272,21272,3695,7850,10235,689,17645,17958,4545,7369,2225,-4460,5509,-8551,-7603,2727,13903
565,05000US16029,"Caribou County, Idaho",58,80,108,32,124,153,257,385,328,1069,195,185,25,0,1165,668,140,190,-137,83,156,-755,-283,188,879
566,05000US16031,"Cassia County, Idaho",505,365,670,290,545,323,520,874,873,3121,860,725,745,45,2033,1595,668,1212,-355,-75,790,-1190,-721,205,1909
567,05000US16033,"Clark County, Idaho",8,60,12,12,45,18,26,51,51,71,95,30,14,0,85,45,10,43,-87,-2,57,-41,6,41,28
568,05000US16035,"Clearwater County, Idaho",176,88,302,72,229,232,270,666,542,1392,155,240,430,35,928,818,315,842,21,-128,266,-426,-152,227,550
569,05000US16037,"Custer County, Idaho",99,108,52,83,87,116,208,238,216,657,225,94,118,4,425,284,309,435,-126,-66,166,-101,-46,-93,222
570,05000US16039,"Elmore County, Idaho",505,825,1140,525,1250,343,568,808,679,3390,790,890,2155,395,1854,1870,814,1455,-285,-1015,1380,-943,-1062,-135,1935
571,05000US16041,"Franklin County, Idaho",88,281,193,133,154,229,313,732,549,1787,155,440,159,85,679,1504,355,969,-67,34,202,-137,-772,194,818
572,05000US16043,"Fremont County, Idaho",166,199,185,58,264,126,298,695,424,1967,164,310,300,100,1169,929,484,1000,2,-115,222,-745,-234,-60,967
573,05000US16045,"Gem County, Idaho",555,245,260,200,364,425,420,844,669,2484,360,365,835,59,1145,1625,700,1310,195,-575,505,-300,-781,-31,1174
574,05000US16047,"Gooding County, Idaho",246,371,453,228,498,272,356,763,573,1965,470,445,805,64,1275,1049,373,1084,-224,-352,662,-647,-286,200,881
575,05000US16049,"Idaho County, Idaho",269,197,227,243,440,425,602,1254,1173,2146,380,475,430,80,1129,1458,814,1908,-111,-203,603,-102,-204,359,238
576,05000US16051,"Jefferson County, Idaho",193,209,364,269,558,364,464,1312,1153,3823,394,485,615,100,2070,2165,1199,1569,-201,-251,727,-1242,-853,-46,2254
577,05000US16053,"Jerome County, Idaho",314,669,698,344,759,265,555,825,815,2734,389,795,1390,195,1220,1855,650,1385,-75,-692,908,-400,-1030,165,1349
578,05000US16055,"Kootenai County, Idaho",2769,2675,4105,2058,5530,2574,2779,6554,5869,25345,1665,2655,9925,2895,4824,11069,7515,19219,1104,-5820,4693,529,-4515,-1646,6126
579,05000US16057,"Latah County, Idaho",2605,1117,1689,584,1235,397,454,1142,1032,5429,730,3470,2535,480,1589,1599,1868,3305,1875,-846,1339,-738,-457,-836,2124
580,05000US16059,"Lemhi County, Idaho",268,308,210,103,210,212,335,400,415,1175,420,295,355,25,595,615,394,1105,-152,-145,288,-48,-215,21,70
581,05000US16061,"Lewis County, Idaho",97,78,95,49,107,97,143,254,213,580,135,145,133,14,488,334,158,244,-38,-38,142,-248,-80,55,336
582,05000US16063,"Lincoln County, Idaho",82,84,132,57,152,58,109,210,172,612,160,145,154,39,390,388,139,219,-78,-22,170,-223,-178,33,393
583,05000US16065,"Madison County, Idaho",2108,1534,1089,454,529,214,313,874,624,2946,775,1145,3230,555,634,1455,1229,1613,1333,-2141,428,-107,-581,-605,1333
584,05000US16067,"Minidoka County, Idaho",304,364,459,420,568,423,565,748,839,2817,635,720,700,70,1849,1689,754,944,-331,-241,918,-861,-941,85,1873
585,05000US16069,"Nez Perce County, Idaho",1099,929,1054,529,1143,463,767,1658,1564,7518,690,1565,2160,340,1713,3640,2770,3589,409,-1106,1332,-483,-1982,-1206,3929
586,05000US16071,"Oneida County, Idaho",59,73,54,64,88,64,62,340,250,637,175,34,115,15,374,404,160,355,-116,-61,137,-248,-64,90,282
587,05000US16073,"Owyhee County, Idaho",354,434,313,78,150,404,444,520,450,1043,645,439,215,20,1360,690,259,560,-291,98,208,-512,-170,191,483
588,05000US16075,"Payette County, Idaho",305,404,475,355,679,485,625,975,935,3419,340,575,1120,184,1855,1980,870,1715,-35,-645,850,-745,-1005,65,1704
589,05000US16077,"Power County, Idaho",44,87,224,110,287,46,197,387,272,1001,275,180,300,4,690,690,240,254,-231,-76,393,-447,-303,32,747
590,05000US16079,"Shoshone County, Idaho",379,334,367,166,433,272,492,746,665,1978,250,645,740,54,1568,1294,472,780,129,-373,545,-804,-548,193,1198
591,05000US16081,"Teton County, Idaho",90,199,241,157,324,138,408,334,333,1546,139,295,465,125,293,349,490,1753,-49,-224,356,253,-15,-157,-207
592,05000US16083,"Twin Falls County, Idaho",2009,1905,2294,889,2530,1087,1739,3345,2855,11839,1425,2685,4550,970,5640,7670,2637,4869,584,-2256,2449,-2814,-4325,218,6970
593,05000US16085,"Valley County, Idaho",203,75,200,133,249,193,158,399,353,1659,155,254,379,58,470,385,384,1549,48,-179,324,-119,14,-31,110
594,05000US16087,"Washington County, Idaho",305,223,263,38,229,210,399,650,588,1331,254,445,325,34,885,850,272,910,51,-62,233,-276,-200,316,421
595,05000US17001,"Adams County, Illinois",2114,1738,1905,798,1544,963,1576,3125,3030,11227,1760,3275,2775,275,8880,5799,1855,3279,354,-870,2067,-6341,-2674,1175,7948
596,05000US17003,"Alexander County, Illinois",288,138,136,57,107,227,227,392,313,679,344,200,134,30,1427,155,74,110,-56,2,134,-973,237,239,569
597,05000US17005,"Bond County, Illinois",308,310,253,128,318,360,533,542,707,2804,360,560,370,45,2494,1265,485,664,-52,-117,401,-1601,-723,222,2140
598,05000US17007,"Boone County, Illinois",769,700,715,535,1175,628,1289,1875,1870,9308,650,605,2005,630,5509,4230,1695,3734,119,-1290,1080,-3592,-2355,175,5574
599,05000US17009,"Brown County, Illinois",122,62,93,8,143,133,167,262,202,918,184,190,55,4,1099,203,150,180,-62,38,147,-799,59,52,738
600,05000US17011,"Bureau County, Illinois",748,575,848,308,837,554,968,1877,1573,6147,760,1495,940,110,6015,3322,630,873,-12,-92,1035,-4493,-1445,943,5274
601,05000US17013,"Calhoun County, Illinois",155,34,55,25,58,185,167,268,278,688,210,108,8,4,908,414,125,143,-55,47,79,-556,-146,153,545
602,05000US17015,"Carroll County, Illinois",348,279,402,200,312,348,494,829,677,2881,395,715,390,15,2910,1099,379,755,-47,12,497,-2068,-270,298,2126
603,05000US17017,"Cass County, Illinois",284,357,273,179,276,218,319,660,514,2186,430,660,268,8,2905,597,209,154,-146,5,447,-2368,63,305,2032
604,05000US17019,"Champaign County, Illinois",14260,6210,6859,3109,6599,2778,3384,6238,5573,27424,3620,12335,16270,4790,17400,17564,4510,6150,10640,-9411,4918,-11238,-11326,1063,21274
605,05000US17021,"Christian County, Illinois",649,935,744,458,673,689,912,1651,1672,5978,925,1615,760,143,6830,2488,704,675,-276,-16,988,-5229,-837,968,5303
606,05000US17023,"Clark County, Illinois",365,416,369,160,432,274,482,744,767,3014,400,765,470,115,3115,1175,355,460,-35,-101,477,-2359,-431,412,2554
607,05000US17025,"Clay County, Illinois",385,154,324,84,224,338,505,858,709,2382,435,630,90,20,3244,798,240,395,-50,234,288,-2401,60,469,1987
608,05000US17027,"Clinton County, Illinois",668,445,584,347,689,904,999,1843,1991,6312,525,1255,850,120,5403,4089,1014,1110,143,-266,916,-3500,-2246,977,5202
609,05000US17029,"Coles County, Illinois",2945,1774,1440,419,1438,673,1473,1840,1779,7602,1605,3105,2850,450,7840,2934,1100,1324,1340,-1410,1407,-5694,-1094,679,6278
610,05000US17031,"Cook County, Illinois",249860,144924,152365,75145,221890,99419,114050,169085,142210,618174,104915,212895,354600,171760,304175,308445,143215,382000,144945,-202235,125275,-90706,-139360,-1005,236174
611,05000US17033,"Crawford County, Illinois",432,331,327,234,370,374,587,1073,1028,3208,410,820,420,37,3863,1045,430,739,22,-93,567,-2902,28,598,2469
612,05000US17035,"Cumberland County, Illinois",203,205,175,108,207,235,328,609,534,1874,250,500,150,0,2110,687,405,235,-47,25,315,-1547,-78,129,1639
613,05000US17037,"DeKalb County, Illinois",4540,2929,3400,1844,3554,1143,1140,2759,2458,13849,1795,5290,7405,1785,6205,9415,3014,2975,2745,-4005,3613,-3922,-6656,-556,10874
614,05000US17039,"De Witt County, Illinois",489,320,262,199,213,325,408,755,767,3037,680,635,165,8,3329,1053,295,598,-191,97,404,-2596,-298,472,2439
615,05000US17041,"Douglas County, Illinois",473,402,469,198,543,434,462,911,847,2982,415,1195,410,70,3318,1398,355,499,58,59,671,-2422,-487,492,2483
616,05000US17043,"DuPage County, Illinois",16475,13750,18985,10945,30705,12414,16939,30625,27644,166645,6760,7575,51600,24935,29320,67635,44890,110980,9715,-32615,16715,33,-37010,-17246,55665
617,05000US17045,"Edgar County, Illinois",810,217,434,123,413,359,565,989,982,3098,550,970,435,40,4003,960,365,468,260,-1,496,-3079,29,617,2630
618,05000US17047,"Edwards County, Illinois",87,127,111,64,89,212,188,386,321,1285,175,235,58,0,1710,314,75,245,-88,53,153,-1310,72,246,1040
619,05000US17049,"Effingham County, Illinois",613,598,767,360,672,711,1117,1714,1644,5729,705,1795,440,63,4514,3193,1097,1735,-92,327,969,-2686,-1479,547,3994
620,05000US17051,"Fayette County, Illinois",464,334,258,135,266,523,769,1158,1083,3003,430,715,290,45,4088,1074,549,689,34,-32,356,-2796,84,534,2314
621,05000US17053,"Ford County, Illinois",539,267,365,118,371,363,415,838,745,1917,509,945,174,18,2809,955,110,210,30,191,471,-2031,-117,635,1707
622,05000US17055,"Franklin County, Illinois",1569,998,839,377,808,1359,1532,2146,1827,5451,1405,1810,1300,65,8884,1954,479,719,164,-461,1120,-5993,192,1348,4732
623,05000US17057,"Fulton County, Illinois",929,623,722,320,558,737,1157,1694,1548,6112,815,1325,884,149,7329,2314,638,838,114,-162,729,-5435,-620,910,5274
624,05000US17059,"Gallatin County, Illinois",151,124,113,66,93,153,237,306,288,808,350,119,44,18,1320,330,83,55,-199,69,141,-930,-24,205,753
625,05000US17061,"Greene County, Illinois",300,244,235,107,227,427,398,824,694,1875,370,485,229,30,2858,740,160,335,-70,6,304,-2033,84,534,1540
626,05000US17063,"Grundy County, Illinois",1164,769,1139,650,1570,1080,949,2189,1830,8104,700,1710,2625,275,4005,5834,2135,1895,464,-1486,1945,-1976,-3645,-305,6209
627,05000US17065,"Hamilton County, Illinois",174,157,88,124,174,278,279,449,578,1275,340,249,114,20,1610,589,145,355,-166,-26,278,-1053,-140,433,920
628,05000US17067,"Hancock County, Illinois",303,256,268,204,414,433,595,997,1002,3217,350,775,305,23,4125,1298,425,388,-47,-37,595,-3097,-301,577,2829
629,05000US17069,"Hardin County, Illinois",154,51,54,16,19,113,192,189,179,579,179,99,4,8,889,194,75,58,-25,50,27,-584,-5,104,521
630,05000US17071,"Henderson County, Illinois",127,85,191,55,181,130,205,500,490,1159,205,295,113,8,1610,545,134,160,-78,78,228,-1275,-45,356,999
631,05000US17073,"Henry County, Illinois",1322,915,734,458,927,996,1538,2679,2277,8745,1575,1850,814,115,8379,4778,1134,1689,-253,-80,1270,-5845,-2099,1143,7056
632,05000US17075,"Iroquois County, Illinois",683,628,482,404,647,723,899,1592,1388,4830,540,1519,685,99,5567,2138,684,808,143,-203,952,-3945,-546,704,4022
633,05000US17077,"Jackson County, Illinois",4730,2355,1954,646,1539,855,1378,1779,1744,7459,1795,4660,4120,660,6615,3325,1235,1912,2935,-2166,1525,-4382,-1546,509,5547
634,05000US17079,"Jasper County, Illinois",287,92,140,44,129,273,258,467,439,1705,209,329,109,40,1795,475,284,490,78,31,133,-1264,-8,155,1215
635,05000US17081,"Jefferson County, Illinois",1370,734,744,399,824,918,1236,1818,1588,6072,1095,1680,1190,100,6639,2568,800,1263,275,-446,1123,-4485,-750,788,4809
636,05000US17083,"Jersey County, Illinois",684,321,269,215,167,504,728,1349,1187,3596,520,905,223,10,3718,2209,678,743,164,46,372,-2486,-860,509,2853
637,05000US17085,"Jo Daviess County, Illinois",415,389,427,386,521,438,848,1303,1137,4188,530,1110,459,24,3479,1718,889,1779,-115,-32,883,-2193,-415,248,2409
638,05000US17087,"Johnson County, Illinois",227,269,151,49,147,347,394,617,650,1833,305,345,149,29,2074,805,310,523,-78,2,167,-1333,-188,340,1310
639,05000US17089,"Kane County, Illinois",11110,9070,10580,5330,10860,7655,10519,19098,15723,78459,5015,11600,23635,6710,31910,44035,23440,31344,6095,-13055,9480,-13736,-24937,-7717,47115
640,05000US17091,"Kankakee County, Illinois",3235,2050,2388,1303,3729,1674,2022,3838,3615,17374,1510,3265,6520,1435,10145,10090,3184,4604,1725,-4132,3597,-6449,-6252,431,12770
641,05000US17093,"Kendall County, Illinois",1314,1400,1710,705,2105,1213,2698,4164,3999,20885,825,2240,2930,1240,9789,14350,5579,3178,489,-1220,1570,-5878,-10186,-1580,17707
642,05000US17095,"Knox County, Illinois",2125,1535,1655,483,1314,887,1383,2413,2089,7418,1620,3465,1820,210,9565,2888,570,1129,505,-165,1587,-7295,-475,1519,6289
643,05000US17097,"Lake County, Illinois",14540,11945,13785,6710,18009,9005,12860,23135,19625,119025,7645,13525,30945,12875,44870,47270,20590,70395,6895,-17160,11844,-23005,-24135,-965,48630
644,05000US17099,"LaSalle County, Illinois",3325,2354,2420,1235,2800,1913,2840,5493,4813,18625,2190,5150,4325,470,15439,10469,3248,3784,1135,-1905,3565,-10686,-4976,1565,14841
645,05000US17101,"Lawrence County, Illinois",359,456,339,231,407,239,507,792,709,2310,435,1020,350,4,3453,595,205,280,-76,-11,634,-2707,197,504,2030
646,05000US17103,"Lee County, Illinois",845,618,670,375,1003,557,858,1519,1408,5948,820,1615,905,170,5185,2813,1015,1179,25,-235,1208,-3770,-1294,393,4769
647,05000US17105,"Livingston County, Illinois",1124,668,883,403,885,643,1208,1638,1434,5962,1030,1955,929,33,6245,2765,779,840,94,-46,1255,-4394,-1127,655,5122
648,05000US17107,"Logan County, Illinois",515,389,687,482,933,426,557,1138,1162,5042,510,1455,970,65,4709,2224,539,672,5,-283,1350,-3726,-1086,623,4370
649,05000US17109,"McDonough County, Illinois",1715,660,619,293,524,544,672,1398,1210,4311,995,1445,1225,150,4900,2009,459,543,720,-606,667,-3684,-611,751,3768
650,05000US17111,"McHenry County, Illinois",4405,3925,5580,2255,6695,4453,6100,12270,10665,55825,2405,4535,12430,3480,21885,37335,14085,16080,2000,-6850,5470,-11332,-25065,-3420,39745
651,05000US17113,"McLean County, Illinois",7445,3850,4745,2184,4990,2774,3303,6287,5063,26122,3845,11250,6910,1210,18860,16525,4049,3843,3600,-2165,5964,-12783,-10238,1014,22279
652,05000US17115,"Macon County, Illinois",3910,2815,1930,1415,3255,2164,2569,4703,4204,18343,2705,5070,4780,755,18990,7043,2220,3469,1205,-2850,3915,-14257,-2340,1984,14874
653,05000US17117,"Macoupin County, Illinois",1300,1028,974,361,696,685,1219,2099,1879,8772,950,2030,1200,170,8423,3354,1235,1698,350,-226,887,-6519,-1255,644,7074
654,05000US17119,"Madison County, Illinois",9730,6365,6634,3065,5720,5709,6618,12430,11309,41749,5275,15620,9435,1180,41145,21945,6705,7960,4455,-2801,7605,-28818,-9515,4604,33789
655,05000US17121,"Marion County, Illinois",1299,864,827,281,845,808,1393,2205,1872,6129,1175,1805,980,140,8760,1950,650,718,124,-153,986,-6559,255,1222,5411
656,05000US17123,"Marshall County, Illinois",252,164,171,59,174,311,387,718,698,2104,264,470,98,0,2674,913,275,309,-12,73,233,-1976,-195,423,1795
657,05000US17125,"Mason County, Illinois",317,245,360,153,297,347,497,913,784,2408,355,670,314,34,3414,892,120,294,-38,46,416,-2570,21,664,2114
658,05000US17127,"Massac County, Illinois",590,267,226,154,374,435,550,874,638,2148,420,515,505,170,3259,845,240,224,170,-279,358,-2274,29,398,1924
659,05000US17129,"Menard County, Illinois",358,254,247,131,252,218,275,552,522,2493,414,555,215,70,1969,1129,480,430,-56,32,313,-1476,-577,42,2063
660,05000US17131,"Mercer County, Illinois",438,229,259,161,408,252,452,850,840,2863,510,709,209,69,3025,1439,269,464,-72,50,500,-2321,-589,571,2399
661,05000US17133,"Monroe County, Illinois",530,392,695,199,579,465,693,1568,1515,6968,195,1180,865,125,2130,4679,1835,2404,335,-170,653,-972,-3111,-320,4564
662,05000US17135,"Montgomery County, Illinois",809,444,552,284,396,618,1023,1484,1314,4809,790,1120,505,50,5943,1588,595,909,19,47,630,-4302,-104,719,3900
663,05000US17137,"Morgan County, Illinois",1015,1035,808,423,1020,539,799,1618,1190,5681,920,1765,1405,230,5139,2615,764,1189,95,-597,1213,-3801,-997,426,4492
664,05000US17139,"Moultrie County, Illinois",275,325,353,129,327,245,359,749,664,2644,285,740,325,70,2394,1275,415,450,-10,28,386,-1790,-526,249,2194
665,05000US17141,"Ogle County, Illinois",1195,1154,957,745,1195,915,1355,2588,2339,9061,885,2585,1640,130,6875,5614,1462,1924,310,-683,1810,-4605,-3026,877,7137
666,05000US17143,"Peoria County, Illinois",7670,4885,5154,2185,6220,2992,4163,7618,7113,27933,4540,10165,9590,1805,24045,14220,5084,6429,3130,-4436,6600,-16890,-6602,2029,21504
667,05000US17145,"Perry County, Illinois",705,349,482,228,329,518,642,983,859,3348,875,885,255,75,4269,1069,500,404,-170,227,482,-3109,-86,359,2944
668,05000US17147,"Piatt County, Illinois",238,229,329,113,332,206,428,1064,774,3292,265,550,359,59,2849,1589,654,424,-27,-30,386,-2215,-525,120,2868
669,05000US17149,"Pike County, Illinois",453,383,280,222,156,471,539,1097,881,2429,585,705,198,4,3584,949,325,408,-132,82,374,-2574,148,556,2021
670,05000US17151,"Pope County, Illinois",105,62,36,15,43,83,184,324,249,672,155,54,30,4,880,290,109,158,-50,6,54,-613,34,140,514
671,05000US17153,"Pulaski County, Illinois",192,167,117,55,63,191,289,357,248,710,240,235,99,12,1267,239,104,98,-48,18,106,-787,118,144,612
672,05000US17155,"Putnam County, Illinois",102,82,97,69,136,119,227,332,263,1079,185,259,53,0,1122,555,120,194,-83,44,205,-776,-223,143,885
673,05000US17157,"Randolph County, Illinois",629,560,679,465,618,552,914,1620,1349,5141,695,1445,725,70,5317,2309,764,1098,-66,-46,1013,-3851,-689,585,4043
674,05000US17159,"Richland County, Illinois",534,421,388,179,352,359,385,808,664,2574,660,820,365,20,3015,930,324,425,-126,23,511,-2271,-122,340,2149
675,05000US17161,"Rock Island County, Illinois",5445,3555,3904,1790,3949,2528,3435,7172,6529,23293,4170,6910,6485,1075,22245,13065,3065,3995,1275,-2581,4664,-16282,-5893,3464,19298
676,05000US17163,"St. Clair County, Illinois",13050,6750,7160,2930,6145,5975,6569,11483,9890,36095,7660,13590,12480,2285,38405,18480,5845,6470,5390,-5320,6790,-25861,-6997,4045,29625
677,05000US17165,"Saline County, Illinois",1015,714,464,199,332,924,719,1173,1017,3585,1050,1135,500,45,5009,1320,500,540,-35,-36,486,-3366,-147,517,3045
678,05000US17167,"Sangamon County, Illinois",7515,4713,5185,2605,5600,3833,4784,7197,7142,36413,3895,10895,9640,1190,27575,18115,6309,6760,3620,-4455,7015,-18958,-10918,833,29653
679,05000US17169,"Schuyler County, Illinois",110,42,239,60,140,178,202,442,391,1215,115,335,120,15,1499,439,175,189,-5,119,185,-1119,3,216,1026
680,05000US17171,"Scott County, Illinois",133,120,76,49,137,147,115,254,283,924,240,170,109,0,984,324,150,164,-107,-33,186,-722,-70,133,760
681,05000US17173,"Shelby County, Illinois",464,407,408,134,347,533,809,1251,1151,3979,555,855,303,50,4875,1505,484,695,-91,105,431,-3533,-254,667,3284
682,05000US17175,"Stark County, Illinois",127,83,98,47,108,152,252,349,344,908,169,243,48,4,1395,353,55,90,-42,50,151,-991,-4,289,818
683,05000US17177,"Stephenson County, Illinois",1322,1705,1535,458,1069,1173,994,2085,2105,7667,1135,3000,1670,274,7869,3659,805,1383,187,-135,1253,-5702,-1574,1300,6284
684,05000US17179,"Tazewell County, Illinois",2359,2600,3269,1560,3215,1970,3040,6668,5974,25268,2020,6165,4075,770,18619,14299,4484,4865,339,-806,4005,-13609,-7631,1490,20403
685,05000US17181,"Union County, Illinois",378,288,339,105,212,502,588,1048,754,2732,500,650,145,35,2999,1209,433,789,-122,194,282,-1909,-161,321,1943
686,05000US17183,"Vermilion County, Illinois",2833,1747,1999,815,2019,1598,2267,3624,3267,11773,1935,3905,3290,290,15959,4249,1114,1239,898,-1291,2544,-12094,-625,2153,10534
687,05000US17185,"Wabash County, Illinois",453,263,204,84,207,265,354,540,512,2103,259,530,380,30,2679,660,249,194,194,-176,261,-2060,-120,263,1909
688,05000US17187,"Warren County, Illinois",429,349,495,174,286,274,437,999,675,2843,400,905,400,19,3205,1254,305,390,29,95,441,-2494,-255,370,2453
689,05000US17189,"Washington County, Illinois",196,279,289,163,327,286,462,877,796,2507,450,565,250,0,2764,1059,368,518,-254,39,490,-2016,-182,428,1989
690,05000US17191,"Wayne County, Illinois",473,299,357,129,406,383,685,887,858,2853,615,735,265,48,3790,1054,319,379,-142,92,487,-2722,-167,539,2474
691,05000US17193,"White County, Illinois",385,308,315,113,290,414,509,873,711,2454,535,655,170,40,3525,679,255,385,-150,145,363,-2602,194,456,2069
692,05000US17195,"Whiteside County, Illinois",1228,1204,1313,684,1358,733,1533,3155,2670,10472,875,2700,1900,320,9965,4790,1589,1855,353,-587,1722,-7699,-1635,1081,8617
693,05000US17197,"Will County, Illinois",10100,7914,9259,4715,10609,10539,14033,26765,23615,113544,4890,10640,19775,7280,45095,70325,29349,41735,5210,-10516,8044,-20523,-43560,-5734,71809
694,05000US17199,"Williamson County, Illinois",2145,1285,1479,684,1859,1339,1797,3557,3317,10584,1635,2865,2510,465,10559,5358,1550,2310,510,-1031,2078,-7423,-1801,1767,8274
695,05000US17201,"Winnebago County, Illinois",9765,7055,8249,4505,9190,3864,5858,11065,10630,46244,4805,11840,18205,3920,36095,28214,6044,6939,4960,-9956,9775,-26373,-17149,4586,39305
696,05000US17203,"Woodford County, Illinois",533,474,581,323,629,478,727,1669,1544,7876,499,1040,835,155,4224,3853,1960,2100,34,-254,797,-3019,-2184,-416,5776
697,05000US18001,"Adams County, Indiana",960,589,549,309,573,509,1139,1425,1595,5115,850,1230,765,120,4319,2695,1030,1490,110,-216,762,-2671,-1270,565,3625
698,05000US18003,"Allen County, Indiana",11040,8969,9755,4910,10565,5395,8145,15479,14128,56945,5615,18170,19205,2260,48910,29950,7769,12334,5425,-9450,13215,-35370,-14471,6359,44611
699,05000US18005,"Bartholomew County, Indiana",1925,1158,1805,1019,3220,1385,2075,3638,3323,12800,1425,2290,4345,1064,8765,7340,2265,4250,500,-2540,3175,-5305,-3702,1058,8550
700,05000US18007,"Benton County, Indiana",221,191,258,52,182,150,269,491,398,1304,149,500,239,4,1893,465,55,190,72,19,230,-1474,26,343,1114
701,05000US18009,"Blackford County, Indiana",290,274,379,75,213,228,545,918,674,1875,270,630,309,20,3129,600,190,175,20,70,268,-2356,318,484,1700
702,05000US18011,"Boone County, Indiana",1045,1210,1200,585,1805,634,1045,2590,2130,12495,690,1945,2380,850,5430,4894,2025,6140,355,-1180,1540,-3751,-2304,105,6355
703,05000US18013,"Brown County, Indiana",264,176,174,63,313,434,584,838,597,2599,214,270,425,80,1693,1635,690,1160,50,-251,296,-675,-797,-93,1439
704,05000US18015,"Carroll County, Indiana",221,242,323,193,450,344,540,1185,1025,3723,260,645,454,65,2995,1864,728,889,-39,-131,578,-2111,-679,297,2834
705,05000US18017,"Cass County, Indiana",764,990,898,276,958,579,1204,2254,1908,5683,695,1995,1089,100,7487,2425,675,574,69,-191,1134,-5704,-171,1233,5109
706,05000US18019,"Clark County, Indiana",2854,2280,3105,1474,2789,1769,3222,5489,4835,16741,2175,4245,5435,645,15075,10870,3044,2994,679,-2330,3618,-10084,-5381,1791,13747
707,05000US18021,"Clay County, Indiana",689,495,598,174,539,429,765,1284,1178,4784,570,930,950,44,4805,1920,689,964,119,-352,669,-3611,-636,489,3820
708,05000US18023,"Clinton County, Indiana",542,736,924,431,763,444,800,1238,1134,5118,450,1400,1500,64,4694,2358,679,980,92,-576,1130,-3450,-1120,455,4138
709,05000US18025,"Crawford County, Indiana",292,151,117,16,95,278,538,649,520,1475,290,255,124,15,2030,680,284,345,2,-7,96,-1214,-31,236,1130
710,05000US18027,"Daviess County, Indiana",767,629,770,330,497,702,805,1385,1150,4603,865,1015,995,139,4154,1785,979,1645,-98,-225,688,-2647,-400,171,2958
711,05000US18029,"Dearborn County, Indiana",1039,853,934,358,709,994,1233,2407,2331,8084,875,1980,915,125,5559,6120,1580,1957,164,19,942,-3332,-3713,751,6127
712,05000US18031,"Decatur County, Indiana",428,533,744,327,1124,435,455,1030,1025,4229,370,790,1935,70,2910,2209,875,1195,58,-1191,1381,-2020,-1179,150,3034
713,05000US18033,"DeKalb County, Indiana",670,830,1052,643,653,490,1004,2080,2065,7304,670,1475,1575,105,6209,3499,1305,1750,0,-523,1191,-4715,-1419,760,5554
714,05000US18035,"Delaware County, Indiana",5154,3175,3129,1600,3534,1957,2559,5064,4570,16679,2240,4985,7935,1410,18444,7135,1979,2824,2914,-4806,3724,-13928,-2071,2591,13855
715,05000US18037,"Dubois County, Indiana",1169,710,855,360,709,675,853,2280,2200,7369,850,2265,690,0,5214,3970,1490,2295,319,165,1069,-3686,-1690,710,5074
716,05000US18039,"Elkhart County, Indiana",4105,4165,4385,2839,7005,2085,3265,6745,6790,31905,2625,4600,13660,1610,17445,17075,6405,9295,1480,-9275,8234,-12095,-10330,385,22610
717,05000US18041,"Fayette County, Indiana",925,585,590,200,649,460,669,1310,1225,3144,455,1195,1280,4,4589,1350,440,385,470,-690,845,-3460,-40,785,2759
718,05000US18043,"Floyd County, Indiana",2434,1494,1680,839,1623,979,1798,3015,2730,12888,1675,2770,3474,130,7760,6649,2770,4265,759,-1794,2332,-4983,-3634,-40,8623
719,05000US18045,"Fountain County, Indiana",443,289,427,191,469,354,544,962,958,2733,500,755,520,43,3144,1270,375,434,-57,-93,617,-2246,-308,583,2299
720,05000US18047,"Franklin County, Indiana",267,404,512,279,274,410,725,855,895,4264,375,795,480,93,2504,2215,830,1770,-108,32,460,-1369,-1360,65,2494
721,05000US18049,"Fulton County, Indiana",373,207,555,163,509,525,634,979,1014,3165,400,845,450,100,3725,1195,540,800,-27,105,572,-2566,-216,474,2365
722,05000US18051,"Gibson County, Indiana",533,658,605,335,879,632,953,1668,1617,5848,575,1315,1080,55,5519,2535,1020,1350,-42,-475,1159,-3934,-867,597,4498
723,05000US18053,"Grant County, Indiana",2044,2055,1895,650,1629,1305,1664,3413,2983,9069,1360,3700,2815,390,12170,3785,1225,1390,684,-920,1889,-9201,-372,1758,7679
724,05000US18055,"Greene County, Indiana",719,429,511,328,598,564,1200,1704,1477,5614,835,1030,660,43,6054,2239,990,1154,-116,-149,883,-4290,-535,487,4460
725,05000US18057,"Hamilton County, Indiana",3055,3345,5030,3159,10515,2855,4040,8370,8050,66845,1520,3250,14930,5410,12744,30495,14020,33105,1535,-9900,8264,-5849,-22125,-5970,33740
726,05000US18059,"Hancock County, Indiana",1099,1343,1350,910,1520,939,1410,3114,3369,13369,495,2445,3084,195,7514,9384,2475,2330,604,-1734,2235,-5165,-6270,894,11039
727,05000US18061,"Harrison County, Indiana",569,739,494,143,629,959,1279,2385,2169,6060,675,1315,525,45,5454,4340,1265,1285,-106,-31,727,-3216,-1955,904,4775
728,05000US18063,"Hendricks County, Indiana",1605,1750,3409,1639,3760,1790,2505,6003,6169,29383,1080,2405,7075,1610,13230,19079,6275,6700,525,-3666,3789,-8935,-13076,-106,22683
729,05000US18065,"Henry County, Indiana",1304,943,1075,573,989,752,1334,2257,1983,7303,940,1905,1830,195,7973,3634,1019,1085,364,-755,1367,-5887,-1377,964,6218
730,05000US18067,"Howard County, Indiana",2710,2118,2050,995,3094,1415,1669,3349,3145,14590,1755,3320,5150,735,12910,6904,2075,2315,955,-3100,3354,-9826,-3555,1070,12275
731,05000US18069,"Huntington County, Indiana",645,900,798,373,749,594,989,1818,1624,6455,305,1610,1485,59,6030,2669,1080,1529,340,-687,1063,-4447,-851,544,4926
732,05000US18071,"Jackson County, Indiana",1215,760,965,520,1045,680,1188,2040,1785,6924,745,1590,1960,230,5795,3694,1509,1370,470,-995,1335,-3927,-1654,276,5554
733,05000US18073,"Jasper County, Indiana",595,482,729,455,620,444,590,1565,1299,5755,520,1015,1300,44,2640,4285,1135,1505,75,-571,1031,-1606,-2720,164,4250
734,05000US18075,"Jay County, Indiana",578,469,428,215,442,439,695,1228,1133,2799,585,1020,494,19,4034,1119,405,614,-7,-66,638,-2900,109,728,2185
735,05000US18077,"Jefferson County, Indiana",874,680,754,365,920,434,810,1420,1165,5450,475,1080,1885,144,4419,2670,1155,1295,399,-1131,1141,-3175,-1250,10,4155
736,05000US18079,"Jennings County, Indiana",580,504,600,185,895,580,650,1559,1489,4249,450,890,1320,100,4390,2344,639,690,130,-720,980,-3160,-785,850,3559
737,05000US18081,"Johnson County, Indiana",2800,3380,3754,1940,4025,1974,2795,5495,4860,24124,1600,5005,8345,955,17030,13024,3975,5515,1200,-4591,5010,-12261,-7529,885,18609
738,05000US18083,"Knox County, Indiana",1205,1219,1070,690,1215,505,853,1704,1639,5398,1135,1730,2385,140,5674,2225,855,954,70,-1315,1765,-4316,-521,784,4444
739,05000US18085,"Kosciusko County, Indiana",1334,1370,1710,910,2295,972,1815,3357,3152,14016,1345,2435,3355,505,8107,7079,2598,5164,-11,-1645,2700,-5320,-3722,554,8852
740,05000US18087,"LaGrange County, Indiana",353,321,568,289,645,494,674,1798,1558,5752,515,875,720,54,2688,2459,1404,3509,-162,-152,880,-1520,-661,154,2243
741,05000US18089,"Lake County, Indiana",17264,10585,11164,5330,12695,9338,11575,20750,16969,73240,10110,14160,28145,4625,53795,42285,14995,19715,7154,-16981,13400,-32882,-21535,1974,53525
742,05000US18091,"LaPorte County, Indiana",2515,3045,2790,1130,2790,1857,2500,4508,4183,18375,1725,3850,6005,680,13209,9280,3690,5159,790,-3215,3240,-8852,-4772,493,13216
743,05000US18093,"Lawrence County, Indiana",934,950,710,365,959,1062,1255,2379,2105,8095,920,1425,1470,100,7624,3570,1775,1919,14,-760,1224,-5307,-1191,330,6176
744,05000US18095,"Madison County, Indiana",3950,3590,3480,1580,3345,2517,3340,5790,5178,20005,2315,4910,8055,675,22860,8624,2349,2750,1635,-4575,4250,-17003,-2834,2829,17255
745,05000US18097,"Marion County, Indiana",50090,34750,37680,16410,29845,17267,20155,36234,29343,101555,14915,68140,74730,11000,116745,54060,11140,20900,35175,-37050,35255,-79323,-17826,18203,80655
746,05000US18099,"Marshall County, Indiana",1023,1043,834,344,989,714,1095,2255,1930,7416,780,1635,1655,153,4988,4865,1344,2123,243,-821,1180,-3179,-2610,586,5293
747,05000US18101,"Martin County, Indiana",298,140,179,59,149,203,395,471,492,1924,310,380,130,10,1964,729,395,419,-12,49,198,-1366,-258,97,1505
748,05000US18103,"Miami County, Indiana",1095,783,674,513,938,487,958,1699,1528,5194,910,1640,1330,125,6315,2045,670,699,185,-656,1326,-4870,-346,858,4495
749,05000US18105,"Monroe County, Indiana",9205,4335,4490,2029,5159,1720,1950,4408,3843,18718,2370,5745,12555,4550,8705,10170,4009,7373,6835,-8065,2638,-5035,-5762,-166,11345
750,05000US18107,"Montgomery County, Indiana",768,795,1189,499,990,518,669,1524,1675,6705,484,1810,1815,135,4885,3600,1240,1200,284,-626,1354,-3698,-2076,435,5505
751,05000US18109,"Morgan County, Indiana",1364,1065,1690,730,1190,1140,1699,3539,3014,10957,1070,3000,1845,135,8923,5964,2050,3035,294,-155,1785,-6084,-2425,964,7922
752,05000US18111,"Newton County, Indiana",343,249,238,123,423,259,474,848,749,1932,465,620,290,4,2233,1474,240,285,-122,-52,542,-1500,-626,509,1647
753,05000US18113,"Noble County, Indiana",860,879,1204,464,1249,524,1274,2315,2058,7865,755,1955,1745,205,6540,3779,1434,2095,105,-541,1508,-4742,-1464,624,5770
754,05000US18115,"Ohio County, Indiana",131,78,90,109,113,109,153,470,364,980,139,285,94,0,954,630,185,189,-8,-4,222,-692,-160,179,791
755,05000US18117,"Orange County, Indiana",474,441,482,217,313,533,675,1093,977,2887,635,810,475,14,3648,1485,335,619,-161,7,516,-2440,-392,642,2268
756,05000US18119,"Owen County, Indiana",348,463,398,198,389,468,628,1180,1090,3680,435,640,650,70,3275,1934,775,1025,-87,-252,517,-2179,-754,315,2655
757,05000US18121,"Parke County, Indiana",315,369,354,88,274,279,474,1075,885,2339,615,400,344,35,3144,899,370,575,-300,10,327,-2391,176,515,1764
758,05000US18123,"Perry County, Indiana",482,302,324,218,369,382,519,989,909,3320,495,815,359,25,3060,1505,559,737,-13,-35,562,-2159,-516,350,2583
759,05000US18125,"Pike County, Indiana",174,168,204,143,179,260,425,683,695,2337,275,330,249,29,2349,980,410,523,-101,-45,293,-1664,-297,285,1814
760,05000US18127,"Porter County, Indiana",3815,2394,3247,1595,4494,2660,3123,6358,5508,31260,1245,2610,9770,1925,10670,18960,6985,11660,2570,-6523,4164,-4887,-12602,-1477,19600
761,05000US18129,"Posey County, Indiana",468,356,227,289,385,409,583,1183,939,5417,369,675,539,130,3118,2959,1075,1378,99,-312,544,-2126,-1776,-136,4039
762,05000US18131,"Pulaski County, Indiana",319,214,295,153,259,360,293,698,674,2175,329,585,325,8,2364,875,415,390,-10,-30,404,-1711,-177,259,1785
763,05000US18133,"Putnam County, Indiana",520,620,810,295,1224,550,805,1614,1255,5544,395,1455,1490,129,4535,2925,980,1490,125,-680,1390,-3180,-1311,275,4054
764,05000US18135,"Randolph County, Indiana",715,409,530,304,588,583,844,1579,1269,3904,630,1175,715,10,5805,1339,490,500,85,-185,882,-4378,240,779,3404
765,05000US18137,"Ripley County, Indiana",563,513,735,246,539,343,599,1199,1284,5179,495,1110,915,84,3015,2719,1120,1854,68,-180,701,-2073,-1520,164,3325
766,05000US18139,"Rush County, Indiana",479,344,375,179,468,505,343,715,810,2639,294,895,615,29,2830,1074,505,570,185,-240,618,-1982,-359,305,2069
767,05000US18141,"St. Joseph County, Indiana",8460,6029,7410,3290,7135,4024,6063,10844,9630,40563,5160,8695,16245,2230,32240,20845,7455,9029,3300,-8835,8195,-22153,-10001,2175,31534
768,05000US18143,"Scott County, Indiana",319,545,480,189,710,360,500,925,720,4155,420,445,1190,170,3470,1940,530,930,-101,-710,729,-2610,-1015,190,3225
769,05000US18145,"Shelby County, Indiana",1025,1180,1022,534,930,943,1160,2012,2154,7035,740,2510,1350,80,7079,3735,890,1283,285,-328,1384,-4976,-1723,1264,5752
770,05000US18147,"Spencer County, Indiana",390,279,281,188,319,319,630,1045,944,3820,435,630,400,10,3369,1925,570,875,-45,-119,497,-2420,-880,374,2945
771,05000US18149,"Starke County, Indiana",503,255,448,150,399,545,819,1418,1059,3457,480,725,535,4,3943,1898,655,738,23,-87,545,-2579,-480,404,2719
772,05000US18151,"Steuben County, Indiana",372,500,909,293,989,439,829,1833,1499,6518,665,825,1480,100,4229,2900,1260,2643,-293,-571,1182,-2961,-1067,239,3875
773,05000US18153,"Sullivan County, Indiana",617,555,279,153,468,428,584,980,805,2855,550,625,840,45,3680,1050,420,520,67,-561,576,-2668,-70,385,2335
774,05000US18155,"Switzerland County, Indiana",229,237,294,150,349,350,362,655,410,1369,165,475,510,115,1438,825,440,435,64,-216,384,-726,-170,-30,934
775,05000US18157,"Tippecanoe County, Indiana",9365,5440,6805,3334,6585,1760,2445,4789,4223,24805,2560,7705,17485,3760,13675,13460,4330,6295,6805,-10680,6159,-9470,-8671,-107,18510
776,05000US18159,"Tipton County, Indiana",174,275,353,175,314,238,349,740,795,3063,305,505,445,40,2680,1333,580,570,-131,-92,449,-2093,-593,215,2493
777,05000US18161,"Union County, Indiana",104,174,219,97,169,94,180,455,355,1110,109,335,249,90,1155,545,175,230,-5,-30,176,-881,-90,180,880
778,05000US18163,"Vanderburgh County, Indiana",7020,5570,6260,2579,5495,3177,4255,8077,6925,27642,3035,7530,14780,1600,22685,14695,4820,6598,3985,-8520,6474,-15253,-6618,2105,21044
779,05000US18165,"Vermillion County, Indiana",423,320,347,186,365,267,511,1008,868,2535,535,605,460,39,3448,935,335,300,-112,-113,512,-2670,73,533,2235
780,05000US18167,"Vigo County, Indiana",4785,3420,3450,1324,3274,1683,2160,4248,3333,14319,2500,4575,7365,1815,15205,6169,1904,2370,2285,-3915,2783,-11362,-1921,1429,11949
781,05000US18169,"Wabash County, Indiana",774,640,695,319,933,513,841,1654,1689,5213,645,1435,1140,135,5560,2625,730,864,129,-445,1117,-4206,-971,959,4349
782,05000US18171,"Warren County, Indiana",117,121,98,79,140,77,224,489,458,1670,149,174,215,4,1470,1000,205,170,-32,-117,215,-1169,-511,253,1500
783,05000US18173,"Warrick County, Indiana",740,835,1180,559,1329,775,974,2358,2224,13105,645,975,2495,505,5149,6905,2705,4449,95,-1315,1383,-3400,-4547,-481,8656
784,05000US18175,"Washington County, Indiana",484,527,603,238,677,554,671,1139,1294,4655,720,750,975,88,3725,2555,705,1215,-236,-372,827,-2500,-1416,589,3440
785,05000US18177,"Wayne County, Indiana",2395,2009,1979,713,1520,1114,1845,3329,2709,9364,1405,3715,3180,310,10825,4425,1425,1584,990,-1201,1923,-7866,-1096,1284,7780
786,05000US18179,"Wells County, Indiana",475,425,689,209,454,489,668,1514,1339,4917,545,1090,490,130,4173,2694,944,979,-70,199,533,-3016,-1180,395,3938
787,05000US18181,"White County, Indiana",360,469,404,261,590,283,704,1229,1170,4293,515,780,735,75,4168,1954,730,1035,-155,-331,776,-3181,-725,440,3258
788,05000US18183,"Whitley County, Indiana",493,504,718,255,794,334,850,1664,1970,6394,480,1345,855,80,4275,3759,1025,1795,13,-137,969,-3091,-2095,945,4599
789,05000US19001,"Adair County, Iowa",210,154,145,83,162,134,258,444,368,1265,254,385,98,14,1653,518,180,170,-44,47,231,-1261,-74,188,1095
790,05000US19003,"Adams County, Iowa",81,45,77,80,75,92,132,290,261,649,219,115,29,8,850,289,75,149,-138,48,147,-626,1,186,500
791,05000US19005,"Allamakee County, Iowa",223,393,324,133,362,412,542,792,737,2353,380,835,185,15,2333,1255,363,744,-157,139,480,-1379,-463,374,1609
792,05000US19007,"Appanoose County, Iowa",429,319,227,94,245,452,545,887,868,1672,355,775,158,14,2824,743,170,380,74,69,325,-1827,144,698,1292
793,05000US19009,"Audubon County, Iowa",102,136,155,65,127,147,242,432,363,1099,258,245,65,4,1468,320,85,225,-156,90,188,-1079,112,278,874
794,05000US19011,"Benton County, Iowa",499,539,317,192,312,624,714,1417,1373,4538,750,885,189,49,4094,2490,1035,900,-251,128,455,-2756,-1073,338,3638
795,05000US19013,"Black Hawk County, Iowa",4859,3419,3945,1870,3860,2132,2900,5799,5077,20235,2210,7315,7275,1160,14090,12555,4215,4573,2649,-3330,4570,-9058,-6756,862,15662
796,05000US19015,"Boone County, Iowa",483,495,854,344,507,558,639,1308,1258,4815,675,1235,700,85,3909,2448,735,1259,-192,154,766,-2712,-1140,523,3556
797,05000US19017,"Bremer County, Iowa",514,340,298,284,313,494,778,1294,1224,4175,690,835,210,24,3739,2580,780,755,-176,88,573,-2467,-1286,444,3420
798,05000US19019,"Buchanan County, Iowa",333,376,433,228,315,473,699,1020,1005,3607,535,855,280,8,3214,1964,660,750,-202,153,535,-2042,-944,345,2857
799,05000US19021,"Buena Vista County, Iowa",539,528,583,408,509,260,419,889,837,2866,550,1415,540,44,2709,1383,438,578,-11,43,873,-2030,-494,399,2288
800,05000US19023,"Butler County, Iowa",188,252,359,178,357,395,360,853,733,2789,420,650,174,79,2645,1329,410,597,-232,185,456,-1890,-476,323,2192
801,05000US19025,"Calhoun County, Iowa",263,198,203,187,126,315,332,635,600,1624,324,544,84,19,2498,500,140,173,-61,119,294,-1851,135,460,1451
802,05000US19027,"Carroll County, Iowa",728,499,429,148,353,478,652,1053,947,3656,770,1139,245,4,3438,1984,433,770,-42,184,497,-2308,-931,514,2886
803,05000US19029,"Cass County, Iowa",449,345,450,238,375,277,514,709,805,2067,435,1025,360,30,2748,860,290,370,14,90,583,-1957,-151,515,1697
804,05000US19031,"Cedar County, Iowa",211,294,198,292,561,397,538,837,1007,3326,475,839,220,39,2598,2071,684,717,-264,-22,814,-1663,-1234,323,2609
805,05000US19033,"Cerro Gordo County, Iowa",1530,914,1385,648,1509,713,958,2417,2343,7467,925,2875,1920,240,6240,3778,1218,2214,605,-535,1917,-4569,-1361,1125,5253
806,05000US19035,"Cherokee County, Iowa",203,323,298,195,238,297,398,523,584,2373,445,705,80,20,2629,859,220,370,-242,218,413,-1934,-336,364,2003
807,05000US19037,"Chickasaw County, Iowa",223,283,240,131,257,218,474,744,724,2215,400,570,130,65,2395,1139,270,375,-177,110,323,-1703,-395,454,1840
808,05000US19039,"Clarke County, Iowa",334,177,158,148,424,187,294,409,459,1314,169,575,484,4,1495,729,150,309,165,-326,568,-1014,-320,309,1005
809,05000US19041,"Clay County, Iowa",573,594,445,190,445,253,490,878,909,2823,609,909,605,105,2704,1565,335,579,-36,-160,530,-1961,-687,574,2244
810,05000US19043,"Clayton County, Iowa",454,400,387,245,383,391,528,1008,999,3237,555,910,280,114,2922,1652,484,843,-101,107,514,-2003,-644,515,2394
811,05000US19045,"Clinton County, Iowa",1529,1054,1094,288,1170,755,1438,2735,2294,8239,1000,2480,1540,85,7645,4444,1099,1754,529,-446,1373,-5452,-1709,1195,6485
812,05000US19047,"Crawford County, Iowa",506,343,343,228,359,314,417,828,678,2499,530,1175,75,8,3074,920,350,405,-24,268,579,-2343,-92,328,2094
813,05000US19049,"Dallas County, Iowa",1263,1470,1499,1075,2504,825,1298,2388,2684,16714,895,2710,3235,960,5874,6969,4180,6800,368,-1736,2619,-3751,-4581,-1496,9914
814,05000US19051,"Davis County, Iowa",157,153,187,24,93,224,254,385,370,1409,174,340,88,15,1445,695,185,315,-17,99,102,-967,-310,185,1094
815,05000US19053,"Decatur County, Iowa",423,208,230,67,134,156,283,393,306,1038,380,550,120,20,1553,374,50,179,43,110,181,-1114,19,256,859
816,05000US19055,"Delaware County, Iowa",278,313,199,97,338,382,518,920,894,3288,430,635,119,55,2934,1364,605,845,-152,80,380,-2034,-444,289,2443
817,05000US19057,"Des Moines County, Iowa",1419,873,1028,424,939,720,1129,2263,2064,6520,850,1680,1915,230,6840,3390,815,1295,569,-887,1133,-4991,-1127,1249,5225
818,05000US19059,"Dickinson County, Iowa",465,498,348,259,368,364,454,1080,1056,3459,445,1020,410,65,2013,1840,578,1757,20,-62,562,-1195,-760,478,1702
819,05000US19061,"Dubuque County, Iowa",2640,2138,2235,1133,2443,1163,1835,4092,3859,17287,1525,4400,3895,790,8275,10439,3505,5429,1115,-1660,2786,-5277,-6347,354,11858
820,05000US19063,"Emmet County, Iowa",224,214,219,69,214,250,417,489,417,1700,255,415,180,80,2134,720,140,290,-31,39,203,-1467,-231,277,1410
821,05000US19065,"Fayette County, Iowa",444,449,553,217,322,388,621,1133,965,3353,390,1270,335,15,4214,1244,339,644,54,218,524,-3205,-111,626,2709
822,05000US19067,"Floyd County, Iowa",639,433,315,139,373,263,489,890,780,2758,570,960,335,45,2948,1200,395,539,69,-20,467,-2196,-310,385,2219
823,05000US19069,"Franklin County, Iowa",253,174,283,113,338,183,440,642,466,1523,340,599,190,40,2037,700,210,205,-87,93,411,-1414,-58,256,1318
824,05000US19071,"Fremont County, Iowa",151,178,178,104,132,125,215,331,353,1282,240,330,175,4,1420,553,120,239,-89,3,232,-1080,-222,233,1043
825,05000US19073,"Greene County, Iowa",242,187,285,98,208,217,230,480,387,1698,335,530,148,0,1863,610,190,299,-93,137,306,-1416,-130,197,1399
826,05000US19075,"Grundy County, Iowa",172,159,267,128,296,193,288,640,536,2649,284,555,129,45,1998,1220,415,534,-112,138,379,-1517,-580,121,2115
827,05000US19077,"Guthrie County, Iowa",240,169,239,71,154,349,386,603,672,1663,314,495,60,4,2188,579,255,649,-74,179,221,-1453,24,417,1014
828,05000US19079,"Hamilton County, Iowa",379,336,385,239,463,249,364,647,611,2767,404,829,510,59,2854,1045,190,495,-25,-125,643,-2241,-398,421,2272
829,05000US19081,"Hancock County, Iowa",215,259,195,126,279,216,319,593,595,2213,345,540,134,30,2153,910,335,409,-130,61,375,-1618,-317,260,1804
830,05000US19083,"Hardin County, Iowa",398,264,455,112,482,344,622,933,786,2969,660,765,150,125,3888,1159,204,405,-262,305,469,-2922,-226,582,2564
831,05000US19085,"Harrison County, Iowa",428,281,332,199,172,392,532,819,749,2249,510,770,119,4,3195,873,379,295,-82,213,367,-2271,-54,370,1954
832,05000US19087,"Henry County, Iowa",432,403,712,263,439,292,450,803,769,3295,420,1030,775,25,2984,1553,435,589,12,-63,677,-2242,-750,334,2706
833,05000US19089,"Howard County, Iowa",147,141,191,75,212,202,257,695,469,1564,265,405,53,55,1659,945,185,320,-118,138,232,-1200,-250,284,1244
834,05000US19091,"Humboldt County, Iowa",259,267,224,78,275,192,372,497,460,1673,325,635,95,55,1913,804,220,194,-66,129,298,-1349,-307,240,1479
835,05000US19093,"Ida County, Iowa",198,115,210,104,140,139,224,336,385,1267,385,345,14,24,1494,509,119,224,-187,196,220,-1131,-173,266,1043
836,05000US19095,"Iowa County, Iowa",319,354,407,188,262,319,399,817,823,3067,565,825,140,0,2324,1652,598,739,-246,267,450,-1606,-835,225,2328
837,05000US19097,"Jackson County, Iowa",449,418,391,328,307,490,632,1062,954,3654,440,995,455,4,3179,1764,620,1030,9,-64,631,-2057,-702,334,2624
838,05000US19099,"Jasper County, Iowa",779,838,773,487,928,592,1008,1528,1593,6283,605,1985,1075,155,5468,3405,880,1225,174,-302,1260,-3868,-1877,713,5058
839,05000US19101,"Jefferson County, Iowa",599,677,247,340,397,423,375,834,700,2563,315,1105,739,90,2389,1323,299,613,284,-492,647,-1591,-489,401,1950
840,05000US19103,"Johnson County, Iowa",8949,4660,4550,1900,3325,1746,2454,4993,4772,21081,2470,10569,8705,1645,9930,12848,5405,6215,6479,-4155,3580,-5730,-7855,-633,14866
841,05000US19105,"Jones County, Iowa",404,388,544,248,399,410,454,1017,933,3705,600,1015,315,70,3014,1689,540,1115,-196,229,577,-2150,-672,393,2590
842,05000US19107,"Keokuk County, Iowa",227,224,182,128,257,214,523,622,617,1691,280,560,164,12,2405,650,165,289,-53,18,373,-1668,-28,452,1402
843,05000US19109,"Kossuth County, Iowa",303,299,399,118,307,362,518,811,802,2999,360,705,259,70,3107,1224,340,705,-57,140,355,-2227,-413,462,2294
844,05000US19111,"Lee County, Iowa",974,800,684,309,768,787,1195,1925,1719,5594,830,1740,875,109,6865,2324,724,855,144,-191,968,-4883,-399,995,4739
845,05000US19113,"Linn County, Iowa",6140,5220,5235,2170,4204,3849,5619,11694,10674,37145,4595,12815,5115,445,32230,23275,5875,5805,1545,120,5929,-22762,-11581,4799,31340
846,05000US19115,"Louisa County, Iowa",247,142,229,174,212,221,314,566,539,1910,295,500,185,0,1934,823,349,313,-48,44,386,-1399,-257,190,1597
847,05000US19117,"Lucas County, Iowa",128,143,184,164,230,207,320,569,564,1434,284,325,215,25,1930,414,190,370,-156,-31,369,-1403,155,374,1064
848,05000US19119,"Lyon County, Iowa",89,142,133,118,206,196,324,605,589,2178,254,314,103,14,1973,967,450,500,-165,30,310,-1453,-362,139,1678
849,05000US19121,"Madison County, Iowa",394,258,413,134,287,284,545,810,770,2559,394,610,430,49,1970,1530,595,885,0,-17,372,-1141,-720,175,1674
850,05000US19123,"Mahaska County, Iowa",775,579,468,212,614,494,634,923,1001,3389,605,1325,690,24,3470,1749,605,590,170,-222,802,-2342,-826,396,2799
851,05000US19125,"Marion County, Iowa",920,544,734,408,1165,522,628,1682,1514,5383,850,1960,780,195,4017,2910,1084,1345,70,-46,1378,-2867,-1228,430,4038
852,05000US19127,"Marshall County, Iowa",818,1050,890,610,1275,498,952,1991,1817,5990,670,2420,1365,190,6305,3163,730,944,148,-475,1695,-4855,-1172,1087,5046
853,05000US19129,"Mills County, Iowa",339,259,259,123,220,158,384,783,653,2613,420,480,250,45,2060,1168,655,560,-81,9,298,-1518,-385,-2,2053
854,05000US19131,"Mitchell County, Iowa",144,123,179,92,160,223,404,592,517,1979,265,380,35,19,1859,943,369,479,-121,144,233,-1232,-351,148,1500
855,05000US19133,"Monona County, Iowa",202,460,176,202,179,262,342,557,418,1394,400,605,169,39,1948,544,145,276,-198,7,342,-1344,13,273,1118
856,05000US19135,"Monroe County, Iowa",153,159,146,124,219,214,213,481,522,1250,190,470,114,25,1430,539,190,390,-37,32,318,-1003,-58,332,860
857,05000US19137,"Montgomery County, Iowa",355,368,342,108,327,297,384,524,503,1490,345,740,374,30,2254,630,150,165,10,-32,405,-1573,-106,353,1325
858,05000US19139,"Muscatine County, Iowa",1065,666,895,665,1235,595,960,1953,1623,7082,930,1620,1825,140,5394,3909,1140,1664,135,-930,1760,-3839,-1956,483,5418
859,05000US19141,"O'Brien County, Iowa",364,444,296,274,382,234,351,640,685,2502,645,705,289,134,2529,1020,338,519,-281,7,522,-1944,-380,347,1983
860,05000US19143,"Osceola County, Iowa",119,73,173,104,163,139,262,306,300,1073,165,365,94,14,1269,513,125,155,-46,79,253,-868,-207,175,918
861,05000US19145,"Page County, Iowa",514,340,390,168,283,268,593,886,866,2434,495,900,235,59,3330,827,339,333,19,155,392,-2469,59,527,2101
862,05000US19147,"Palo Alto County, Iowa",104,203,312,94,244,149,303,412,432,1632,274,535,84,65,1949,675,209,189,-170,228,273,-1497,-263,223,1443
863,05000US19149,"Plymouth County, Iowa",468,482,434,241,481,367,662,1292,1138,4729,685,1170,240,19,3463,2599,864,1095,-217,194,703,-2434,-1307,274,3634
864,05000US19151,"Pocahontas County, Iowa",189,147,188,148,121,225,299,407,361,1284,345,355,64,25,1742,449,85,149,-156,124,244,-1218,-42,276,1135
865,05000US19153,"Polk County, Iowa",14395,10775,14095,7005,13405,7045,8995,17794,16775,73975,5760,25150,24810,3940,44285,47140,16840,15085,8635,-10715,16470,-28245,-29346,-65,58890
866,05000US19155,"Pottawattamie County, Iowa",3085,2244,3065,1072,2250,1826,2567,4604,4314,12814,2280,5910,3234,295,14024,6575,2349,2574,805,-169,3027,-9631,-1971,1965,10240
867,05000US19157,"Poweshiek County, Iowa",493,464,495,322,524,228,545,814,875,2995,420,995,785,75,2244,1785,490,960,73,-290,771,-1471,-971,385,2035
868,05000US19159,"Ringgold County, Iowa",116,112,97,67,136,92,238,272,240,812,219,230,65,4,1059,183,69,244,-103,32,199,-729,89,171,568
869,05000US19161,"Sac County, Iowa",173,178,212,164,246,195,368,527,522,1834,360,475,98,39,2265,725,190,345,-187,114,371,-1702,-198,332,1489
870,05000US19163,"Scott County, Iowa",4695,4044,4685,1893,5359,2542,3541,6327,5977,28943,2355,8060,8285,1970,15900,15609,5255,10439,2340,-3600,5282,-9817,-9282,722,18504
871,05000US19165,"Shelby County, Iowa",265,224,228,167,188,286,304,794,470,2293,355,514,194,4,2273,1112,360,290,-90,34,351,-1683,-318,110,2003
872,05000US19167,"Sioux County, Iowa",620,405,535,224,633,436,532,1674,1579,5787,765,1270,275,105,4134,3040,1025,1609,-145,260,752,-3166,-1366,554,4178
873,05000US19169,"Story County, Iowa",6619,3545,3520,1304,2979,1015,1209,2578,2283,12529,2380,7650,6814,1124,6200,7460,2779,2849,4239,-3294,3159,-3976,-4882,-496,9680
874,05000US19171,"Tama County, Iowa",315,268,337,226,355,277,473,786,696,3080,580,615,230,85,3114,1275,379,570,-265,107,496,-2364,-489,317,2510
875,05000US19173,"Taylor County, Iowa",86,180,160,113,121,213,202,387,366,1019,210,365,52,23,1444,375,80,199,-124,108,211,-1029,12,286,820
876,05000US19175,"Union County, Iowa",333,464,308,208,263,298,359,664,613,1963,355,834,225,150,2364,870,270,349,-22,83,321,-1707,-206,343,1614
877,05000US19177,"Van Buren County, Iowa",143,82,143,32,77,177,249,460,414,1142,225,189,40,18,1619,430,110,284,-82,103,91,-1193,30,304,858
878,05000US19179,"Wapello County, Iowa",1270,1030,857,413,534,943,1205,2174,1954,4924,1020,1815,1179,105,7063,2054,600,835,250,-322,842,-4915,120,1354,4089
879,05000US19181,"Warren County, Iowa",994,900,1144,467,764,638,872,2024,1874,9215,765,2275,975,270,4919,4835,2180,2509,229,169,961,-3409,-2811,-306,6706
880,05000US19183,"Washington County, Iowa",410,523,779,133,524,252,520,957,994,3784,515,1225,565,69,2978,1903,665,910,-105,214,588,-2206,-946,329,2874
881,05000US19185,"Wayne County, Iowa",122,127,132,40,83,230,244,488,372,922,259,208,34,4,1539,295,100,210,-137,98,119,-1065,193,272,712
882,05000US19187,"Webster County, Iowa",1169,1335,1005,510,855,986,1124,1939,1515,5113,1255,2305,1095,210,6374,2480,803,853,-86,-90,1155,-4264,-541,712,4260
883,05000US19189,"Winnebago County, Iowa",249,224,260,137,304,207,398,557,603,1824,340,660,135,50,2246,840,195,195,-91,125,391,-1641,-283,408,1629
884,05000US19191,"Winneshiek County, Iowa",422,343,339,103,579,425,508,873,1077,3596,500,860,290,130,2270,2025,868,1259,-78,49,552,-1337,-1152,209,2337
885,05000US19193,"Woodbury County, Iowa",3004,2694,2749,1374,3220,1329,2468,4528,3968,14932,2180,5140,5240,480,13985,7473,2285,2520,824,-2491,4114,-10188,-2945,1683,12412
886,05000US19195,"Worth County, Iowa",173,96,169,34,148,178,236,462,427,1384,244,285,69,19,1574,720,160,145,-71,100,163,-1160,-258,267,1239
887,05000US19197,"Wright County, Iowa",345,338,293,158,387,254,450,824,629,2024,410,795,235,80,3034,708,180,205,-65,58,465,-2330,116,449,1819
888,05000US20001,"Allen County, Kansas",363,225,356,149,383,341,353,712,556,2025,435,660,390,8,2839,735,205,224,-72,-34,524,-2145,-23,351,1801
889,05000US20003,"Anderson County, Kansas",112,180,263,149,234,195,367,399,343,1183,195,425,175,130,1413,475,175,264,-83,88,253,-851,-76,168,919
890,05000US20005,"Atchison County, Kansas",398,429,283,193,480,271,449,609,628,2390,435,715,580,50,2379,940,320,595,-37,-297,623,-1659,-331,308,1795
891,05000US20007,"Barber County, Kansas",163,88,91,18,237,160,88,182,193,755,274,204,119,8,999,255,40,109,-111,-28,247,-751,-73,153,646
892,05000US20009,"Barton County, Kansas",704,770,694,319,1049,520,675,1359,1164,4350,730,1690,1020,100,5130,1590,575,660,-26,-326,1268,-3935,-231,589,3690
893,05000US20011,"Bourbon County, Kansas",485,340,408,132,303,278,513,885,684,2024,395,640,535,95,2634,800,244,384,90,-127,340,-1843,85,440,1640
894,05000US20013,"Brown County, Kansas",210,203,311,180,272,124,248,518,444,1604,329,485,328,24,1823,645,219,190,-119,-17,428,-1451,-127,225,1414
895,05000US20015,"Butler County, Kansas",1448,1299,1529,604,1580,824,1355,2618,2189,11318,930,2605,2210,710,7583,6480,1795,2439,518,-681,1474,-5404,-3862,394,8879
896,05000US20017,"Chase County, Kansas",58,54,52,16,58,61,108,186,190,413,98,105,30,0,544,175,49,99,-40,22,74,-375,11,141,314
897,05000US20019,"Chautauqua County, Kansas",62,88,71,47,65,107,121,261,263,497,128,114,69,10,794,174,65,115,-66,2,102,-566,87,198,382
898,05000US20021,"Cherokee County, Kansas",364,595,439,310,314,434,729,1263,1149,2990,520,730,725,35,4040,1080,350,560,-156,-286,589,-2877,183,799,2430
899,05000US20023,"Cheyenne County, Kansas",74,26,69,28,44,70,109,148,126,529,128,79,33,4,685,130,105,104,-54,36,68,-506,18,21,425
900,05000US20025,"Clark County, Kansas",12,26,107,20,116,59,56,98,77,353,94,85,98,0,490,145,30,29,-82,9,136,-375,-47,47,324
901,05000US20027,"Clay County, Kansas",88,96,254,99,180,283,275,280,333,1555,129,349,164,65,1820,610,275,180,-41,90,214,-1262,-330,58,1375
902,05000US20029,"Cloud County, Kansas",194,242,288,115,197,119,241,607,482,1593,284,480,264,24,2154,494,180,135,-90,24,288,-1794,113,302,1458
903,05000US20031,"Coffey County, Kansas",218,158,217,98,162,201,258,377,383,1565,255,515,79,4,1579,713,200,305,-37,138,256,-1120,-336,183,1260
904,05000US20033,"Comanche County, Kansas",20,28,18,14,63,44,54,109,85,303,63,55,19,0,439,80,19,45,-43,-1,77,-341,29,66,258
905,05000US20035,"Cowley County, Kansas",1029,920,911,569,1237,595,841,1373,1368,5188,815,1455,2185,210,5800,1975,615,894,214,-1274,1596,-4364,-602,753,4294
906,05000US20037,"Crawford County, Kansas",1924,1173,1430,477,1089,647,835,1470,1315,4988,875,1730,2880,590,5450,1879,885,910,1049,-1450,976,-3968,-409,430,4078
907,05000US20039,"Decatur County, Kansas",58,72,59,85,127,93,170,162,172,511,119,190,89,10,809,190,39,54,-61,-30,202,-546,-28,133,457
908,05000US20041,"Dickinson County, Kansas",438,504,433,232,509,363,464,973,934,3186,500,830,645,140,3065,1548,687,685,-62,-212,601,-2238,-575,247,2501
909,05000US20043,"Doniphan County, Kansas",155,173,178,73,299,98,273,368,399,1215,209,345,299,4,1339,513,180,235,-54,-121,368,-968,-145,219,980
910,05000US20045,"Douglas County, Kansas",5775,4440,4580,2230,4695,1104,1464,2580,2459,15975,1760,7095,11295,1595,4505,10475,3670,4919,4015,-6715,5330,-1937,-7895,-1211,11056
911,05000US20047,"Edwards County, Kansas",58,40,36,54,107,48,87,167,166,586,115,109,49,4,838,94,39,74,-57,-13,157,-703,73,127,512
912,05000US20049,"Elk County, Kansas",62,59,47,16,26,62,114,212,195,433,79,104,25,4,810,70,58,50,-17,22,38,-634,142,137,383
913,05000US20051,"Ellis County, Kansas",1155,1034,1108,418,724,489,580,939,869,4558,775,2275,1285,110,2390,2845,1074,1095,380,-177,1032,-1321,-1906,-205,3463
914,05000US20053,"Ellsworth County, Kansas",164,125,118,68,120,164,229,317,333,978,245,224,80,40,1255,454,100,149,-81,38,148,-862,-137,233,829
915,05000US20055,"Finney County, Kansas",575,634,1085,689,1804,459,739,1254,1049,4785,815,940,2845,194,3140,2759,960,1110,-240,-1760,2299,-1942,-1505,89,3675
916,05000US20057,"Ford County, Kansas",530,954,880,684,1199,264,702,1099,1054,4263,465,1235,2160,375,3645,2144,474,909,65,-1280,1508,-2679,-1045,580,3354
917,05000US20059,"Franklin County, Kansas",580,473,698,278,734,409,543,1244,1170,4038,349,1085,1210,109,3389,2435,449,1094,231,-512,903,-2437,-1191,721,2944
918,05000US20061,"Geary County, Kansas",935,855,1945,1270,2864,358,290,844,599,3174,440,780,3160,3500,1875,1559,1114,680,495,-1215,634,-1227,-715,-515,2494
919,05000US20063,"Gove County, Kansas",46,39,80,26,82,55,76,163,139,547,114,88,45,20,660,203,29,45,-68,35,88,-529,-40,110,502
920,05000US20065,"Graham County, Kansas",95,49,42,19,45,47,102,232,212,508,119,89,23,18,755,178,50,55,-24,19,46,-606,54,162,453
921,05000US20067,"Grant County, Kansas",105,165,120,43,118,115,150,230,284,1200,195,275,95,0,1255,485,155,175,-90,25,161,-990,-255,129,1025
922,05000US20069,"Gray County, Kansas",78,63,123,80,179,66,136,218,291,974,129,305,69,14,845,499,134,160,-51,54,245,-643,-281,157,814
923,05000US20071,"Greeley County, Kansas",29,32,8,18,89,4,28,71,82,185,54,65,45,14,190,73,8,44,-25,-37,93,-158,-2,74,141
924,05000US20073,"Greenwood County, Kansas",159,171,177,68,157,125,227,462,390,1037,259,335,124,4,1616,294,80,208,-100,53,221,-1264,168,310,829
925,05000US20075,"Hamilton County, Kansas",16,24,74,36,119,19,83,117,133,312,135,89,45,4,468,100,30,24,-119,29,151,-366,17,103,288
926,05000US20077,"Harper County, Kansas",101,142,128,68,195,167,138,297,296,928,153,229,224,35,1279,309,65,104,-52,-96,228,-974,-12,231,824
927,05000US20079,"Harvey County, Kansas",1108,849,794,352,809,380,621,1494,1737,5388,605,1990,1154,160,5069,3228,705,855,503,-360,1001,-4068,-1734,1032,4533
928,05000US20081,"Haskell County, Kansas",27,55,47,64,116,81,88,176,132,570,158,89,58,4,589,279,54,124,-131,-11,176,-420,-103,78,446
929,05000US20083,"Hodgeman County, Kansas",19,41,98,8,53,37,57,96,90,324,130,75,15,0,374,90,40,65,-111,83,61,-280,6,50,259
930,05000US20085,"Jackson County, Kansas",339,333,305,80,308,201,230,760,649,2255,465,490,288,95,1855,1170,385,554,-126,17,293,-1424,-410,264,1701
931,05000US20087,"Jefferson County, Kansas",239,224,324,191,407,379,499,1060,1050,3644,290,650,435,25,2600,2185,765,795,-51,-111,573,-1722,-1125,285,2849
932,05000US20089,"Jewell County, Kansas",42,76,70,14,72,90,195,146,128,581,123,105,48,4,925,150,14,40,-81,22,82,-640,-4,114,541
933,05000US20091,"Johnson County, Kansas",9804,10259,17525,8303,23775,5018,7359,16663,15949,112277,4745,12830,42450,9645,20795,61225,27654,46195,5059,-24925,22433,-8418,-44562,-11705,66082
934,05000US20093,"Kearny County, Kansas",55,25,57,25,114,97,28,153,134,533,89,110,69,10,520,214,89,140,-34,-12,129,-395,-61,45,393
935,05000US20095,"Kingman County, Kansas",122,142,183,80,188,123,197,443,418,1390,205,364,129,0,1600,439,204,260,-83,54,268,-1280,4,214,1130
936,05000US20097,"Kiowa County, Kansas",62,52,86,41,102,49,66,105,87,377,110,125,80,4,322,174,114,85,-48,6,139,-207,-69,-27,292
937,05000US20099,"Labette County, Kansas",594,623,489,150,519,293,571,874,874,3302,570,955,750,90,4189,1004,399,428,24,-261,579,-3325,-130,475,2874
938,05000US20101,"Lane County, Kansas",44,28,54,18,38,59,112,98,106,348,94,55,30,0,480,75,25,69,-50,24,56,-309,23,81,279
939,05000US20103,"Leavenworth County, Kansas",1645,1349,1805,1119,2795,1209,1335,2845,2524,11135,1085,3430,2920,1270,7115,6649,2485,2630,560,-1115,2644,-4571,-3804,39,8505
940,05000US20105,"Lincoln County, Kansas",67,36,47,36,62,70,95,198,197,527,114,102,24,4,855,104,34,59,-47,23,94,-690,94,163,468
941,05000US20107,"Linn County, Kansas",332,188,238,130,157,564,459,730,565,1162,415,489,105,30,2290,790,165,189,-83,133,257,-1267,-60,400,973
942,05000US20109,"Logan County, Kansas",57,29,142,19,49,65,84,177,160,466,104,88,84,15,588,159,60,70,-47,58,53,-439,18,100,396
943,05000US20111,"Lyon County, Kansas",1369,1150,1519,545,1159,287,567,1239,1008,4924,664,2455,2365,270,4305,1814,665,1119,705,-846,1434,-3451,-575,343,3805
944,05000US20113,"McPherson County, Kansas",624,524,977,447,848,431,563,1481,1402,5093,814,1520,985,95,3664,3173,894,1105,-190,-8,1200,-2670,-1692,508,3988
945,05000US20115,"Marion County, Kansas",191,227,210,111,242,262,421,664,664,2053,309,460,168,34,2749,729,194,344,-118,42,319,-2066,-65,470,1709
946,05000US20117,"Marshall County, Kansas",112,229,283,160,227,183,382,474,423,1820,294,520,204,4,1983,564,210,439,-182,79,383,-1418,-90,213,1381
947,05000US20119,"Meade County, Kansas",62,134,62,34,182,72,81,201,250,738,200,205,72,0,760,286,63,90,-138,-10,216,-607,-85,187,648
948,05000US20121,"Miami County, Kansas",874,415,824,225,479,589,875,1630,1470,5629,495,1360,835,125,3625,3254,1285,1960,379,-11,579,-2161,-1624,185,3669
949,05000US20123,"Mitchell County, Kansas",159,161,182,119,145,143,246,273,380,996,259,339,135,25,1367,365,150,120,-100,47,239,-978,-92,230,876
950,05000US20125,"Montgomery County, Kansas",888,913,960,374,923,791,908,1634,1394,5252,955,1505,1500,100,6964,1749,490,845,-67,-540,1197,-5265,-115,904,4407
951,05000US20127,"Morris County, Kansas",146,78,112,43,133,72,194,268,262,1094,139,204,164,4,1014,349,234,280,7,-52,172,-748,-81,28,814
952,05000US20129,"Morton County, Kansas",72,64,86,58,68,37,59,122,149,459,114,135,98,10,514,175,80,64,-42,-12,116,-418,-53,69,395
953,05000US20131,"Nemaha County, Kansas",187,278,238,88,245,266,224,574,549,1693,345,600,70,38,1713,504,339,550,-158,168,295,-1223,70,210,1143
954,05000US20133,"Neosho County, Kansas",575,396,317,219,448,345,518,729,623,2579,380,1030,479,80,3194,772,375,385,195,-162,587,-2331,-43,248,2194
955,05000US20135,"Ness County, Kansas",42,24,86,30,58,97,137,171,161,568,84,110,34,12,827,135,59,70,-42,52,76,-593,36,102,498
956,05000US20137,"Norton County, Kansas",66,31,136,64,148,46,217,267,254,788,164,89,144,49,1235,79,70,85,-98,-8,163,-972,188,184,703
957,05000US20139,"Osage County, Kansas",492,297,372,199,308,446,475,804,749,2697,500,735,350,89,2859,1278,424,499,-8,22,418,-1938,-474,325,2198
958,05000US20141,"Osborne County, Kansas",85,89,114,38,151,138,142,136,185,628,165,230,79,4,949,180,50,50,-80,35,185,-669,-44,135,578
959,05000US20143,"Ottawa County, Kansas",95,66,100,69,78,109,153,468,378,1068,130,183,88,8,1239,440,160,215,-35,12,139,-977,28,218,853
960,05000US20145,"Pawnee County, Kansas",70,95,230,139,230,100,50,467,417,1023,315,285,160,0,1469,150,135,80,-245,70,369,-1319,317,282,943
961,05000US20147,"Phillips County, Kansas",70,126,147,101,89,73,153,392,306,989,149,224,94,40,1269,359,110,75,-79,53,150,-1043,33,196,914
962,05000US20149,"Pottawatomie County, Kansas",314,302,501,231,503,374,503,833,968,4244,215,675,685,265,1953,2304,930,1615,99,-184,469,-1076,-1471,38,2629
963,05000US20151,"Pratt County, Kansas",229,138,168,205,329,136,263,449,455,1538,135,415,464,60,1608,524,210,349,94,-296,474,-1209,-75,245,1189
964,05000US20153,"Rawlins County, Kansas",24,59,79,34,94,37,130,140,117,464,123,139,35,0,570,155,40,100,-99,44,128,-403,-15,77,364
965,05000US20155,"Reno County, Kansas",1644,1490,1685,890,2109,778,1319,2598,2719,10352,1020,2515,3635,655,9555,4724,1445,1715,624,-1950,2344,-7458,-2126,1274,8637
966,05000US20157,"Republic County, Kansas",94,77,171,83,137,148,215,251,253,934,204,264,70,25,1364,154,95,195,-110,101,195,-1001,97,158,739
967,05000US20159,"Rice County, Kansas",263,266,151,102,294,207,280,456,412,1555,345,605,99,25,2113,564,140,125,-82,52,371,-1626,-108,272,1430
968,05000US20161,"Riley County, Kansas",3519,2214,4215,1930,3528,364,579,1299,1320,8115,1415,2305,8205,3475,2245,3909,2200,3010,2104,-3990,1983,-1302,-2610,-880,5105
969,05000US20163,"Rooks County, Kansas",66,113,102,48,92,138,195,257,297,894,148,219,54,4,1164,289,100,220,-82,48,136,-831,-32,197,674
970,05000US20165,"Rush County, Kansas",97,83,77,29,42,48,107,242,243,590,119,155,40,4,884,160,60,50,-22,37,67,-729,82,183,540
971,05000US20167,"Russell County, Kansas",183,193,235,29,112,108,197,407,353,1558,234,345,149,20,1455,635,74,264,-51,86,121,-1150,-228,279,1294
972,05000US20169,"Saline County, Kansas",1359,1475,1909,734,1978,714,1215,2168,2058,8939,860,2455,3560,570,6405,4979,1664,2194,499,-1651,2142,-4476,-2811,394,6745
973,05000US20171,"Scott County, Kansas",45,45,80,60,295,50,80,260,320,960,85,160,190,100,735,350,160,330,-40,-110,255,-605,-90,160,630
974,05000US20173,"Sedgwick County, Kansas",17135,13730,15810,7569,16225,8120,9973,19609,17990,73467,6945,28705,30425,4380,58575,43495,9785,15054,10190,-14615,19414,-40482,-23886,8205,58413
975,05000US20175,"Seward County, Kansas",445,415,553,208,959,379,374,945,779,2699,270,775,1360,190,2750,1509,390,335,175,-807,977,-1997,-564,389,2364
976,05000US20177,"Shawnee County, Kansas",6004,5060,5805,2684,5654,2130,3520,6495,6205,28970,3555,9300,10330,2000,22050,15890,4300,4975,2449,-4525,6338,-16400,-9395,1905,23995
977,05000US20179,"Sheridan County, Kansas",33,58,35,33,84,22,104,153,131,519,129,89,30,4,598,155,50,85,-96,5,113,-472,-2,81,434
978,05000US20181,"Sherman County, Kansas",148,165,159,98,380,64,159,214,290,1094,160,359,355,75,1105,380,145,150,-12,-196,403,-882,-166,145,944
979,05000US20183,"Smith County, Kansas",89,96,68,33,107,77,157,203,202,672,175,154,28,23,1018,155,44,105,-86,40,117,-784,48,158,567
980,05000US20185,"Stafford County, Kansas",67,82,42,30,73,119,122,291,298,773,94,124,65,10,1204,195,99,60,-27,-23,93,-963,96,199,713
981,05000US20187,"Stanton County, Kansas",8,44,53,18,46,75,63,109,123,270,94,59,20,0,430,70,65,60,-86,33,64,-292,39,58,210
982,05000US20189,"Stevens County, Kansas",125,85,93,64,179,150,82,123,102,970,160,235,150,0,735,320,235,130,-35,-57,243,-503,-197,-133,840
983,05000US20191,"Sumner County, Kansas",649,474,559,189,537,594,641,1093,1053,3742,620,995,730,50,4719,1369,270,618,29,-171,676,-3484,-276,783,3124
984,05000US20193,"Thomas County, Kansas",328,115,190,109,99,169,270,348,377,1379,375,430,25,10,1439,534,240,240,-47,165,198,-1000,-186,137,1139
985,05000US20195,"Trego County, Kansas",18,56,114,18,84,28,98,144,174,689,98,125,65,4,789,189,50,85,-80,49,98,-663,-45,124,604
986,05000US20197,"Wabaunsee County, Kansas",103,55,112,60,89,134,253,424,304,1298,134,154,124,4,1240,575,235,309,-31,-12,145,-853,-151,69,989
987,05000US20199,"Wallace County, Kansas",20,22,40,12,38,48,76,72,47,260,84,29,8,10,345,90,14,29,-64,32,40,-221,-18,33,231
988,05000US20201,"Washington County, Kansas",89,76,134,31,148,118,154,281,267,1059,199,185,79,8,1375,270,50,230,-110,55,171,-1103,11,217,829
989,05000US20203,"Wichita County, Kansas",18,18,90,55,78,48,44,155,109,360,110,99,50,4,375,115,45,90,-92,40,129,-283,40,64,270
990,05000US20205,"Wilson County, Kansas",274,189,227,45,268,178,318,503,498,1524,245,390,324,55,2150,360,119,239,29,-97,258,-1654,143,379,1285
991,05000US20207,"Woodson County, Kansas",101,38,57,39,44,129,256,206,203,562,108,123,49,0,1013,155,59,65,-7,8,83,-628,51,144,497
992,05000US20209,"Wyandotte County, Kansas",9310,4815,5694,2160,3260,3613,5278,7565,5649,13317,4695,11285,8565,685,26099,6280,1249,1133,4615,-2871,4735,-17208,1285,4400,12184
993,05000US21001,"Adair County, Kentucky",530,355,278,274,275,442,665,925,825,2938,580,640,440,45,2774,1114,550,1010,-50,-162,504,-1667,-189,275,1928
994,05000US21003,"Allen County, Kentucky",440,510,394,278,550,440,559,920,815,3084,510,595,975,90,2520,1415,679,1159,-70,-581,738,-1521,-495,136,1925
995,05000US21005,"Anderson County, Kentucky",508,304,575,304,329,458,479,1059,1114,3644,430,945,650,4,2215,2629,800,930,78,-75,629,-1278,-1570,314,2714
996,05000US21007,"Ballard County, Kentucky",194,138,115,115,130,148,248,499,372,1368,275,220,165,39,1184,649,175,560,-81,-50,206,-788,-150,197,808
997,05000US21009,"Barren County, Kentucky",1440,844,1139,615,1705,779,1050,1660,1450,6824,860,1160,3115,585,3990,3335,1380,2730,580,-1976,1735,-2161,-1675,70,4094
998,05000US21011,"Bath County, Kentucky",268,257,284,124,268,344,334,518,417,1894,315,285,500,110,1850,725,275,514,-47,-216,282,-1172,-207,142,1380
999,05000US21013,"Bell County, Kentucky",1715,810,512,284,554,1140,1024,1555,1205,2703,1435,1170,1055,215,4815,1300,485,705,280,-543,623,-2651,255,720,1998
1000,05000US21015,"Boone County, Kentucky",2075,1999,2895,1695,3530,1774,2500,4704,3729,21705,1110,3925,5915,1260,9325,14125,4415,6220,965,-3020,3965,-5051,-9421,-686,15485
1001,05000US21017,"Bourbon County, Kentucky",814,764,664,312,490,377,518,874,830,2704,965,1445,580,70,2135,1479,405,1074,-151,84,732,-1240,-605,425,1630
1002,05000US21019,"Boyd County, Kentucky",1879,929,1060,405,1485,984,885,1797,1903,8338,1745,1285,2300,429,6525,3294,2030,1990,134,-1240,1461,-4656,-1497,-127,6348
1003,05000US21021,"Boyle County, Kentucky",715,768,915,368,863,344,685,1053,1009,4485,600,850,2055,129,2330,1795,1174,2074,115,-1140,1102,-1301,-742,-165,2411
1004,05000US21023,"Bracken County, Kentucky",430,226,115,63,113,399,343,497,403,944,390,535,25,4,1725,477,150,179,40,90,172,-983,20,253,765
1005,05000US21025,"Breathitt County, Kentucky",591,303,235,83,228,601,704,700,589,1534,630,460,295,54,2904,454,174,420,-39,-60,257,-1599,246,415,1114
1006,05000US21027,"Breckinridge County, Kentucky",342,417,361,125,388,422,664,960,750,3200,540,690,365,34,3055,1605,560,810,-198,-4,479,-1969,-645,190,2390
1007,05000US21029,"Bullitt County, Kentucky",1265,1050,1335,590,1094,1390,2315,3843,3908,13179,1075,2325,1860,80,8370,9149,3140,3305,190,-525,1604,-4665,-5306,768,9874
1008,05000US21031,"Butler County, Kentucky",329,280,340,136,285,303,318,508,483,2193,345,395,555,74,1700,984,299,739,-16,-215,347,-1079,-476,184,1454
1009,05000US21033,"Caldwell County, Kentucky",500,66,260,73,540,194,594,499,449,2220,440,585,380,25,1745,1204,290,739,60,-120,588,-957,-705,159,1481
1010,05000US21035,"Calloway County, Kentucky",2039,838,919,537,1050,610,879,1330,1300,5675,845,1675,2270,579,3195,2495,1855,2070,1194,-1351,1008,-1706,-1165,-555,3605
1011,05000US21037,"Campbell County, Kentucky",3124,2204,2400,1089,2374,1894,2068,3954,3469,14095,1625,4895,4355,315,9270,8854,2905,4245,1499,-1955,3148,-5308,-4900,564,9850
1012,05000US21039,"Carlisle County, Kentucky",87,87,138,23,102,84,204,347,239,814,85,139,160,29,810,235,170,349,2,-22,96,-522,112,69,465
1013,05000US21041,"Carroll County, Kentucky",284,349,160,94,447,190,268,283,194,1690,195,340,600,195,1050,659,189,763,89,-440,346,-592,-376,5,927
1014,05000US21043,"Carter County, Kentucky",758,344,488,184,560,695,908,1480,1470,4125,715,900,650,69,4169,1620,720,1615,43,-162,675,-2566,-140,750,2510
1015,05000US21045,"Casey County, Kentucky",242,308,273,173,259,659,810,778,819,2408,495,610,154,8,2878,954,290,995,-253,119,424,-1409,-176,529,1413
1016,05000US21047,"Christian County, Kentucky",2734,1855,3025,1644,3965,965,864,1519,1665,7304,1530,2640,6815,2265,5220,3755,1075,2229,1204,-3790,3344,-3391,-2236,590,5075
1017,05000US21049,"Clark County, Kentucky",1320,1265,1025,299,974,695,779,1374,1425,5225,1095,2305,1455,25,4015,3335,865,1419,225,-430,1248,-2541,-1961,560,3806
1018,05000US21051,"Clay County, Kentucky",804,570,303,133,400,1160,908,748,768,2154,895,715,525,79,3768,959,280,549,-91,-222,454,-1700,-211,488,1605
1019,05000US21053,"Clinton County, Kentucky",275,280,264,110,284,234,394,630,540,1220,430,515,240,25,1839,460,229,340,-155,24,369,-1211,170,311,880
1020,05000US21055,"Crittenden County, Kentucky",115,179,118,78,204,329,288,589,559,1488,210,360,114,15,1719,700,225,409,-95,4,267,-1102,-111,334,1079
1021,05000US21057,"Cumberland County, Kentucky",255,109,153,42,255,210,247,284,284,948,400,195,214,4,859,460,230,348,-145,-61,293,-402,-176,54,600
1022,05000US21059,"Daviess County, Kentucky",2815,2210,2915,1595,3300,1685,1859,3914,3334,16533,2050,3260,6530,990,10880,8369,2975,4824,765,-3615,3905,-7336,-4455,359,11709
1023,05000US21061,"Edmonson County, Kentucky",272,193,117,69,316,379,479,767,729,1909,224,395,234,85,2234,969,250,494,48,-117,300,-1376,-202,479,1415
1024,05000US21063,"Elliott County, Kentucky",291,144,48,24,100,310,254,402,377,825,280,135,194,4,1225,419,200,245,11,-146,120,-661,-17,177,580
1025,05000US21065,"Estill County, Kentucky",508,383,312,141,318,504,554,635,638,1924,440,600,600,14,2389,744,350,559,68,-288,445,-1331,-109,288,1365
1026,05000US21067,"Fayette County, Kentucky",16170,10345,12260,5430,14305,4020,4374,8730,7665,45560,7595,18215,27495,5215,17350,24860,9215,18420,8575,-15235,14520,-8956,-16130,-1550,27140
1027,05000US21069,"Fleming County, Kentucky",399,319,303,194,470,300,384,659,574,2415,445,650,470,125,2070,835,410,969,-46,-167,539,-1386,-176,164,1446
1028,05000US21071,"Floyd County, Kentucky",1614,1025,609,304,920,1272,1459,1599,1273,4925,1585,1150,1475,265,6274,2194,1020,1275,29,-866,959,-3543,-595,253,3650
1029,05000US21073,"Franklin County, Kentucky",1345,1200,1894,1240,1975,739,793,1595,1350,8815,980,2985,3315,370,4315,5264,1520,2340,365,-1421,2845,-2783,-3669,-170,6475
1030,05000US21075,"Fulton County, Kentucky",313,154,220,68,199,154,149,295,285,745,275,349,320,20,1020,295,85,215,38,-100,247,-717,0,200,530
1031,05000US21077,"Gallatin County, Kentucky",242,193,180,66,187,223,343,453,337,818,285,510,70,0,1470,538,114,178,-43,110,253,-904,-85,223,640
1032,05000US21079,"Garrard County, Kentucky",450,330,298,175,257,329,525,754,805,3324,325,550,600,35,1860,1665,865,1070,125,-302,397,-1006,-911,-60,2254
1033,05000US21081,"Grant County, Kentucky",598,609,588,279,754,343,420,678,717,3703,275,450,1725,380,1909,1939,705,1420,323,-1137,653,-1146,-1261,12,2283
1034,05000US21083,"Graves County, Kentucky",1205,689,824,428,610,788,1190,1485,1430,5983,930,1215,1410,194,5280,2634,1275,1644,275,-586,844,-3302,-1149,155,4339
1035,05000US21085,"Grayson County, Kentucky",695,594,550,251,615,477,708,1319,1092,3694,580,1030,975,109,2814,2189,739,1275,115,-425,757,-1629,-870,353,2419
1036,05000US21087,"Green County, Kentucky",289,265,191,75,217,334,312,600,489,1823,280,450,285,25,1974,720,165,559,9,-94,267,-1328,-120,324,1264
1037,05000US21089,"Greenup County, Kentucky",774,674,565,269,1068,775,840,1665,1413,6539,940,795,1360,249,5109,2795,1435,1745,-166,-795,1088,-3494,-1130,-22,4794
1038,05000US21091,"Hancock County, Kentucky",244,112,136,192,142,153,152,394,380,1540,295,345,140,35,1273,630,340,315,-51,-4,299,-968,-236,40,1225
1039,05000US21093,"Hardin County, Kentucky",2900,2555,3350,1855,5100,1495,2060,3620,3155,15794,1790,4705,7515,1755,8035,9070,3185,5460,1110,-4165,5200,-4480,-5450,-30,10334
1040,05000US21095,"Harlan County, Kentucky",1535,690,504,248,548,1049,1353,1524,1195,3044,1295,1275,900,79,5824,1064,440,560,240,-396,717,-3422,460,755,2484
1041,05000US21097,"Harrison County, Kentucky",575,490,364,274,453,325,359,620,689,3240,450,650,905,155,1440,1464,674,1550,125,-541,572,-756,-844,15,1690
1042,05000US21099,"Hart County, Kentucky",469,399,440,157,423,512,565,805,730,2964,585,720,545,35,2605,1494,520,869,-116,-105,545,-1528,-689,210,2095
1043,05000US21101,"Henderson County, Kentucky",1955,1490,1629,704,1350,860,1200,1820,1649,6249,1480,3005,2565,85,5660,3455,1029,1570,475,-936,1969,-3600,-1635,620,4679
1044,05000US21103,"Henry County, Kentucky",605,397,457,230,275,364,440,649,619,2115,500,955,450,59,2080,1188,455,450,105,7,446,-1276,-539,164,1665
1045,05000US21105,"Hickman County, Kentucky",57,40,93,32,144,156,154,375,214,705,90,174,73,14,1030,310,80,185,-33,20,162,-720,65,134,520
1046,05000US21107,"Hopkins County, Kentucky",1603,995,1014,383,1465,973,1112,2303,1974,7515,1215,1930,2015,304,6899,3434,1475,1730,388,-1001,1544,-4814,-1131,499,5785
1047,05000US21109,"Jackson County, Kentucky",329,357,168,84,410,624,525,730,465,1760,490,425,385,65,2305,1005,385,374,-161,-217,429,-1156,-275,80,1386
1048,05000US21111,"Jefferson County, Kentucky",32389,21235,26305,11590,27795,12290,15214,29430,26740,112895,17920,40295,51975,9109,65075,62238,23615,43015,14469,-25670,30276,-37571,-32808,3125,69880
1049,05000US21113,"Jessamine County, Kentucky",2040,1174,1555,890,1368,599,634,1800,1665,7089,1155,3290,2395,180,3565,3820,990,3230,885,-840,2078,-2332,-2020,675,3859
1050,05000US21115,"Johnson County, Kentucky",755,455,398,130,684,669,879,848,934,3105,725,535,1035,135,3005,1910,645,995,30,-637,679,-1457,-1062,289,2110
1051,05000US21117,"Kenton County, Kentucky",6234,3909,4849,2470,4124,2294,3282,6795,5760,24267,3845,9860,7155,745,18550,13980,4198,5474,2389,-2306,5849,-12974,-7185,1562,18793
1052,05000US21119,"Knott County, Kentucky",482,348,221,107,256,695,634,888,733,2175,680,445,279,24,3410,699,245,465,-198,-58,339,-2081,189,488,1710
1053,05000US21121,"Knox County, Kentucky",1815,890,864,290,624,1269,998,1305,1195,3470,1715,1230,1420,125,4389,1635,779,1085,100,-556,789,-2122,-330,416,2385
1054,05000US21123,"Larue County, Kentucky",390,474,319,99,257,279,345,869,780,2031,365,680,430,49,2115,938,414,544,25,-111,307,-1491,-69,366,1487
1055,05000US21125,"Laurel County, Kentucky",1850,1410,1585,485,1780,1754,1195,2215,2410,9049,1515,1670,3350,565,6580,4810,2010,2790,335,-1765,1700,-3631,-2595,400,6259
1056,05000US21127,"Lawrence County, Kentucky",580,302,206,98,268,478,715,809,685,2329,450,390,535,99,2555,1125,419,720,130,-329,267,-1362,-316,266,1609
1057,05000US21129,"Lee County, Kentucky",423,158,65,15,91,334,303,383,312,879,265,220,249,15,1460,360,135,135,158,-184,91,-823,23,177,744
1058,05000US21131,"Leslie County, Kentucky",476,128,80,45,228,619,530,465,555,1303,479,319,105,54,2485,580,70,214,-3,-25,219,-1336,-115,485,1089
1059,05000US21133,"Letcher County, Kentucky",869,533,569,223,398,1177,822,1120,1415,3299,1020,575,885,120,5190,1265,275,775,-151,-316,501,-3191,-145,1140,2524
1060,05000US21135,"Lewis County, Kentucky",550,252,188,25,374,510,495,770,599,2015,775,305,234,69,2595,880,285,420,-225,-46,330,-1590,-110,314,1595
1061,05000US21137,"Lincoln County, Kentucky",659,436,495,199,804,623,780,1175,1149,3865,535,810,1105,135,3055,2280,760,1218,124,-610,868,-1652,-1105,389,2647
1062,05000US21139,"Livingston County, Kentucky",352,152,151,28,363,177,343,538,420,1646,434,353,239,10,1595,799,280,363,-82,-88,381,-1075,-261,140,1283
1063,05000US21141,"Logan County, Kentucky",914,694,803,344,759,513,494,995,1015,4660,870,870,1615,165,3105,2120,805,1385,44,-812,938,-2098,-1125,210,3275
1064,05000US21143,"Lyon County, Kentucky",223,117,123,44,98,213,188,503,367,1553,234,245,74,39,1259,674,260,668,-11,49,103,-858,-171,107,885
1065,05000US21145,"McCracken County, Kentucky",2355,1864,1529,1030,2318,1184,1700,2985,2415,10920,1660,2550,4205,684,6765,5100,2182,4880,695,-2676,2664,-3881,-2115,233,6040
1066,05000US21147,"McCreary County, Kentucky",864,455,255,40,235,935,894,1059,764,1283,570,630,520,135,3135,850,374,190,294,-265,140,-1306,209,390,1093
1067,05000US21149,"McLean County, Kentucky",251,142,181,56,135,279,294,494,364,1685,225,355,170,4,1714,763,234,375,26,11,187,-1141,-269,130,1310
1068,05000US21151,"Madison County, Kentucky",3518,2495,2480,1269,3790,1257,1495,2260,2450,12449,1715,4980,6025,825,5710,6880,3085,4110,1803,-3545,4234,-2958,-4620,-635,8339
1069,05000US21153,"Magoffin County, Kentucky",629,296,369,119,179,453,427,545,569,1665,619,565,380,25,2085,715,320,354,10,-11,273,-1205,-170,249,1311
1070,05000US21155,"Marion County, Kentucky",423,332,469,226,468,388,568,819,799,3074,325,565,855,184,1994,1800,624,1114,98,-386,510,-1038,-981,175,1960
1071,05000US21157,"Marshall County, Kentucky",578,634,534,315,724,559,900,1810,1660,6065,760,885,1045,75,4590,2645,1495,1730,-182,-511,964,-3131,-835,165,4335
1072,05000US21159,"Martin County, Kentucky",552,189,148,85,229,378,368,689,754,1345,535,385,264,20,1870,760,210,320,17,-116,294,-1124,-71,544,1025
1073,05000US21161,"Mason County, Kentucky",558,380,535,136,519,284,463,582,548,2943,740,420,860,140,1805,1208,569,1248,-182,-325,515,-1058,-626,-21,1695
1074,05000US21163,"Meade County, Kentucky",533,458,553,324,1179,538,455,1089,829,4898,405,745,1520,393,3049,2350,1204,1339,128,-967,1110,-2056,-1261,-375,3559
1075,05000US21165,"Menifee County, Kentucky",101,61,77,53,151,240,195,360,363,1035,215,108,123,19,1195,570,205,269,-114,-46,185,-760,-210,158,766
1076,05000US21167,"Mercer County, Kentucky",549,540,660,209,465,483,575,679,680,3885,535,940,900,75,2070,1900,880,1469,14,-240,599,-1012,-1221,-200,2416
1077,05000US21169,"Metcalfe County, Kentucky",207,227,215,119,172,264,409,582,474,1450,315,400,220,4,1760,700,185,364,-108,-5,287,-1087,-118,289,1086
1078,05000US21171,"Monroe County, Kentucky",294,332,163,118,283,345,344,407,499,1730,420,470,260,55,1744,495,405,540,-126,-97,346,-1055,-88,94,1190
1079,05000US21173,"Montgomery County, Kentucky",739,650,673,374,974,455,474,1018,912,4379,710,500,1985,250,2203,2390,1040,1679,29,-1312,1098,-1274,-1372,-128,2700
1080,05000US21175,"Morgan County, Kentucky",323,364,214,118,244,321,484,648,637,1860,415,510,274,55,2145,760,314,540,-92,-60,307,-1340,-112,323,1320
1081,05000US21177,"Muhlenberg County, Kentucky",784,432,480,339,510,659,917,1430,1225,5019,615,910,850,155,4880,1955,934,1250,169,-370,694,-3304,-525,291,3769
1082,05000US21179,"Nelson County, Kentucky",910,670,705,314,1144,858,1060,2004,2009,8054,680,1660,1285,115,4099,4870,1825,2909,230,-580,1343,-2181,-2866,184,5145
1083,05000US21181,"Nicholas County, Kentucky",218,142,188,73,203,125,190,317,257,1138,280,225,269,54,1018,485,150,260,-62,-81,222,-703,-168,107,878
1084,05000US21183,"Ohio County, Kentucky",449,545,424,95,619,470,703,1054,1050,4044,440,905,640,130,3339,1889,610,1194,9,-216,584,-2166,-835,440,2850
1085,05000US21185,"Oldham County, Kentucky",544,585,537,369,979,565,749,1662,1472,13261,665,885,1105,385,2104,4123,3440,8059,-121,-568,963,-790,-2461,-1968,5202
1086,05000US21187,"Owen County, Kentucky",192,229,206,152,272,212,349,407,344,1655,265,370,335,75,1330,935,275,525,-73,-129,349,-769,-528,69,1130
1087,05000US21189,"Owsley County, Kentucky",203,87,47,12,74,308,168,133,175,527,260,120,40,19,809,230,30,189,-57,7,67,-333,-97,145,338
1088,05000US21191,"Pendleton County, Kentucky",293,258,305,117,293,530,515,860,710,1520,455,630,179,4,2410,970,320,295,-162,126,406,-1365,-110,390,1225
1089,05000US21193,"Perry County, Kentucky",960,494,759,199,534,1095,1065,1134,939,4149,860,925,910,215,4995,1700,549,1104,100,-151,518,-2835,-566,390,3045
1090,05000US21195,"Pike County, Kentucky",2290,1404,1119,633,1543,2538,2004,3359,2649,9244,2150,1335,2690,825,10645,3719,1334,3479,140,-1571,1351,-6103,-360,1315,5765
1091,05000US21197,"Powell County, Kentucky",487,339,277,55,370,289,454,394,300,1845,490,300,705,39,1825,920,275,465,-3,-428,386,-1082,-526,25,1380
1092,05000US21199,"Pulaski County, Kentucky",2825,1370,1245,485,2020,1679,1914,2940,2309,9843,1665,2005,3725,555,7124,4750,1835,4443,1160,-2480,1950,-3531,-1810,474,5400
1093,05000US21201,"Robertson County, Kentucky",50,46,14,68,43,122,85,103,111,352,35,104,74,0,249,225,80,173,15,-60,111,-42,-122,31,179
1094,05000US21203,"Rockcastle County, Kentucky",383,390,393,115,296,424,693,770,670,2730,430,590,495,55,2645,1200,485,679,-47,-102,356,-1528,-430,185,2051
1095,05000US21205,"Rowan County, Kentucky",945,750,670,259,934,310,470,1105,805,3055,685,880,1715,264,2075,944,645,1645,260,-1045,929,-1295,161,160,1410
1096,05000US21207,"Russell County, Kentucky",479,418,374,223,369,640,648,769,698,2755,480,710,615,60,2515,1445,330,1075,-1,-241,532,-1227,-676,368,1680
1097,05000US21209,"Scott County, Kentucky",1210,1115,1354,714,1615,770,710,1824,1369,9270,1115,2105,2560,229,3300,5690,1445,3375,95,-1206,2100,-1820,-3866,-76,5895
1098,05000US21211,"Shelby County, Kentucky",1250,1045,1205,448,1085,560,934,1494,1194,7384,875,2000,2010,145,3095,3665,1300,3290,375,-805,1388,-1601,-2171,-106,4094
1099,05000US21213,"Simpson County, Kentucky",419,439,699,220,775,200,370,549,630,2788,239,565,1655,100,1465,1215,640,1194,180,-956,895,-895,-666,-10,1594
1100,05000US21215,"Spencer County, Kentucky",184,199,294,237,203,322,413,664,599,3585,290,640,174,25,1069,2045,1110,1330,-106,120,415,-334,-1381,-511,2255
1101,05000US21217,"Taylor County, Kentucky",825,835,825,404,660,325,580,965,819,3684,500,1180,1665,215,2270,1775,695,1364,325,-840,849,-1365,-810,124,2320
1102,05000US21219,"Todd County, Kentucky",333,233,206,153,393,274,413,595,465,1679,380,375,475,100,1540,945,290,509,-47,-269,446,-853,-350,175,1170
1103,05000US21221,"Trigg County, Kentucky",238,199,279,109,220,299,550,705,689,2923,360,305,294,80,1849,1505,440,1304,-122,-15,249,-1000,-800,249,1619
1104,05000US21223,"Trimble County, Kentucky",263,156,140,34,253,243,268,658,480,1264,220,405,214,4,1683,605,270,267,43,-74,283,-1172,53,210,997
1105,05000US21225,"Union County, Kentucky",404,214,473,234,430,194,299,638,594,2315,335,675,730,35,2025,850,289,654,69,-257,629,-1532,-212,305,1661
1106,05000US21227,"Warren County, Kentucky",4265,3130,3780,2184,5810,1060,1430,3044,3400,19020,2215,3705,10695,2550,5884,9605,4125,8055,2050,-6915,5444,-3394,-6561,-725,10965
1107,05000US21229,"Washington County, Kentucky",283,163,194,69,360,189,393,497,393,2174,180,520,309,55,1525,962,434,610,103,-115,374,-943,-465,-41,1564
1108,05000US21231,"Wayne County, Kentucky",655,590,355,169,425,604,655,1015,849,2965,695,755,685,45,3110,1385,615,720,-40,-330,549,-1851,-370,234,2245
1109,05000US21233,"Webster County, Kentucky",252,255,284,239,354,374,429,593,570,1960,420,605,279,90,2175,820,455,364,-168,5,503,-1372,-227,115,1596
1110,05000US21235,"Whitley County, Kentucky",1100,464,1010,309,820,983,837,1500,1550,4535,940,955,1635,185,4854,2064,945,1260,160,-625,944,-3034,-564,605,3275
1111,05000US21237,"Wolfe County, Kentucky",510,203,129,49,100,229,244,539,403,725,380,370,240,20,1335,310,100,105,130,-111,129,-862,229,303,620
1112,05000US21239,"Woodford County, Kentucky",705,545,733,319,675,475,494,949,919,4383,810,1220,930,15,1610,2685,960,2078,-105,-197,979,-641,-1736,-41,2305
1113,05000US22001,"Acadia Parish, Louisiana",1705,1580,963,355,1883,1106,1560,2085,1924,9633,1860,1595,2330,710,6945,3828,1850,3855,-155,-1367,1528,-4279,-1743,74,5778
1114,05000US22003,"Allen Parish, Louisiana",422,575,314,143,441,419,819,975,979,3154,725,585,495,85,3498,1100,700,775,-303,-181,499,-2260,-125,279,2379
1115,05000US22005,"Ascension Parish, Louisiana",2014,1035,1475,710,3075,2750,2294,3585,3625,22170,1580,1850,3355,1520,8650,11200,5170,8880,434,-1880,2265,-3606,-7615,-1545,13290
1116,05000US22007,"Assumption Parish, Louisiana",450,510,370,110,375,864,784,939,830,3820,725,440,625,25,3440,1520,975,1045,-275,-255,460,-1792,-581,-145,2775
1117,05000US22009,"Avoyelles Parish, Louisiana",1213,920,1005,314,1093,1165,868,1694,1500,5940,1275,1125,1625,505,4930,2235,1240,2185,-62,-620,902,-2897,-541,260,3755
1118,05000US22011,"Beauregard Parish, Louisiana",704,933,504,192,813,877,1104,1509,1317,5605,1055,880,915,288,4919,2485,1400,1578,-351,-411,717,-2938,-976,-83,4027
1119,05000US22013,"Bienville Parish, Louisiana",498,443,298,147,250,396,401,599,514,2476,735,470,380,44,2498,790,434,558,-237,-82,353,-1701,-191,80,1918
1120,05000US22015,"Bossier Parish, Louisiana",3325,2155,3420,2040,6894,1910,2190,3419,2989,20340,2300,1975,6510,7050,8035,6934,4950,10870,1025,-3090,1884,-3935,-3515,-1961,9470
1121,05000US22017,"Caddo Parish, Louisiana",11009,6780,7765,3509,9790,4434,5274,8294,7560,35387,6640,6625,18705,6900,21195,14040,7815,16753,4369,-10940,6399,-11487,-5746,-255,18634
1122,05000US22019,"Calcasieu Parish, Louisiana",5290,4260,4885,2529,8015,3655,4210,6790,6795,32385,4415,3925,12585,4070,18345,12460,6375,15970,875,-7700,6474,-10480,-5670,420,16415
1123,05000US22021,"Caldwell Parish, Louisiana",342,209,158,103,164,344,393,363,281,1340,450,264,225,24,1615,500,215,389,-108,-67,243,-878,-137,66,951
1124,05000US22023,"Cameron Parish, Louisiana",4,74,75,25,97,77,324,299,314,1475,125,40,95,19,1075,635,320,380,-121,-20,103,-674,-336,-6,1095
1125,05000US22025,"Catahoula Parish, Louisiana",308,216,202,58,149,299,370,505,373,1449,470,309,143,0,1664,424,395,375,-162,59,207,-995,81,-22,1074
1126,05000US22027,"Claiborne Parish, Louisiana",783,454,395,99,280,423,529,813,732,1765,655,435,824,95,2285,565,370,755,128,-429,284,-1333,248,362,1010
1127,05000US22029,"Concordia Parish, Louisiana",704,725,520,54,709,424,890,660,550,2409,1080,915,575,154,2499,810,525,1009,-376,-55,609,-1185,-150,25,1400
1128,05000US22031,"De Soto Parish, Louisiana",980,534,443,175,659,933,730,899,807,4180,1075,845,700,175,3549,1589,565,1910,-95,-257,659,-1886,-690,242,2270
1129,05000US22033,"East Baton Rouge Parish, Louisiana",18985,11775,13540,7085,17565,8010,7949,13360,11525,59863,7225,18340,31975,11420,26670,32225,13525,27759,11760,-18435,13230,-10711,-18865,-2000,32104
1130,05000US22035,"East Carroll Parish, Louisiana",508,423,213,47,135,153,83,208,159,469,480,525,279,45,620,219,95,155,28,-66,137,-384,-11,64,314
1131,05000US22037,"East Feliciana Parish, Louisiana",319,324,384,157,129,767,687,1004,954,2565,490,595,230,0,2789,1135,420,1235,-171,154,286,-1335,-131,534,1330
1132,05000US22039,"Evangeline Parish, Louisiana",963,1248,725,294,763,474,865,1609,1408,4264,1125,1390,1330,160,3980,1305,963,1840,-162,-605,897,-2641,304,445,2424
1133,05000US22041,"Franklin Parish, Louisiana",792,584,389,179,494,486,644,699,763,2819,775,760,825,85,2650,1085,528,978,17,-436,588,-1520,-386,235,1841
1134,05000US22043,"Grant Parish, Louisiana",580,321,468,329,724,469,479,758,759,2680,635,524,1130,135,2495,1030,554,900,-55,-662,918,-1547,-272,205,1780
1135,05000US22045,"Iberia Parish, Louisiana",1790,1630,1450,940,2895,1230,1470,2330,2100,10993,2195,1550,3700,1245,7550,4180,2065,4174,-405,-2250,2590,-4850,-1850,35,6819
1136,05000US22047,"Iberville Parish, Louisiana",759,368,488,238,839,984,718,1230,1260,4554,730,745,990,235,3439,1940,740,2499,29,-502,842,-1737,-710,520,2055
1137,05000US22049,"Jackson Parish, Louisiana",623,339,322,181,303,278,444,689,593,2518,630,615,445,85,2150,1050,264,935,-7,-123,399,-1428,-361,329,1583
1138,05000US22051,"Jefferson Parish, Louisiana",13774,11195,12725,7059,19624,7849,9257,13695,12494,64003,5280,6145,39840,13120,20745,36360,17720,31480,8494,-27115,13563,-3639,-22665,-5226,32523
1139,05000US22053,"Jefferson Davis Parish, Louisiana",884,624,613,419,729,885,934,1150,1054,4420,1025,1025,1070,139,3890,2310,620,1495,-141,-457,1009,-2071,-1160,434,2925
1140,05000US22055,"Lafayette Parish, Louisiana",7645,6015,4855,3005,9375,4530,4694,7775,6825,37004,4855,5830,15035,5175,15110,16765,10124,17865,2790,-10180,7205,-5886,-8990,-3299,19139
1141,05000US22057,"Lafourche Parish, Louisiana",2190,1500,1775,690,2845,1942,2570,4169,3939,16433,2120,1815,3875,1185,9084,6895,3804,7645,70,-2100,2350,-4572,-2726,135,8788
1142,05000US22059,"LaSalle Parish, Louisiana",423,254,189,125,320,338,447,645,714,1805,564,345,384,20,2140,784,270,665,-141,-195,425,-1355,-139,444,1140
1143,05000US22061,"Lincoln Parish, Louisiana",3135,1555,1484,444,1279,754,680,1154,1049,6085,1505,1840,3645,909,3460,1780,1220,3080,1630,-2161,814,-2026,-626,-171,3005
1144,05000US22063,"Livingston Parish, Louisiana",2465,1510,1760,899,2945,3645,3559,5830,6129,21824,2260,3020,3400,905,14490,14450,5280,5364,205,-1640,2939,-7286,-8620,849,16460
1145,05000US22065,"Madison Parish, Louisiana",505,454,298,128,389,351,220,333,323,1155,550,640,540,60,1604,403,95,220,-45,-242,457,-1033,-70,228,935
1146,05000US22067,"Morehouse Parish, Louisiana",1170,724,575,275,669,635,619,1287,1356,3359,770,1090,1425,130,3448,1585,595,1143,400,-850,814,-2194,-298,761,2216
1147,05000US22069,"Natchitoches Parish, Louisiana",2515,1214,1848,555,1135,554,514,1014,933,4582,1690,1005,3540,1035,2874,1489,775,2419,825,-1692,655,-1806,-475,158,2163
1148,05000US22071,"Orleans Parish, Louisiana",27250,13310,13195,6535,21713,7990,6952,10494,8971,41530,11045,9580,35375,26000,12550,20199,8145,33764,16205,-22180,2248,2392,-9705,826,7766
1149,05000US22073,"Ouachita Parish, Louisiana",6520,3995,4340,2304,5945,2244,2480,4339,3474,22093,3550,3535,11065,4945,10670,6929,4310,12334,2970,-6725,3304,-5946,-2590,-836,9759
1150,05000US22075,"Plaquemines Parish, Louisiana",329,239,794,415,929,958,805,718,833,3110,435,455,985,845,2464,830,434,2420,-106,-191,499,-701,-112,399,690
1151,05000US22077,"Pointe Coupee Parish, Louisiana",744,453,409,155,329,1008,862,1074,1114,3090,1115,605,340,35,3334,1390,665,1420,-371,69,449,-1464,-316,449,1670
1152,05000US22079,"Rapides Parish, Louisiana",4220,3330,3780,2254,5015,2113,2775,3555,3170,18253,2855,3050,9475,3220,9545,7549,4775,8060,1365,-5695,4049,-4657,-3994,-1605,10193
1153,05000US22081,"Red River Parish, Louisiana",228,148,194,78,215,308,284,294,245,1409,430,160,205,70,1360,520,175,488,-202,-11,223,-768,-226,70,921
1154,05000US22083,"Richland Parish, Louisiana",759,744,514,145,584,320,454,759,680,2820,950,635,1055,105,2365,890,500,1070,-191,-541,624,-1591,-131,180,1750
1155,05000US22085,"Sabine Parish, Louisiana",677,448,497,182,577,708,633,1049,1017,3875,1015,690,550,108,3755,1234,700,1343,-338,-53,651,-2414,-185,317,2532
1156,05000US22087,"St. Bernard Parish, Louisiana",1369,935,869,482,1129,1012,1228,1580,1300,5108,580,785,3140,290,3364,4704,874,1269,789,-2271,1321,-1124,-3124,426,3839
1157,05000US22089,"St. Charles Parish, Louisiana",830,680,745,373,1089,1290,960,1989,1714,9865,575,820,1840,485,3260,4485,2860,4765,255,-1095,977,-1010,-2496,-1146,5100
1158,05000US22091,"St. Helena Parish, Louisiana",372,75,87,109,40,719,580,684,530,974,420,230,33,0,2170,579,175,430,-48,54,149,-871,105,355,544
1159,05000US22093,"St. James Parish, Louisiana",490,260,257,270,515,619,719,835,835,3374,790,390,515,85,2525,1655,795,1210,-300,-258,700,-1187,-820,40,2164
1160,05000US22095,"St. John the Baptist Parish, Louisiana",1000,599,670,290,1140,1144,985,1790,1540,6525,615,850,1660,555,3874,4480,1735,1890,385,-990,875,-1745,-2690,-195,4635
1161,05000US22097,"St. Landry Parish, Louisiana",3300,1810,1644,720,1729,2309,2515,3534,2979,11175,2780,1945,3655,840,9105,5724,2230,4525,520,-2011,1609,-4281,-2190,749,6650
1162,05000US22099,"St. Martin Parish, Louisiana",845,880,1029,390,785,1725,2334,2245,2010,7904,1510,1280,1005,130,7785,3145,1715,2975,-665,24,1045,-3726,-900,295,4929
1163,05000US22101,"St. Mary Parish, Louisiana",1325,759,1630,659,3124,1173,1188,1970,1690,7089,2750,885,2985,890,5764,3130,1550,2230,-1425,-1355,2893,-3403,-1160,140,4859
1164,05000US22103,"St. Tammany Parish, Louisiana",3935,3700,3705,2164,6419,4484,4929,8549,7640,47475,2865,2570,8735,5785,11745,19315,13074,28210,1070,-5030,2798,-2332,-10766,-5434,19265
1165,05000US22105,"Tangipahoa Parish, Louisiana",3480,3264,2340,1075,4979,2123,3350,4180,3690,20094,2430,1595,7880,3240,10029,6205,5794,11030,1050,-5540,2814,-4556,-2025,-2104,9064
1166,05000US22107,"Tensas Parish, Louisiana",264,224,105,43,102,190,178,229,204,435,420,215,110,0,755,213,70,235,-156,-5,145,-387,16,134,200
1167,05000US22109,"Terrebonne Parish, Louisiana",2254,2025,1805,1315,4200,2770,3040,4675,4015,15989,1790,1640,5595,2580,9770,7745,3980,7615,464,-3790,2935,-3960,-3070,35,8374
1168,05000US22111,"Union Parish, Louisiana",625,334,196,77,222,670,604,823,830,3735,665,475,270,59,3229,1080,695,1645,-40,-74,240,-1955,-257,135,2090
1169,05000US22113,"Vermilion Parish, Louisiana",1465,859,838,517,1395,1439,1660,2549,2344,9510,1655,1450,1870,125,8520,3650,2094,2654,-190,-1032,1787,-5421,-1101,250,6856
1170,05000US22115,"Vernon Parish, Louisiana",1069,1154,1654,1217,3428,751,871,1278,1324,5633,1310,1035,3305,2880,4098,2054,1269,2119,-241,-1651,1765,-2476,-776,55,3514
1171,05000US22117,"Washington Parish, Louisiana",1634,963,1083,318,1003,1250,1585,2124,1949,6455,1765,1155,1815,265,6540,2755,1445,2070,-131,-732,1056,-3705,-631,504,4385
1172,05000US22119,"Webster Parish, Louisiana",1350,1120,968,302,993,1153,1204,2219,1939,5340,1335,1145,1775,490,5953,2129,1075,2260,15,-807,805,-3596,90,864,3080
1173,05000US22121,"West Baton Rouge Parish, Louisiana",885,250,385,179,810,475,745,760,650,4180,625,885,890,115,2445,1625,1395,1460,260,-505,874,-1225,-865,-745,2720
1174,05000US22123,"West Carroll Parish, Louisiana",218,308,187,42,330,289,344,550,519,1730,473,380,205,10,1760,640,260,489,-255,-18,362,-1127,-90,259,1241
1175,05000US22125,"West Feliciana Parish, Louisiana",193,179,198,89,388,345,218,460,309,1620,400,220,310,105,824,544,385,1210,-207,-112,372,-261,-84,-76,410
1176,05000US22127,"Winn Parish, Louisiana",539,537,399,80,334,321,429,514,417,1939,625,535,660,53,2160,535,334,484,-86,-261,361,-1410,-21,83,1455
1177,05000US23001,"Androscoggin County, Maine",4119,3475,3214,1748,3749,1054,1983,4085,3944,18732,2945,3595,8485,1290,7314,11000,5160,5904,1174,-5271,4207,-4277,-6915,-1216,12828
1178,05000US23003,"Aroostook County, Maine",2784,2179,1589,557,1359,1878,2605,3796,3227,10651,2830,3040,2280,300,12619,5080,2070,2338,-46,-691,1616,-8136,-1284,1157,8313
1179,05000US23005,"Cumberland County, Maine",10840,6005,8259,3949,8220,5393,6600,12144,10659,48940,7095,6815,19125,4250,10335,25780,16915,29529,3745,-10866,7919,1658,-13636,-6256,19411
1180,05000US23007,"Franklin County, Maine",653,493,571,323,302,564,1049,1599,1433,4909,670,860,760,44,3380,2809,1391,1908,-17,-189,581,-1767,-1210,42,3001
1181,05000US23009,"Hancock County, Maine",1734,1070,1094,780,1543,1157,1612,2812,2451,10142,1545,985,3060,630,3528,4029,2370,8050,189,-1966,1693,-759,-1217,81,2092
1182,05000US23011,"Kennebec County, Maine",4005,3375,3004,1640,3209,2197,3213,6015,5139,20553,2875,5090,6385,880,10560,13700,4890,7374,1130,-3381,3969,-5150,-7685,249,13179
1183,05000US23013,"Knox County, Maine",749,819,875,408,1200,829,874,1958,1984,7794,635,810,1975,619,2155,3080,2395,5575,114,-1100,989,-452,-1122,-411,2219
1184,05000US23015,"Lincoln County, Maine",862,723,733,214,769,813,1167,1872,1439,6885,735,770,1580,214,2073,3015,1833,5318,127,-847,769,-93,-1143,-394,1567
1185,05000US23017,"Oxford County, Maine",1169,1169,859,427,539,988,1767,3143,2782,8784,1195,1025,1585,360,6063,4616,2418,4034,-26,-726,606,-3308,-1473,364,4750
1186,05000US23019,"Penobscot County, Maine",5275,3905,4119,1475,3925,2806,4527,7252,6736,23962,3565,4425,9315,1419,17165,14294,5965,6439,1710,-5196,3981,-9832,-7042,771,17523
1187,05000US23021,"Piscataquis County, Maine",495,455,356,190,281,594,678,1213,973,2644,560,630,565,19,2844,1379,784,977,-65,-209,452,-1572,-166,189,1667
1188,05000US23023,"Sagadahoc County, Maine",969,794,804,238,1040,659,1058,1715,1540,7373,715,735,2205,175,2195,3470,2383,4080,254,-1401,1103,-478,-1755,-843,3293
1189,05000US23025,"Somerset County, Maine",1510,1370,934,524,769,1589,2058,2743,2370,8302,1255,1230,2290,330,8354,4054,1984,2225,255,-1356,963,-4707,-1311,386,6077
1190,05000US23027,"Waldo County, Maine",909,588,564,388,1067,957,1502,2181,1892,7448,960,710,1365,490,3874,3510,2455,3873,-51,-801,965,-1415,-1329,-563,3575
1191,05000US23029,"Washington County, Maine",1038,719,767,284,571,970,1346,2016,1682,5030,1305,940,1035,130,5520,2101,1258,2047,-267,-268,725,-3204,-85,424,2983
1192,05000US23031,"York County, Maine",4785,4095,4500,2575,5265,3858,5277,10050,8830,36134,3370,4560,11120,2175,9405,17800,12539,23365,1415,-6620,5665,-270,-7750,-3709,12769
1193,05000US24001,"Allegany County, Maryland",2674,1995,1665,834,1479,1596,2048,3452,3205,9808,2055,3690,2059,840,9390,5649,2082,2504,619,-394,1473,-5746,-2197,1123,7304
1194,05000US24003,"Anne Arundel County, Maryland",7725,7359,9074,5490,23180,8448,9360,15690,15220,106390,5725,4455,16765,25875,12660,25884,32980,83070,2000,-7691,2795,5148,-10194,-17760,23320
1195,05000US24005,"Baltimore County, Maryland",22315,19105,20315,13169,31990,14830,18808,25849,24774,125044,9520,18110,58030,21235,44315,61545,38305,65085,12795,-37715,23924,-10677,-35696,-13531,59959
1196,05000US24009,"Calvert County, Maryland",1114,1054,650,489,1908,1658,1879,1649,2565,18385,990,1225,1485,1525,3585,3860,5715,13525,124,-835,872,-48,-2211,-3150,4860
1197,05000US24011,"Caroline County, Maryland",699,880,654,460,773,559,778,1158,1029,5113,525,800,1440,700,1413,2503,1814,2979,174,-786,533,-76,-1345,-785,2134
1198,05000US24013,"Carroll County, Maryland",2460,2000,2200,1255,3060,2697,3509,4648,5469,33548,1970,3340,3990,1685,3425,9750,12970,23760,490,-1790,2630,2781,-5102,-7501,9788
1199,05000US24015,"Cecil County, Maryland",2139,2205,2020,950,2655,1854,2428,4072,3729,15774,1490,2735,4900,850,4725,10900,5960,6154,649,-2880,2755,-443,-6828,-2231,9620
1200,05000US24017,"Charles County, Maryland",3140,2354,1234,1564,4178,3670,3428,2769,3649,28908,2085,2495,3415,4479,9255,8774,11484,13545,1055,-2181,1263,-2157,-6005,-7835,15363
1201,05000US24019,"Dorchester County, Maryland",1194,764,817,332,1319,440,818,1344,1143,5038,795,975,2060,585,1975,2709,1147,2844,399,-1243,1066,-717,-1365,-4,2194
1202,05000US24021,"Frederick County, Maryland",5970,4424,3070,2859,6394,4772,6718,4615,6089,44948,3370,7590,7240,4530,12355,11334,14803,29584,2600,-4170,4723,-865,-6719,-8714,15364
1203,05000US24023,"Garrett County, Maryland",817,468,558,287,516,664,950,1932,1522,4739,955,1015,560,134,2899,2624,1013,2963,-138,-2,669,-1285,-692,509,1776
1204,05000US24025,"Harford County, Maryland",5390,3475,3019,2185,5799,4829,5560,8215,8189,46970,3305,4480,9120,2970,11370,19315,17230,25959,2085,-6101,5014,-981,-11100,-9041,21011
1205,05000US24027,"Howard County, Maryland",4700,3675,3635,2990,14260,2648,3125,4485,5580,66550,2070,1835,6810,18525,4015,6115,11945,60945,2630,-3175,-1275,1758,-1630,-6365,5605
1206,05000US24029,"Kent County, Maryland",585,418,485,289,505,308,446,899,783,3192,515,425,1040,290,723,1378,918,2473,70,-555,504,31,-479,-135,719
1207,05000US24031,"Montgomery County, Maryland",26635,20915,12789,13505,53099,14010,16285,12588,16133,182200,10870,12365,30210,73505,18710,15255,29295,181785,15765,-17421,-6901,11585,-2667,-13162,415
1208,05000US24033,"Prince George's County, Maryland",26284,24044,14915,15640,36305,15123,18607,13185,18409,123669,9815,29215,45605,32540,53810,39885,46495,52440,16469,-30690,19405,-20080,-26700,-28086,71229
1209,05000US24035,"Queen Anne's County, Maryland",714,546,643,284,1212,715,1217,1603,1587,9563,860,670,1015,865,1444,2714,3183,7523,-146,-372,631,488,-1111,-1596,2040
1210,05000US24037,"St. Mary's County, Maryland",2334,1839,1519,1359,3975,1970,2145,2720,2854,19025,1725,2175,4655,2465,3855,6770,7630,10435,609,-3136,2869,260,-4050,-4776,8590
1211,05000US24039,"Somerset County, Maryland",1210,503,459,199,572,460,698,1071,859,2704,825,800,1030,294,2420,1460,562,1238,385,-571,477,-1262,-389,297,1466
1212,05000US24041,"Talbot County, Maryland",1065,1040,970,570,1269,845,905,1354,1339,7420,565,940,2595,795,1000,1920,1780,7195,500,-1625,1044,750,-566,-441,225
1213,05000US24043,"Washington County, Maryland",4845,3454,4115,2134,5355,1934,2974,5105,4820,22348,3630,5155,8555,2535,6480,11795,7440,11079,1215,-4440,4954,-1572,-6690,-2620,11269
1214,05000US24045,"Wicomico County, Maryland",2560,3245,3224,1625,4063,1133,1565,3239,2708,14679,1470,1735,7720,3780,5250,8820,3529,5455,1090,-4496,1908,-2552,-5581,-821,9224
1215,05000US24047,"Worcester County, Maryland",1100,905,1050,560,1800,1194,1224,2539,2039,9417,865,1000,2450,1100,2170,2999,2900,8200,235,-1400,1260,248,-460,-861,1217
1216,05000US24510,"Baltimore city, Maryland",47940,21995,20320,10090,25905,16075,14573,17379,14788,53190,28250,38270,42210,17505,67490,23160,10295,17964,19690,-21890,18490,-36842,-5781,4493,35226
1217,05000US25001,"Barnstable County, Massachusetts",4989,3990,4220,1809,5145,5883,7455,12265,10904,40990,4285,2350,10530,2984,3040,8019,12180,52910,704,-6310,3970,10298,4246,-1276,-11920
1218,05000US25003,"Berkshire County, Massachusetts",5250,3725,3780,1418,2900,3054,3828,6353,5338,20423,4285,6610,5350,835,9215,12905,4835,11760,965,-1570,3483,-2333,-6552,503,8663
1219,05000US25005,"Bristol County, Massachusetts",22675,14890,15660,7785,19735,8295,10850,16640,15320,86985,14655,24975,32255,8865,10625,25725,29555,71085,8020,-16595,18655,8520,-9085,-14235,15900
1220,05000US25007,"Dukes County, Massachusetts",344,195,309,183,345,429,644,614,609,2704,455,125,320,475,55,65,115,4545,-111,-11,53,1018,549,494,-1841
1221,05000US25009,"Essex County, Massachusetts",37625,20460,17905,9145,20520,13829,15645,22439,22359,115215,23575,29415,38720,13945,13990,27170,35804,110605,14050,-20815,15720,15484,-4731,-13445,4610
1222,05000US25011,"Franklin County, Massachusetts",2803,2159,1878,923,1748,1519,2079,3583,3178,11333,2180,2570,4015,720,3725,7530,4208,5864,623,-2137,1951,-127,-3947,-1030,5469
1223,05000US25013,"Hampden County, Massachusetts",27370,14380,12139,5210,10340,7724,10665,18004,16115,60988,17480,20680,27530,3765,24615,45330,18769,21979,9890,-15391,11785,-6226,-27326,-2654,39009
1224,05000US25015,"Hampshire County, Massachusetts",5994,3489,4060,1415,4945,2233,3258,5473,5068,24180,3465,3280,9514,3665,3215,9910,9305,16815,2529,-5454,2695,2276,-4437,-4237,7365
1225,05000US25017,"Middlesex County, Massachusetts",57665,32230,31275,21230,79700,24715,26605,35040,34895,255435,36350,34660,76065,75010,20920,32850,46150,274920,21315,-44790,25920,30400,2190,-11255,-19485
1226,05000US25019,"Nantucket County, Massachusetts",161,220,180,220,543,189,209,173,242,1643,215,219,319,570,55,14,40,2399,-54,-139,193,343,159,202,-756
1227,05000US25021,"Norfolk County, Massachusetts",21770,12480,11095,7990,27110,11575,13330,17670,18755,122855,14885,10895,26610,28065,9135,21095,26860,126240,6885,-15515,7035,15770,-3425,-8105,-3385
1228,05000US25023,"Plymouth County, Massachusetts",13245,8905,7820,4305,10109,9323,11635,17600,17320,87220,9930,7565,18965,7910,10735,26575,27545,76340,3315,-11145,6504,10223,-8975,-10225,10880
1229,05000US25025,"Suffolk County, Massachusetts",72085,27150,24045,15555,54474,10060,9720,13070,11855,66905,47860,27970,50945,66545,7115,11980,13274,79150,24225,-26900,3484,12665,1090,-1419,-12245
1230,05000US25027,"Worcester County, Massachusetts",32500,19025,21100,11010,24329,11889,15880,24940,23900,125330,19800,30975,46400,10790,24250,64200,39970,72290,12700,-25300,24549,3519,-39260,-16070,53040
1231,05000US26001,"Alcona County, Michigan",162,101,171,62,92,472,524,884,748,1987,204,240,138,8,2434,897,448,852,-42,33,146,-1438,-13,300,1135
1232,05000US26003,"Alger County, Michigan",118,112,129,37,39,171,356,464,438,1473,80,210,125,14,1175,742,354,610,38,4,62,-648,-278,84,863
1233,05000US26005,"Allegan County, Michigan",1464,1348,1780,1050,2059,2332,2984,5326,5352,20134,1500,2490,3340,345,12280,11850,3747,7439,-36,-1560,2764,-6964,-6524,1605,12695
1234,05000US26007,"Alpena County, Michigan",845,769,623,260,444,656,1103,1823,1688,5114,755,1330,775,70,5895,2409,674,1199,90,-152,634,-4136,-586,1014,3915
1235,05000US26009,"Antrim County, Michigan",312,322,272,176,374,502,788,1315,1201,4720,320,470,585,115,3113,1778,803,2869,-8,-313,435,-1823,-463,398,1851
1236,05000US26011,"Arenac County, Michigan",337,299,231,110,181,444,697,1047,957,2534,350,440,340,29,3402,1102,523,603,-13,-109,262,-2261,-55,434,1931
1237,05000US26013,"Baraga County, Michigan",144,97,108,38,108,228,309,415,342,1240,129,190,145,34,1424,532,232,374,15,-37,112,-887,-117,110,866
1238,05000US26015,"Barry County, Michigan",869,999,1134,638,989,1155,1589,3334,3149,10642,950,1565,1885,235,7754,5739,2138,3550,-81,-751,1392,-5010,-2405,1011,7092
1239,05000US26017,"Bay County, Michigan",2529,1898,2240,782,2192,2644,3078,5523,4534,19558,1785,3225,3990,639,19730,8324,3179,3719,744,-1750,2335,-14008,-2801,1355,15839
1240,05000US26019,"Benzie County, Michigan",226,154,171,120,162,389,552,1071,907,3435,175,275,280,100,1601,1784,1070,1826,51,-109,182,-660,-713,-163,1609
1241,05000US26021,"Berrien County, Michigan",5058,3774,4129,1985,4404,2429,3936,6600,5959,26356,3385,5315,9065,1585,15809,12298,5393,11304,1673,-4936,4804,-9444,-5698,566,15052
1242,05000US26023,"Branch County, Michigan",693,849,1020,403,1064,688,1014,2152,1898,7106,705,1095,1990,240,6975,2503,1294,1832,-12,-970,1227,-5273,-351,604,5274
1243,05000US26025,"Calhoun County, Michigan",3580,3224,3500,1599,4285,2358,3224,5843,4758,22398,1895,3520,9275,1505,18340,10435,3574,5705,1685,-5775,4379,-12758,-4592,1184,16693
1244,05000US26027,"Cass County, Michigan",1285,494,903,475,889,809,1374,2828,2755,9657,1215,1165,1400,254,7130,4044,1809,4268,70,-497,1110,-4947,-1216,946,5389
1245,05000US26029,"Charlevoix County, Michigan",367,510,548,274,416,556,834,1450,1308,5199,430,600,995,95,2909,2387,1349,2704,-63,-447,595,-1519,-937,-41,2495
1246,05000US26031,"Cheboygan County, Michigan",519,498,418,198,433,805,932,1831,1508,4625,515,770,710,82,4398,1868,1053,2287,4,-292,549,-2661,-37,455,2338
1247,05000US26033,"Chippewa County, Michigan",955,1003,794,346,1113,586,982,1642,1598,5447,890,1710,1470,140,4744,2509,1353,1403,65,-676,1319,-3176,-867,245,4044
1248,05000US26035,"Clare County, Michigan",883,630,407,127,313,1079,1527,2128,1424,4601,705,850,745,58,6625,1945,952,1234,178,-338,382,-4019,183,472,3367
1249,05000US26037,"Clinton County, Michigan",1353,1068,1405,625,1560,1054,1268,3522,3217,14876,990,2225,2265,554,7378,8379,3404,4293,363,-860,1631,-5056,-4857,-187,10583
1250,05000US26039,"Crawford County, Michigan",334,234,220,163,219,379,463,874,744,2543,195,315,600,54,2795,1095,443,650,139,-380,328,-1953,-221,301,1893
1251,05000US26041,"Delta County, Michigan",1094,748,694,238,429,783,1232,2201,1914,7125,770,1440,865,125,6534,3510,1274,1693,324,-171,542,-4519,-1309,640,5432
1252,05000US26043,"Dickinson County, Michigan",645,317,638,344,554,707,999,1328,1410,4845,445,695,1305,45,5113,1762,774,1258,200,-667,853,-3407,-434,636,3587
1253,05000US26045,"Eaton County, Michigan",2574,2239,3090,1449,3579,1498,2103,4750,4544,19549,1300,3810,7050,765,13325,11934,3410,3244,1274,-3960,4263,-9724,-7184,1134,16305
1254,05000US26047,"Emmet County, Michigan",689,723,1234,328,883,729,912,1786,1451,6122,525,1150,1930,244,2814,3080,1253,3702,164,-696,967,-1173,-1294,198,2420
1255,05000US26049,"Genesee County, Michigan",13220,9944,10010,4700,11910,8812,9600,16924,15763,69654,5750,12070,25815,6165,62530,31690,10085,15093,7470,-15805,10445,-44118,-14766,5678,54561
1256,05000US26051,"Gladwin County, Michigan",558,411,388,186,255,994,1024,1688,1505,4400,570,695,440,104,4934,2133,883,1522,-12,-52,337,-2916,-445,622,2878
1257,05000US26053,"Gogebic County, Michigan",534,391,313,86,178,465,661,992,793,2493,469,705,315,30,3633,697,364,607,65,-2,234,-2507,295,429,1886
1258,05000US26055,"Grand Traverse County, Michigan",1459,1630,1794,1190,2439,1654,2309,4838,4172,16128,1055,1745,4600,1120,6424,9535,3860,8499,404,-2806,2509,-2461,-4697,312,7629
1259,05000US26057,"Gratiot County, Michigan",1339,829,724,325,808,996,840,1984,1517,5809,730,1510,1475,305,6689,2339,773,1158,609,-751,828,-4853,-355,744,4651
1260,05000US26059,"Hillsdale County, Michigan",1045,800,944,332,1082,947,1284,2383,2137,7551,990,1090,1910,214,7004,3175,1404,2284,55,-966,1200,-4773,-792,733,5267
1261,05000US26061,"Houghton County, Michigan",1359,934,723,298,818,690,691,1587,1567,5018,545,1395,1490,720,5008,1912,867,1649,814,-767,396,-3627,-325,700,3369
1262,05000US26063,"Huron County, Michigan",739,473,610,238,491,701,1069,1988,1893,6155,735,1080,660,80,6659,2417,1056,1653,4,-50,649,-4889,-429,837,4502
1263,05000US26065,"Ingham County, Michigan",13420,8654,9715,4609,10320,4160,5444,10182,8673,38728,4720,12755,24305,4950,33560,18920,5800,7820,8700,-14590,9979,-23956,-8738,2873,30908
1264,05000US26067,"Ionia County, Michigan",1120,988,1039,608,1233,1065,1368,2558,2268,10722,870,1265,2595,260,8030,5120,2264,2508,250,-1556,1581,-5597,-2562,4,8214
1265,05000US26069,"Iosco County, Michigan",568,412,528,224,568,783,977,1887,1568,4372,465,950,780,85,5434,1994,819,1235,103,-252,707,-3674,-107,749,3137
1266,05000US26071,"Iron County, Michigan",306,198,251,52,132,336,630,969,881,2009,359,344,190,23,2977,673,338,568,-53,61,161,-2011,296,543,1441
1267,05000US26073,"Isabella County, Michigan",3015,1955,2045,799,1774,973,1077,2048,2019,9530,1225,2495,4435,1440,6058,4785,2048,2663,1790,-2390,1133,-4008,-2737,-29,6867
1268,05000US26075,"Jackson County, Michigan",3749,3655,3055,1705,4309,2439,3307,6968,6017,27882,2610,3330,8645,1900,20210,11985,5334,8184,1139,-5590,4114,-14464,-5017,683,19698
1269,05000US26077,"Kalamazoo County, Michigan",8495,7145,7680,4400,9440,3364,4680,8875,7744,42168,4360,9370,18985,4460,21825,22449,7578,14140,4135,-11305,9380,-13781,-13574,166,28028
1270,05000US26079,"Kalkaska County, Michigan",327,293,295,113,328,594,514,1013,819,2903,210,570,555,28,2819,1520,612,834,117,-260,413,-1711,-507,207,2069
1271,05000US26081,"Kent County, Michigan",17500,14720,16604,8270,16535,8734,12605,25579,22699,97855,8175,22325,36810,6330,59005,55050,19615,30825,9325,-20206,18475,-37666,-29471,3084,67030
1272,05000US26083,"Keweenaw County, Michigan",48,8,38,10,28,59,112,175,187,394,55,40,25,25,475,94,74,249,-7,13,13,-304,81,113,145
1273,05000US26085,"Lake County, Michigan",328,183,89,24,82,517,606,807,696,1483,185,305,185,45,2450,770,283,488,143,-96,61,-1327,37,413,995
1274,05000US26087,"Lapeer County, Michigan",1560,1165,1254,640,1189,1528,2717,5111,4586,14213,1140,2115,2360,195,11124,9147,3054,4533,420,-1106,1634,-6879,-4036,1532,9680
1275,05000US26089,"Leelanau County, Michigan",221,247,273,202,234,468,683,1327,1134,4463,290,340,430,120,973,1852,1243,3894,-69,-157,316,178,-525,-109,569
1276,05000US26091,"Lenawee County, Michigan",1860,1639,1839,803,2392,1429,2323,4882,4281,17713,1000,2450,4500,554,12395,8705,3887,4888,860,-2661,2641,-8643,-3823,394,12825
1277,05000US26093,"Livingston County, Michigan",2369,2125,2635,948,2280,3839,5179,9633,8489,34562,1450,4820,3200,885,17800,22915,10170,10129,919,-565,2343,-8782,-13282,-1681,24433
1278,05000US26095,"Luce County, Michigan",102,128,96,63,125,133,182,363,295,864,105,255,144,14,1138,357,155,130,-3,-48,174,-823,6,140,734
1279,05000US26097,"Mackinac County, Michigan",228,237,413,107,362,305,382,728,644,1994,360,540,280,155,1543,951,469,963,-132,133,314,-856,-223,175,1031
1280,05000US26099,"Macomb County, Michigan",20075,17560,19490,11120,24445,16079,22494,38830,34205,144293,9775,18135,53560,11215,103240,77590,30440,40505,10300,-34070,24350,-64667,-38760,3765,103788
1281,05000US26101,"Manistee County, Michigan",420,412,470,138,302,515,695,1677,1431,4381,479,470,710,84,3845,2259,938,1581,-59,-240,356,-2635,-582,493,2800
1282,05000US26103,"Marquette County, Michigan",2370,1533,1704,704,1539,1153,1341,2860,2615,10835,1355,2930,2950,640,6845,5275,2514,3983,1015,-1246,1603,-4351,-2415,101,6852
1283,05000US26105,"Mason County, Michigan",594,599,648,282,680,618,955,1656,1352,5017,425,925,1180,260,4049,2304,1123,2105,169,-532,702,-2476,-648,229,2912
1284,05000US26107,"Mecosta County, Michigan",1394,829,775,360,729,782,1193,1880,1779,6317,1030,1350,1225,465,5340,2920,1505,1968,364,-450,624,-3365,-1040,274,4349
1285,05000US26109,"Menominee County, Michigan",568,583,408,234,472,512,867,1523,1542,4411,575,1055,549,59,4664,1729,893,1188,-7,-141,647,-3285,-206,649,3223
1286,05000US26111,"Midland County, Michigan",2435,1420,1569,940,1848,1591,2283,4422,3412,14834,1465,3305,2850,570,12389,7715,2289,3800,970,-1281,2218,-8515,-3293,1123,11034
1287,05000US26113,"Missaukee County, Michigan",204,286,220,147,212,344,558,990,845,2384,229,265,525,60,2489,1175,594,739,-25,-305,299,-1587,-185,251,1645
1288,05000US26115,"Monroe County, Michigan",2788,2270,2675,1260,2628,3247,3894,7122,6636,28025,2040,3660,5315,614,18350,16419,6533,7094,748,-2640,3274,-11209,-9297,103,20931
1289,05000US26117,"Montcalm County, Michigan",1279,1149,1040,494,1249,1347,1783,3748,3051,9407,935,1685,2120,470,10128,4784,1764,2274,344,-1080,1273,-6998,-1036,1287,7133
1290,05000US26119,"Montmorency County, Michigan",140,105,123,41,77,248,469,859,712,1562,124,180,169,10,2054,830,359,538,16,-46,108,-1337,29,353,1024
1291,05000US26121,"Muskegon County, Michigan",4825,3474,3763,1333,3349,3107,3783,8032,6853,28378,2670,3775,9080,1225,23545,14285,4765,6889,2155,-5317,3457,-16655,-6253,2088,21489
1292,05000US26123,"Newaygo County, Michigan",999,657,568,243,773,1354,1630,2673,2591,7942,890,900,1265,205,8204,3824,1579,2275,109,-697,811,-5220,-1151,1012,5667
1293,05000US26125,"Oakland County, Michigan",27260,20750,27535,15350,56020,17958,20888,39635,36494,245315,12945,22180,75915,35890,85865,89955,49179,131260,14315,-48380,35480,-47019,-50320,-12685,114055
1294,05000US26127,"Oceana County, Michigan",459,422,495,213,372,604,891,1451,1354,4148,500,680,760,24,4094,1865,824,1537,-41,-265,561,-2599,-414,530,2611
1295,05000US26129,"Ogemaw County, Michigan",388,413,399,172,252,739,989,1695,1375,3361,260,630,585,154,4543,1682,828,848,128,-186,270,-2815,13,547,2513
1296,05000US26131,"Ontonagon County, Michigan",123,73,88,19,43,235,362,611,500,1089,120,165,43,20,1904,401,118,264,3,45,42,-1307,210,382,825
1297,05000US26133,"Osceola County, Michigan",565,412,265,188,271,547,909,1503,1293,3456,530,680,445,49,4510,1645,528,778,35,-180,410,-3054,-142,765,2678
1298,05000US26135,"Oscoda County, Michigan",177,127,103,73,78,382,409,684,570,1239,199,144,205,10,2094,680,249,339,-22,-102,141,-1303,4,321,900
1299,05000US26137,"Otsego County, Michigan",393,443,498,270,429,423,659,1319,1144,4641,350,385,1125,165,3359,2307,1005,1384,43,-627,534,-2277,-988,139,3257
1300,05000US26139,"Ottawa County, Michigan",5115,5030,5150,2425,4780,4055,7044,13684,12345,42915,2585,9790,8575,1570,24795,32355,8875,11820,2530,-3425,5635,-13696,-18671,3470,31095
1301,05000US26141,"Presque Isle County, Michigan",254,137,186,55,135,399,602,948,852,2586,239,295,150,70,2894,964,548,889,15,36,120,-1893,-16,304,1697
1302,05000US26143,"Roscommon County, Michigan",669,521,307,224,377,878,1099,1960,1465,3833,275,825,880,80,5118,2164,855,1273,394,-573,521,-3141,-204,610,2560
1303,05000US26145,"Saginaw County, Michigan",6400,3690,5160,2105,4840,3831,4905,8733,7748,32743,3030,5675,11385,2090,30600,14425,5045,7144,3370,-6225,4855,-21864,-5692,2703,25599
1304,05000US26147,"St. Clair County, Michigan",4789,3070,3224,1354,2925,3383,4708,9143,7684,26253,2705,6330,5765,560,23400,14390,4981,7305,2084,-2541,3719,-15309,-5247,2703,18948
1305,05000US26149,"St. Joseph County, Michigan",1454,1179,1439,804,1330,855,1403,3024,2868,10478,1030,1990,2845,325,8610,4690,1778,2964,424,-1406,1809,-6352,-1666,1090,7514
1306,05000US26151,"Sanilac County, Michigan",967,649,754,393,689,998,1504,2255,2003,7390,960,1210,1155,123,7668,3223,1255,1941,7,-401,959,-5166,-968,748,5449
1307,05000US26153,"Schoolcraft County, Michigan",243,169,127,64,87,259,354,469,357,1239,200,285,204,4,1429,539,279,464,43,-77,147,-816,-70,78,775
1308,05000US26155,"Shiawassee County, Michigan",1339,1544,1735,552,1548,1065,1589,3192,3287,12333,960,2345,3145,275,10294,6398,2184,2388,379,-1410,1825,-7640,-3206,1103,9945
1309,05000US26157,"Tuscola County, Michigan",1013,676,998,383,812,1332,1615,3197,2658,9542,690,1460,1535,199,10359,4662,1450,1784,323,-537,996,-7412,-1465,1208,7758
1310,05000US26159,"Van Buren County, Michigan",1625,1399,1680,583,1345,1673,2134,3863,3848,11913,1395,2745,2240,265,10235,6425,2220,4024,230,-560,1663,-6428,-2562,1628,7889
1311,05000US26161,"Washtenaw County, Michigan",15825,9380,12015,5170,12919,5189,6165,12014,9498,52634,6800,17155,23325,8024,24340,23325,14014,22980,9025,-11310,10065,-12986,-11311,-4516,29654
1312,05000US26163,"Wayne County, Michigan",92985,46975,46590,20775,46915,48429,46278,70725,62749,209345,41810,83885,108175,20360,269475,82610,29615,48860,51175,-61585,47330,-174768,-11885,33134,160485
1313,05000US26165,"Wexford County, Michigan",763,739,580,281,749,694,1038,1958,1625,5140,625,855,1465,154,5715,2475,853,1257,138,-885,876,-3983,-517,772,3883
1314,05000US27001,"Aitkin County, Minnesota",438,333,256,101,221,659,813,1294,1012,2807,460,500,355,30,1962,1757,814,1998,-22,-99,292,-490,-463,198,809
1315,05000US27003,"Anoka County, Minnesota",5995,5700,5689,2955,4795,5530,8975,15579,15194,58489,2780,10225,10505,1605,33210,41639,14730,12320,3215,-4816,6145,-18705,-26060,464,46169
1316,05000US27005,"Becker County, Minnesota",823,589,694,281,547,772,932,1726,1567,5928,870,995,855,225,2905,2989,1348,3369,-47,-161,603,-1201,-1263,219,2559
1317,05000US27007,"Beltrami County, Minnesota",1680,1208,1268,418,878,951,1071,2058,1899,6101,1300,1930,1965,239,4342,3868,1459,2088,380,-697,1057,-2320,-1810,440,4013
1318,05000US27009,"Benton County, Minnesota",1504,958,1325,473,758,669,867,1661,1612,6463,640,2585,1344,440,3284,4725,1347,1686,864,-19,791,-1748,-3064,265,4777
1319,05000US27011,"Big Stone County, Minnesota",164,138,111,43,54,91,175,358,275,918,235,189,64,35,1088,338,149,188,-71,47,62,-822,20,126,730
1320,05000US27013,"Blue Earth County, Minnesota",2635,2060,2385,959,1668,914,1447,2277,2047,9465,1825,3065,3975,850,4670,6850,1830,2643,810,-1590,1777,-2309,-4573,217,6822
1321,05000US27015,"Brown County, Minnesota",552,624,589,274,334,474,692,1357,1319,4807,720,1155,444,45,3878,2786,898,898,-168,145,563,-2712,-1429,421,3909
1322,05000US27017,"Carlton County, Minnesota",714,575,582,231,646,586,926,1646,1387,6488,640,970,870,249,2738,4340,1660,2222,74,-288,628,-1226,-2694,-273,4266
1323,05000US27019,"Carver County, Minnesota",1305,1210,1560,948,1624,1174,1803,3182,3153,19908,1140,2280,2515,705,4810,7978,5505,10765,165,-955,1867,-1833,-4796,-2352,9143
1324,05000US27021,"Cass County, Minnesota",727,613,483,289,382,848,1177,2010,1810,5238,950,845,625,84,3138,2669,1137,3702,-223,-142,587,-1113,-659,673,1536
1325,05000US27023,"Chippewa County, Minnesota",377,242,337,189,346,183,406,477,492,2080,544,635,295,29,2124,893,299,299,-167,42,506,-1535,-416,193,1781
1326,05000US27025,"Chisago County, Minnesota",1025,617,474,185,604,882,1717,2514,2879,9297,765,1275,735,130,6029,6258,2653,2283,260,-261,659,-3430,-3744,226,7014
1327,05000US27027,"Clay County, Minnesota",2624,1613,1494,598,1038,653,1347,2455,2295,9667,1440,3115,2319,465,5144,6804,2097,2163,1184,-825,1171,-3144,-4349,198,7504
1328,05000US27029,"Clearwater County, Minnesota",257,177,154,42,80,342,298,499,450,1281,280,260,139,24,1330,809,209,411,-23,15,98,-690,-310,241,870
1329,05000US27031,"Cook County, Minnesota",191,137,128,68,167,172,219,283,307,1100,209,230,190,54,290,422,369,1029,-18,-62,181,101,-139,-62,71
1330,05000US27033,"Cottonwood County, Minnesota",325,262,245,89,172,395,356,727,507,1954,389,420,250,30,2438,789,240,315,-64,-5,231,-1687,-62,267,1639
1331,05000US27035,"Crow Wing County, Minnesota",1398,1454,1633,580,1343,1314,1960,3468,3166,10893,995,2555,2410,429,5003,6015,2729,6609,403,-777,1494,-1729,-2547,437,4284
1332,05000US27037,"Dakota County, Minnesota",9005,7969,8740,4814,10198,5919,8973,14934,14614,75330,4700,14340,18155,3529,26905,44944,21095,25845,4305,-9415,11483,-12013,-30010,-6481,49485
1333,05000US27039,"Dodge County, Minnesota",326,334,439,93,153,378,589,1192,1171,3397,490,645,213,4,3004,2020,748,630,-164,226,242,-2037,-828,423,2767
1334,05000US27041,"Douglas County, Minnesota",1014,769,968,442,828,647,1027,1886,1734,7205,605,1875,1060,485,2699,3819,1720,4057,409,-92,785,-1025,-1933,14,3148
1335,05000US27043,"Faribault County, Minnesota",423,236,317,133,390,346,585,851,721,2442,460,870,133,49,3390,892,225,354,-37,184,474,-2459,-41,496,2088
1336,05000US27045,"Fillmore County, Minnesota",569,317,333,170,355,402,587,1199,1058,3901,610,780,310,50,2873,1875,653,1543,-41,23,475,-1884,-676,405,2358
1337,05000US27047,"Freeborn County, Minnesota",748,518,893,321,503,648,1118,1587,1599,5163,730,1555,525,195,5650,2679,636,1089,18,368,629,-3884,-1092,963,4074
1338,05000US27049,"Goodhue County, Minnesota",1305,1154,1044,613,793,955,1094,2335,2146,8523,1145,1980,1400,385,3820,5269,2211,3368,160,-356,1021,-1771,-2934,-65,5155
1339,05000US27051,"Grant County, Minnesota",138,137,132,56,75,115,194,350,340,1104,200,199,115,18,1197,373,135,337,-62,17,113,-888,-23,205,767
1340,05000US27053,"Hennepin County, Minnesota",53085,33879,33799,19560,47255,18975,25450,40225,37730,195420,26735,59475,75305,26070,67545,100795,51285,95930,26350,-41506,40745,-23120,-60570,-13555,99490
1341,05000US27055,"Houston County, Minnesota",369,393,436,114,298,483,517,1081,1093,3622,480,735,340,45,2270,2352,857,1092,-111,96,367,-1270,-1271,236,2530
1342,05000US27057,"Hubbard County, Minnesota",424,408,258,131,338,451,811,1329,1097,3791,530,610,340,70,2044,1965,824,2468,-106,-82,399,-782,-636,273,1323
1343,05000US27059,"Isanti County, Minnesota",779,563,573,334,429,872,1438,2163,2039,5644,620,1259,670,130,5785,3614,1370,1188,159,-97,633,-3475,-1451,669,4456
1344,05000US27061,"Itasca County, Minnesota",1204,741,852,462,531,1122,1697,2910,2324,8037,1100,1440,1130,119,5599,4788,1989,3433,104,-278,874,-2780,-1878,335,4604
1345,05000US27063,"Jackson County, Minnesota",207,197,189,80,244,191,347,578,568,1855,345,385,150,35,1973,885,254,423,-138,39,289,-1435,-307,314,1432
1346,05000US27065,"Kanabec County, Minnesota",282,282,328,53,249,480,542,1001,829,2566,320,310,495,49,2002,1904,629,784,-38,-167,253,-980,-903,200,1782
1347,05000US27067,"Kandiyohi County, Minnesota",1193,975,787,483,954,642,950,1965,1693,7514,980,1725,1475,205,3884,3698,1539,3453,213,-688,1232,-2292,-1733,154,4061
1348,05000US27069,"Kittson County, Minnesota",115,66,83,34,77,119,120,276,262,842,135,183,35,28,1169,238,85,59,-20,48,83,-930,38,177,783
1349,05000US27071,"Koochiching County, Minnesota",524,219,228,103,118,419,512,724,634,2223,395,525,194,94,2569,1304,279,530,129,34,127,-1638,-580,355,1693
1350,05000US27073,"Lac qui Parle County, Minnesota",157,147,142,69,101,215,314,463,431,1253,245,300,70,8,1850,463,125,160,-88,72,162,-1321,0,306,1093
1351,05000US27075,"Lake County, Minnesota",239,164,156,44,229,197,358,847,584,2372,235,290,279,20,1370,1179,555,1258,4,-123,253,-815,-332,29,1114
1352,05000US27077,"Lake of the Woods County, Minnesota",58,66,87,48,23,89,174,155,164,645,95,125,59,4,604,340,90,239,-37,28,67,-341,-185,74,406
1353,05000US27079,"Le Sueur County, Minnesota",468,395,537,198,378,562,704,1389,1274,5178,530,830,535,75,2644,2829,1214,2297,-62,2,501,-1378,-1440,60,2881
1354,05000US27081,"Lincoln County, Minnesota",136,121,98,80,129,188,231,346,297,1002,175,279,45,29,1193,385,124,289,-39,53,180,-774,-39,173,713
1355,05000US27083,"Lyon County, Minnesota",965,589,869,228,538,293,628,1075,849,4113,975,1460,659,100,3349,2021,704,908,-10,210,666,-2428,-946,145,3205
1356,05000US27085,"McLeod County, Minnesota",772,673,607,394,763,484,1019,1692,1700,6802,694,1090,1200,210,4220,4274,1394,1811,78,-593,947,-2717,-2582,306,4991
1357,05000US27087,"Mahnomen County, Minnesota",217,136,145,38,80,156,184,232,218,622,270,180,125,20,855,307,94,127,-53,20,98,-515,-75,124,495
1358,05000US27089,"Marshall County, Minnesota",189,149,177,61,185,235,253,569,532,1800,245,335,124,40,1923,784,244,282,-56,53,206,-1435,-215,288,1518
1359,05000US27091,"Martin County, Minnesota",523,403,584,180,517,365,579,1009,1064,3615,629,1009,480,90,3698,1583,534,810,-106,104,607,-2754,-574,530,2805
1360,05000US27093,"Meeker County, Minnesota",496,377,453,172,455,398,665,1110,1046,4273,435,850,559,100,2583,2187,898,1643,61,-106,527,-1520,-1077,148,2630
1361,05000US27095,"Mille Lacs County, Minnesota",629,513,668,277,568,482,732,1342,1187,3934,765,680,910,290,2490,2912,933,1253,-136,-242,555,-1276,-1570,254,2681
1362,05000US27097,"Morrison County, Minnesota",954,492,618,234,467,728,1135,1936,1647,5645,815,1130,700,109,3437,3694,1394,2174,139,-82,592,-1574,-1758,253,3471
1363,05000US27099,"Mower County, Minnesota",1057,1112,918,348,724,674,1236,1661,1671,6602,800,1860,1200,285,6189,2746,949,1654,257,-282,787,-4279,-1085,722,4948
1364,05000US27101,"Murray County, Minnesota",194,122,117,67,207,199,298,535,497,1627,264,280,100,49,1795,604,194,516,-70,17,225,-1298,-69,303,1111
1365,05000US27103,"Nicollet County, Minnesota",789,570,840,493,774,487,740,1314,1095,5734,565,1235,1360,285,2118,4474,1213,1443,224,-520,982,-891,-3160,-118,4291
1366,05000US27105,"Nobles County, Minnesota",735,423,417,209,498,474,542,824,944,3104,640,984,570,94,2945,1640,504,709,95,-153,613,-1929,-816,440,2395
1367,05000US27107,"Norman County, Minnesota",157,86,150,67,72,189,247,376,345,1187,230,174,93,24,1528,477,89,133,-73,57,115,-1092,-101,256,1054
1368,05000US27109,"Olmsted County, Minnesota",4254,3565,3385,1419,3034,2341,3538,7099,6208,26191,2515,6930,5045,1145,17105,15545,5014,7179,1739,-1660,3308,-11226,-8446,1194,19012
1369,05000US27111,"Otter Tail County, Minnesota",1505,953,1205,583,898,1189,1780,2987,2981,10766,1500,2140,1065,440,6560,4792,2309,5793,5,140,1041,-3591,-1805,672,4973
1370,05000US27113,"Pennington County, Minnesota",338,307,348,179,384,327,482,567,667,2369,355,790,344,65,1873,1540,408,578,-17,4,498,-1064,-973,259,1791
1371,05000US27115,"Pine County, Minnesota",723,540,423,177,451,890,913,1626,1404,3936,790,695,710,124,3208,2780,1022,1623,-67,-287,504,-1405,-1154,382,2313
1372,05000US27117,"Pipestone County, Minnesota",309,182,289,72,162,272,280,546,446,1515,363,495,85,65,1950,598,155,374,-54,204,169,-1398,-52,291,1141
1373,05000US27119,"Polk County, Minnesota",1228,677,666,256,546,788,879,1618,1482,4882,940,1630,625,173,4192,3138,1021,1013,288,41,629,-2525,-1520,461,3869
1374,05000US27121,"Pope County, Minnesota",261,235,222,101,231,218,323,722,626,2237,379,345,264,34,1473,895,444,1107,-118,-42,298,-932,-173,182,1130
1375,05000US27123,"Ramsey County, Minnesota",28070,17840,15300,8785,14790,8335,12563,19150,17515,69124,13950,36730,27550,6545,40130,43720,18555,22539,14120,-12250,17030,-19232,-24570,-1040,46585
1376,05000US27125,"Red Lake County, Minnesota",135,50,101,24,26,108,116,267,245,775,144,114,34,15,880,325,95,104,-9,67,35,-656,-58,150,671
1377,05000US27127,"Redwood County, Minnesota",377,286,302,174,292,330,521,868,787,2567,555,639,195,50,3043,1067,310,568,-178,107,416,-2192,-199,477,1999
1378,05000US27129,"Renville County, Minnesota",332,249,271,161,278,331,443,778,738,2750,450,545,160,113,3125,1103,289,572,-118,111,326,-2351,-325,449,2178
1379,05000US27131,"Rice County, Minnesota",1813,1309,1219,530,1019,1009,1377,2673,2510,10006,1325,2295,1835,435,5110,5979,2282,3809,488,-616,1114,-2724,-3306,228,6197
1380,05000US27133,"Rock County, Minnesota",218,235,165,48,362,185,297,432,411,1666,309,520,170,30,1408,918,295,383,-91,-5,380,-926,-486,116,1283
1381,05000US27135,"Roseau County, Minnesota",327,235,336,117,288,268,366,853,761,2722,425,535,240,105,2436,1533,405,474,-98,96,300,-1802,-680,356,2248
1382,05000US27137,"St. Louis County, Minnesota",7295,5584,4980,2150,4910,3489,5542,9704,9034,34961,5845,6750,9045,3275,23345,18504,7349,12445,1450,-4065,3785,-14314,-8800,1685,22516
1383,05000US27139,"Scott County, Minnesota",2090,1599,1564,792,2115,2061,2263,4319,4458,26283,1260,2555,3590,735,6735,13260,8100,11928,830,-2026,2172,-2411,-8941,-3642,14355
1384,05000US27141,"Sherburne County, Minnesota",1229,1445,870,565,1145,1040,2155,4059,3348,15790,995,2265,1820,180,8630,10184,4045,3314,234,-950,1530,-5435,-6125,-697,12476
1385,05000US27143,"Sibley County, Minnesota",245,287,347,151,291,248,359,773,698,2788,399,599,264,54,2099,1337,445,882,-154,83,388,-1492,-564,253,1906
1386,05000US27145,"Stearns County, Minnesota",4120,3264,4409,2274,4289,2204,2883,5658,5184,25209,3145,6170,8175,869,10329,15940,5528,9013,975,-3766,5694,-5242,-10282,-344,16196
1387,05000US27147,"Steele County, Minnesota",1000,724,720,355,608,664,887,1779,1512,6418,620,1515,1070,190,4209,4569,1320,1119,380,-350,773,-2658,-2790,192,5299
1388,05000US27149,"Stevens County, Minnesota",484,303,164,69,208,90,156,356,335,1532,360,499,275,80,1175,734,229,280,124,-111,197,-929,-378,106,1252
1389,05000US27151,"Swift County, Minnesota",323,284,289,109,298,196,279,503,502,1549,405,650,220,28,1779,749,173,288,-82,69,379,-1304,-246,329,1261
1390,05000US27153,"Todd County, Minnesota",392,439,475,157,320,772,896,1471,1274,3801,660,675,405,38,3555,2189,888,1549,-268,70,439,-1887,-718,386,2252
1391,05000US27155,"Traverse County, Minnesota",72,49,95,24,68,113,135,251,236,617,115,154,20,30,902,184,75,144,-43,75,62,-654,67,161,473
1392,05000US27157,"Wabasha County, Minnesota",318,309,503,181,386,441,581,1091,1178,4256,435,715,460,84,2069,2520,984,1723,-117,43,483,-1047,-1429,194,2533
1393,05000US27159,"Wadena County, Minnesota",412,283,257,173,157,374,612,856,687,1998,345,630,280,19,2237,1410,407,414,67,-23,311,-1251,-554,280,1584
1394,05000US27161,"Waseca County, Minnesota",389,570,287,183,198,374,487,893,753,3313,360,895,320,64,2395,1915,589,905,29,-33,317,-1534,-1022,164,2408
1395,05000US27163,"Washington County, Minnesota",3589,2995,3528,2059,5070,3419,5145,9329,9135,48942,2170,4365,7920,2785,13470,24665,13609,23635,1419,-4392,4344,-4906,-15336,-4474,25307
1396,05000US27165,"Watonwan County, Minnesota",307,213,313,108,203,237,344,557,585,1608,345,560,229,20,2145,669,149,304,-38,84,291,-1564,-112,436,1304
1397,05000US27167,"Wilkin County, Minnesota",270,109,169,49,87,95,206,325,352,1188,285,290,104,14,1189,589,115,280,-15,65,122,-888,-264,237,908
1398,05000US27169,"Winona County, Minnesota",1800,1265,1240,503,974,782,1031,2126,1895,8031,1410,2735,1449,165,4414,4944,1689,2540,390,-209,1312,-2601,-2818,206,5491
1399,05000US27171,"Wright County, Minnesota",1959,2063,1714,864,1563,2448,3727,5813,5142,21746,1925,3685,2340,220,12805,14135,5559,6175,34,-626,2207,-6630,-8322,-417,15571
1400,05000US27173,"Yellow Medicine County, Minnesota",269,183,153,79,241,233,302,524,458,1768,345,380,174,15,2045,627,219,374,-76,-21,305,-1510,-103,239,1394
1401,05000US28001,"Adams County, Mississippi",1645,775,660,433,800,670,735,1277,1305,3685,1630,785,1570,330,3460,1615,529,1845,15,-910,903,-2055,-338,776,1840
1402,05000US28003,"Alcorn County, Mississippi",735,1004,755,536,1360,850,884,1889,1569,5904,1080,1085,1835,375,5154,2415,1110,1804,-345,-1080,1521,-3420,-526,459,4100
1403,05000US28005,"Amite County, Mississippi",157,174,169,73,133,529,749,708,642,1874,365,84,243,19,2485,670,329,874,-208,-74,187,-1207,38,313,1000
1404,05000US28007,"Attala County, Mississippi",685,414,435,128,470,389,498,964,839,2709,695,560,805,55,3020,835,435,868,-10,-370,543,-2133,129,404,1841
1405,05000US28009,"Benton County, Mississippi",108,126,84,50,159,254,358,303,253,1285,105,204,179,30,1575,395,220,314,3,-95,179,-963,-92,33,971
1406,05000US28011,"Bolivar County, Mississippi",1850,1180,935,409,1091,775,792,1034,823,3578,1335,1295,1955,880,3249,1629,679,1355,515,-1020,620,-1682,-595,144,2223
1407,05000US28013,"Calhoun County, Mississippi",569,302,180,135,504,319,592,735,619,2194,470,575,529,110,2925,649,345,303,99,-349,529,-2014,86,274,1891
1408,05000US28015,"Carroll County, Mississippi",207,49,130,49,240,319,238,394,373,1750,394,200,64,10,1335,615,245,729,-187,66,279,-778,-221,128,1021
1409,05000US28017,"Chickasaw County, Mississippi",632,248,349,270,352,303,674,656,748,2410,425,735,660,53,3084,669,275,539,207,-311,569,-2107,-13,473,1871
1410,05000US28019,"Choctaw County, Mississippi",227,172,127,73,163,175,385,369,374,1295,300,185,210,55,1419,445,174,485,-73,-83,181,-859,-76,200,810
1411,05000US28021,"Claiborne County, Mississippi",394,219,73,39,272,352,409,403,328,878,440,188,330,34,1590,335,65,199,-46,-257,277,-829,68,263,679
1412,05000US28023,"Clarke County, Mississippi",252,96,337,134,264,499,633,910,819,2829,244,360,430,45,3199,965,450,670,8,-93,353,-2067,-55,369,2159
1413,05000US28025,"Clay County, Mississippi",669,550,384,228,329,505,509,979,734,3024,380,460,1070,270,3065,1194,500,885,289,-686,287,-2051,-215,234,2139
1414,05000US28027,"Coahoma County, Mississippi",1519,824,716,375,919,437,553,734,663,2495,1120,1135,1730,395,3150,770,194,625,399,-1014,899,-2160,-36,469,1870
1415,05000US28029,"Copiah County, Mississippi",769,419,385,165,425,1270,934,1495,1259,2980,600,985,535,44,4854,1635,635,630,169,-150,546,-2650,-140,624,2350
1416,05000US28031,"Covington County, Mississippi",377,107,207,185,399,398,634,1260,909,2755,400,320,460,90,3100,855,545,1150,-23,-253,494,-2068,405,364,1605
1417,05000US28033,"DeSoto County, Mississippi",2150,2390,3810,1869,6194,1915,2995,5279,5303,29995,1560,1620,10135,3110,12405,15900,8325,9030,590,-6325,4953,-7495,-10621,-3022,20965
1418,05000US28035,"Forrest County, Mississippi",3240,2185,2655,1234,3310,1344,1384,1880,1675,9685,1735,1755,7005,2105,6049,4125,1965,3665,1505,-4350,2439,-3321,-2245,-290,6020
1419,05000US28037,"Franklin County, Mississippi",218,145,115,29,213,219,195,333,409,1415,434,164,125,8,1340,415,219,395,-216,-10,234,-926,-82,190,1020
1420,05000US28039,"George County, Mississippi",259,142,248,94,319,689,784,890,834,3144,395,305,360,4,3299,1394,574,1089,-136,-112,409,-1826,-504,260,2055
1421,05000US28041,"Greene County, Mississippi",154,75,82,18,193,458,309,448,463,2115,115,179,209,10,2140,669,310,584,39,-127,201,-1373,-221,153,1531
1422,05000US28043,"Grenada County, Mississippi",665,400,440,395,589,435,624,870,565,3065,635,560,1125,170,2455,1150,440,1350,30,-685,814,-1396,-280,125,1715
1423,05000US28045,"Hancock County, Mississippi",795,1025,824,570,1854,890,1595,1830,1735,8764,655,545,2955,920,4810,3595,2575,3549,140,-2131,1504,-2325,-1765,-840,5215
1424,05000US28047,"Harrison County, Mississippi",6770,4950,6310,3364,12960,3119,3204,5199,4868,27735,3055,2640,17635,11025,12565,11365,7965,12685,3715,-11325,5299,-6242,-6166,-3097,15050
1425,05000US28049,"Hinds County, Mississippi",10800,7255,7415,3260,7590,5722,5235,8460,7125,27638,5725,8760,18680,3150,28280,13064,5040,7775,5075,-11265,7700,-17323,-4604,2085,19863
1426,05000US28051,"Holmes County, Mississippi",1223,349,342,149,396,754,675,778,663,1210,1160,705,505,90,2994,540,185,275,63,-163,455,-1565,238,478,935
1427,05000US28053,"Humphreys County, Mississippi",457,273,268,120,171,191,225,373,333,734,565,299,405,39,1239,310,130,145,-108,-137,252,-823,63,203,589
1428,05000US28055,"Issaquena County, Mississippi",57,73,39,32,45,25,18,71,63,92,125,54,60,0,138,30,14,20,-68,-21,77,-95,41,49,72
1429,05000US28057,"Itawamba County, Mississippi",448,335,320,313,738,405,734,1338,1249,3494,445,335,1230,159,3135,1699,659,1215,3,-910,892,-1996,-361,590,2279
1430,05000US28059,"Jackson County, Mississippi",3690,2439,2685,1973,4390,2934,2803,5245,5250,21224,2195,2685,8590,1715,15780,10365,4690,6190,1495,-5905,4648,-10043,-5120,560,15034
1431,05000US28061,"Jasper County, Mississippi",378,147,176,87,287,619,717,959,914,2785,400,215,339,125,3640,905,560,640,-22,-163,249,-2304,54,354,2145
1432,05000US28063,"Jefferson County, Mississippi",378,280,79,48,54,78,349,269,260,734,415,290,124,25,1245,149,70,175,-37,-45,77,-818,120,190,559
1433,05000US28065,"Jefferson Davis County, Mississippi",454,147,440,69,114,468,590,679,570,1475,400,360,370,80,1995,989,335,310,54,70,103,-937,-310,235,1165
1434,05000US28067,"Jones County, Mississippi",1535,1339,1564,455,1870,1249,1850,2874,2629,10200,1595,1315,3120,729,9160,3525,1680,3880,-60,-1556,1596,-6061,-651,949,6320
1435,05000US28069,"Kemper County, Mississippi",325,267,113,16,142,290,327,714,543,1195,485,265,93,24,1880,515,160,275,-160,20,134,-1263,199,383,920
1436,05000US28071,"Lafayette County, Mississippi",3225,1240,1520,1040,1209,919,1109,1255,1105,7348,895,1875,4080,1355,3603,2700,1810,3595,2330,-2560,894,-1575,-1445,-705,3753
1437,05000US28073,"Lamar County, Mississippi",1459,1133,1009,705,2720,714,1060,1550,1460,10685,950,785,2845,2435,3220,2805,2765,6275,509,-1836,990,-1446,-1255,-1305,4410
1438,05000US28075,"Lauderdale County, Mississippi",1945,2065,2050,729,3500,1443,1384,3510,2729,11845,1945,1650,3955,2735,9465,4009,1885,4724,0,-1905,1494,-6638,-499,844,7121
1439,05000US28077,"Lawrence County, Mississippi",267,131,158,101,355,399,379,605,505,2089,230,230,315,230,1755,1170,390,565,37,-157,226,-977,-565,115,1524
1440,05000US28079,"Leake County, Mississippi",504,407,584,275,530,710,708,799,583,3243,600,540,1025,145,3205,1134,644,985,-96,-441,660,-1787,-335,-61,2258
1441,05000US28081,"Lee County, Mississippi",2735,2240,1830,993,2835,1502,1744,3474,2972,12925,1965,2510,4795,1364,8580,6020,2620,4980,770,-2965,2464,-5334,-2546,352,7945
1442,05000US28083,"Leflore County, Mississippi",2143,1060,754,267,1105,589,657,788,548,2710,1225,1805,1970,344,2984,1144,415,765,918,-1216,1028,-1738,-356,133,1945
1443,05000US28085,"Lincoln County, Mississippi",684,825,375,470,865,865,950,1559,1530,5420,815,520,1454,410,4125,2164,1190,2200,-131,-1079,925,-2310,-605,340,3220
1444,05000US28087,"Lowndes County, Mississippi",2105,1405,1829,764,2645,1010,1230,1754,1443,8635,1435,2000,3735,1585,5290,3709,2220,3295,670,-1906,1824,-3050,-1955,-777,5340
1445,05000US28089,"Madison County, Mississippi",2340,1235,2015,1395,4295,1799,1465,2388,2234,19180,1235,1810,5810,2425,5090,6150,4795,11583,1105,-3795,3265,-1826,-3762,-2561,7597
1446,05000US28091,"Marion County, Mississippi",700,579,298,84,399,615,945,1640,1530,3700,645,600,695,125,4140,1135,870,1605,55,-397,358,-2580,505,660,2095
1447,05000US28093,"Marshall County, Mississippi",464,670,625,343,1054,983,625,1680,1355,6030,790,740,1155,465,4775,1875,1210,2350,-326,-530,932,-3167,-195,145,3680
1448,05000US28095,"Monroe County, Mississippi",954,800,564,204,999,815,999,1870,1675,5954,1205,875,1185,255,5290,2485,1220,1834,-251,-621,948,-3476,-615,455,4120
1449,05000US28097,"Montgomery County, Mississippi",469,161,178,70,318,313,333,639,533,1860,319,405,385,65,1884,745,324,394,150,-207,323,-1238,-106,209,1466
1450,05000US28099,"Neshoba County, Mississippi",709,449,454,285,959,563,1069,1330,1185,4290,760,680,1220,205,4365,1310,909,1420,-51,-766,1039,-2733,20,276,2870
1451,05000US28101,"Newton County, Mississippi",493,375,325,185,412,449,514,1240,1115,3315,540,360,770,125,3565,1199,510,1085,-47,-445,472,-2602,41,605,2230
1452,05000US28103,"Noxubee County, Mississippi",429,269,125,69,147,400,437,253,282,1535,370,335,315,24,2115,394,90,390,59,-190,192,-1278,-141,192,1145
1453,05000US28105,"Oktibbeha County, Mississippi",3425,925,1129,809,1830,880,925,1114,1058,5554,945,1670,4125,1400,3289,2500,975,2940,2480,-2996,1239,-1484,-1386,83,2614
1454,05000US28107,"Panola County, Mississippi",634,709,704,395,924,737,912,1710,1650,4625,740,650,1475,519,5395,1635,789,1570,-106,-771,800,-3746,75,861,3055
1455,05000US28109,"Pearl River County, Mississippi",1089,964,924,390,1484,1504,1645,1895,1915,9220,1150,705,2445,545,6155,3930,2550,3705,-61,-1521,1329,-3006,-2035,-635,5515
1456,05000US28111,"Perry County, Mississippi",262,127,245,50,119,389,474,814,639,1810,290,270,229,20,2105,640,355,575,-28,16,149,-1242,174,284,1235
1457,05000US28113,"Pike County, Mississippi",1569,955,845,479,880,1435,1174,1590,1175,5194,1200,800,2115,615,5250,2215,893,2145,369,-1270,744,-2641,-625,282,3049
1458,05000US28115,"Pontotoc County, Mississippi",497,529,580,389,990,535,743,1226,1267,4480,619,675,1465,230,3459,2130,1025,1295,-122,-885,1149,-2181,-904,242,3185
1459,05000US28117,"Prentiss County, Mississippi",685,844,573,134,547,363,975,1140,1044,3610,705,940,1025,100,3219,1865,765,968,-20,-452,581,-1881,-725,279,2642
1460,05000US28119,"Quitman County, Mississippi",323,208,244,85,190,367,289,394,318,813,345,295,395,20,1640,289,65,73,-22,-151,255,-984,105,253,740
1461,05000US28121,"Rankin County, Mississippi",2175,2120,2840,1849,4695,1943,3308,5689,5069,26784,1875,2360,6300,3135,11590,15195,6045,9105,300,-3460,3409,-6339,-9506,-976,17679
1462,05000US28123,"Scott County, Mississippi",755,515,649,320,694,775,810,1339,1220,3654,920,470,1355,175,4275,1505,575,904,-165,-706,839,-2690,-166,645,2750
1463,05000US28125,"Sharkey County, Mississippi",179,119,127,59,194,79,133,299,275,424,300,255,134,0,755,210,45,115,-121,-7,253,-543,89,230,309
1464,05000US28127,"Simpson County, Mississippi",487,354,392,209,504,654,900,1145,1295,3610,505,330,910,215,3755,1625,535,1700,-18,-518,498,-2201,-480,760,1910
1465,05000US28129,"Smith County, Mississippi",282,188,260,133,242,358,565,980,909,2480,310,335,414,55,2495,1035,425,825,-28,-154,320,-1572,-55,484,1655
1466,05000US28131,"Stone County, Mississippi",345,78,275,219,365,318,540,660,580,2890,350,230,490,215,1855,1120,705,1005,-5,-215,369,-997,-460,-125,1885
1467,05000US28133,"Sunflower County, Mississippi",1028,814,884,174,820,392,554,895,834,2438,950,880,1670,218,3038,834,270,734,78,-786,776,-2092,61,564,1704
1468,05000US28135,"Tallahatchie County, Mississippi",189,413,128,62,174,515,354,572,538,1450,479,265,194,35,2324,549,239,245,-290,-66,201,-1455,23,299,1205
1469,05000US28137,"Tate County, Mississippi",595,428,465,179,714,695,720,1235,914,4440,384,730,1135,134,3540,2275,695,1255,211,-670,759,-2125,-1040,219,3185
1470,05000US28139,"Tippah County, Mississippi",459,460,338,227,658,392,735,983,824,3489,450,860,730,84,3080,1560,599,1120,9,-392,801,-1953,-577,225,2369
1471,05000US28141,"Tishomingo County, Mississippi",413,223,503,328,368,410,723,844,654,3290,520,545,710,59,3085,1469,495,825,-107,-207,637,-1952,-625,159,2465
1472,05000US28143,"Tunica County, Mississippi",490,525,465,254,764,119,109,280,324,830,150,365,1450,515,755,320,130,285,340,-985,503,-527,-40,194,545
1473,05000US28145,"Union County, Mississippi",502,431,512,223,1069,523,530,1300,1254,3930,555,475,1420,305,3190,1570,775,1725,-53,-908,987,-2137,-270,479,2205
1474,05000US28147,"Walthall County, Mississippi",213,46,107,83,172,1025,735,1004,1070,2054,295,120,115,94,2325,1059,435,1494,-82,-8,161,-565,-55,635,560
1475,05000US28149,"Warren County, Mississippi",1815,1394,975,544,2015,945,1090,1714,1520,7143,1420,1465,3140,715,5089,2564,1879,2575,395,-2165,1844,-3054,-850,-359,4568
1476,05000US28151,"Washington County, Mississippi",2319,1764,1539,743,1950,1148,1037,1555,1100,5408,1520,1880,3750,1160,6068,1934,565,1545,799,-2211,1533,-3883,-379,535,3863
1477,05000US28153,"Wayne County, Mississippi",435,190,460,30,375,600,910,974,755,3190,480,575,405,20,3485,1160,675,950,-45,55,385,-1975,-186,80,2240
1478,05000US28155,"Webster County, Mississippi",349,229,131,76,200,282,360,429,360,1558,370,325,220,60,1690,574,215,389,-21,-89,216,-1048,-145,145,1169
1479,05000US28157,"Wilkinson County, Mississippi",154,153,139,34,79,606,322,314,293,800,300,95,165,0,1630,370,105,225,-146,-26,113,-702,-56,188,575
1480,05000US28159,"Winston County, Mississippi",549,369,484,150,534,489,665,905,750,2800,430,550,895,190,3064,1115,339,895,119,-411,494,-1910,-210,411,1905
1481,05000US28161,"Yalobusha County, Mississippi",404,184,209,93,428,299,499,529,448,2175,415,410,380,100,2205,720,465,535,-11,-171,421,-1407,-191,-17,1640
1482,05000US28163,"Yazoo County, Mississippi",1210,840,462,167,624,549,668,914,767,2750,1140,790,1165,199,3070,1000,430,970,70,-703,592,-1853,-86,337,1780
1483,05000US29001,"Adair County, Missouri",1790,674,499,295,650,328,559,888,809,3341,540,1675,1410,285,2524,1505,623,1069,1250,-911,660,-1637,-617,186,2272
1484,05000US29003,"Andrew County, Missouri",240,234,502,128,459,415,366,703,663,3196,295,415,810,30,2050,1489,748,1105,-55,-308,557,-1269,-786,-85,2091
1485,05000US29005,"Atchison County, Missouri",153,91,183,78,241,121,177,358,253,967,174,384,149,23,1160,419,104,145,-21,34,296,-862,-61,149,822
1486,05000US29007,"Audrain County, Missouri",590,524,670,370,892,399,388,1075,995,3698,640,1010,1294,80,3319,1630,714,915,-50,-624,1182,-2532,-555,281,2783
1487,05000US29009,"Barry County, Missouri",704,773,815,329,729,685,849,1960,1554,5264,445,1260,1310,335,4098,2420,1145,2340,259,-495,723,-2564,-460,409,2924
1488,05000US29011,"Barton County, Missouri",291,323,339,214,354,171,344,463,374,2030,395,680,395,49,1609,757,405,649,-104,-56,519,-1094,-294,-31,1381
1489,05000US29013,"Bates County, Missouri",233,392,558,153,434,287,525,593,684,2798,364,695,615,90,2310,1295,449,964,-131,-57,497,-1498,-702,235,1834
1490,05000US29015,"Benton County, Missouri",479,239,323,158,288,609,710,1565,1334,2925,250,515,600,124,2649,1625,1110,1275,229,-277,322,-1330,-60,224,1650
1491,05000US29017,"Bollinger County, Missouri",257,213,217,84,160,370,493,663,669,1835,355,395,155,29,2070,910,415,550,-98,62,215,-1207,-247,254,1285
1492,05000US29019,"Boone County, Missouri",10060,5560,7105,2729,5690,2109,2599,5640,5095,23277,3985,14435,10625,2110,10990,14610,4608,7884,6075,-3520,6309,-6282,-8970,487,15393
1493,05000US29021,"Buchanan County, Missouri",2985,2009,2750,892,3629,1334,1747,3147,3033,12712,1820,3285,6415,745,10205,5765,2252,3365,1165,-3665,3776,-7124,-2618,781,9347
1494,05000US29023,"Butler County, Missouri",1310,1414,1070,598,1670,984,1005,1649,1560,5655,930,1660,3045,430,4909,2834,1270,1734,380,-1975,1838,-2920,-1185,290,3921
1495,05000US29025,"Caldwell County, Missouri",344,211,214,71,101,278,435,634,524,1100,415,480,25,14,1805,545,224,315,-71,189,158,-1092,89,300,785
1496,05000US29027,"Callaway County, Missouri",1215,710,820,525,1265,609,615,1734,1774,7224,890,1780,1760,115,4404,3559,1720,2069,325,-940,1675,-3180,-1825,54,5155
1497,05000US29029,"Camden County, Missouri",802,516,659,354,969,1034,1025,1784,1619,7840,520,1005,1435,345,3094,2905,1645,5855,282,-776,978,-1035,-1121,-26,1985
1498,05000US29031,"Cape Girardeau County, Missouri",2210,1864,2089,1063,3020,965,1407,2572,2457,12398,1275,2365,5185,1434,5793,6404,3460,4224,935,-3096,2649,-3421,-3832,-1003,8174
1499,05000US29033,"Carroll County, Missouri",161,315,216,79,192,281,263,363,311,1506,235,510,188,29,1619,444,169,453,-74,28,242,-1075,-81,142,1053
1500,05000US29035,"Carter County, Missouri",171,144,115,64,183,104,229,243,270,955,215,170,244,24,950,359,160,365,-44,-129,223,-617,-116,110,590
1501,05000US29037,"Cass County, Missouri",2130,1830,2039,1199,2289,1814,2514,4670,4205,16895,1765,3260,3850,615,11414,9995,3705,4530,365,-1811,2873,-7086,-5325,500,12365
1502,05000US29039,"Cedar County, Missouri",450,477,295,188,328,428,380,852,709,2013,390,530,755,65,2155,763,270,1004,60,-460,451,-1347,89,439,1009
1503,05000US29041,"Chariton County, Missouri",150,157,130,73,153,116,258,374,366,1250,205,260,138,49,1205,374,205,405,-55,-8,177,-831,0,161,845
1504,05000US29043,"Christian County, Missouri",1050,1728,1904,843,2460,923,1340,3393,2885,14813,890,2255,4240,589,5670,8295,3678,5614,160,-2336,2714,-3407,-4902,-793,9199
1505,05000US29045,"Clark County, Missouri",141,126,104,99,259,136,209,435,368,1229,189,300,165,70,1185,379,180,440,-48,-61,288,-840,56,188,789
1506,05000US29047,"Clay County, Missouri",5759,4738,6540,3870,6824,2799,4755,9544,8549,38125,3070,10795,12405,1470,24950,23625,7555,6900,2689,-5865,9224,-17396,-14081,994,31225
1507,05000US29049,"Clinton County, Missouri",459,398,562,243,365,569,605,1029,938,3194,390,1110,525,10,3155,1610,655,810,69,37,598,-1981,-581,283,2384
1508,05000US29051,"Cole County, Missouri",2425,1910,2070,1259,2059,838,1310,3089,2684,12214,1805,5925,1924,75,6749,7304,2724,3835,620,146,3243,-4601,-4215,-40,8379
1509,05000US29053,"Cooper County, Missouri",290,413,479,243,416,309,416,728,645,2584,375,865,560,40,2009,1284,488,892,-85,-81,619,-1284,-556,157,1692
1510,05000US29055,"Crawford County, Missouri",639,568,704,224,507,550,644,1189,1180,3502,665,825,1055,94,2499,1824,850,1639,-26,-351,637,-1305,-635,330,1863
1511,05000US29057,"Dade County, Missouri",149,131,194,55,149,228,239,493,399,1247,114,280,260,12,1460,424,189,418,35,-66,192,-993,69,210,829
1512,05000US29059,"Dallas County, Missouri",298,383,349,138,489,309,544,725,733,2349,404,585,595,65,2095,905,555,950,-106,-246,562,-1242,-180,178,1399
1513,05000US29061,"Daviess County, Missouri",105,145,146,66,208,138,242,372,413,1344,235,240,164,10,1180,519,228,563,-130,-18,264,-800,-147,185,781
1514,05000US29063,"DeKalb County, Missouri",170,392,292,90,347,131,290,412,444,1484,390,409,425,74,1325,594,275,404,-220,-133,363,-904,-182,169,1080
1515,05000US29065,"Dent County, Missouri",380,560,279,154,439,359,445,755,593,2255,620,695,395,105,1890,910,580,895,-240,-116,488,-1086,-155,13,1360
1516,05000US29067,"Douglas County, Missouri",325,238,318,50,270,362,552,1048,833,1649,275,505,345,90,1865,795,535,860,50,-27,230,-951,253,298,789
1517,05000US29069,"Dunklin County, Missouri",1333,1028,1094,377,849,908,1039,1349,1374,3895,1390,1580,1580,145,5555,1395,480,769,-57,-486,1081,-3608,-46,894,3126
1518,05000US29071,"Franklin County, Missouri",2355,2384,3083,1015,1710,2299,3613,5950,5115,14310,1950,6155,2400,30,11910,10410,3179,5165,405,683,2695,-5998,-4460,1936,9145
1519,05000US29073,"Gasconade County, Missouri",372,194,300,159,418,243,442,780,754,2705,384,510,534,24,1979,1015,405,1425,-12,-234,553,-1294,-235,349,1280
1520,05000US29075,"Gentry County, Missouri",142,154,184,113,152,171,186,258,256,1074,215,250,235,34,1084,445,105,289,-73,-51,231,-727,-187,151,785
1521,05000US29077,"Greene County, Missouri",12135,9140,11824,5595,11574,4003,5249,10944,9625,42144,4630,14680,26805,4170,23410,25355,9120,13420,7505,-14981,12999,-14158,-14411,505,28724
1522,05000US29079,"Grundy County, Missouri",360,235,265,94,358,274,259,345,348,1587,340,520,370,84,1479,663,225,394,20,-105,368,-946,-318,123,1193
1523,05000US29081,"Harrison County, Missouri",195,228,217,103,221,181,214,424,403,1486,225,395,325,10,1629,384,209,369,-30,-108,314,-1234,40,194,1117
1524,05000US29083,"Henry County, Missouri",674,333,608,203,674,415,593,1239,1103,3813,665,595,895,315,3634,1544,680,1179,9,-287,562,-2626,-305,423,2634
1525,05000US29085,"Hickory County, Missouri",220,207,133,74,88,279,600,505,453,1490,234,240,205,34,1795,625,368,610,-14,-72,128,-916,-120,85,880
1526,05000US29087,"Holt County, Missouri",85,113,169,85,158,102,143,218,223,886,169,295,108,14,809,363,104,292,-84,61,229,-564,-145,119,594
1527,05000US29089,"Howard County, Missouri",232,216,209,90,154,157,221,358,405,1704,320,280,230,64,1320,645,255,605,-88,-21,180,-942,-287,150,1099
1528,05000US29091,"Howell County, Missouri",1185,949,1199,534,1158,1190,1242,2005,1775,5498,1130,1430,2205,225,5309,2510,1389,2184,55,-1006,1467,-2877,-505,386,3314
1529,05000US29093,"Iron County, Missouri",332,209,227,113,230,209,248,669,653,1483,315,480,300,35,1790,714,209,324,17,-73,308,-1333,-45,444,1159
1530,05000US29095,"Jackson County, Missouri",33735,21370,26480,10945,23079,13909,16476,29568,24748,85939,16250,48900,43460,7010,92200,43150,13844,18215,17485,-16980,27014,-61815,-13582,10904,67724
1531,05000US29097,"Jasper County, Missouri",3139,2754,3305,1905,5215,1420,2458,4070,3848,18638,1775,2790,9515,2225,12250,9060,4125,4968,1364,-6210,4895,-8372,-4990,-277,13670
1532,05000US29099,"Jefferson County, Missouri",4365,3334,3980,2110,3050,4694,6290,12569,11155,34689,2980,8090,5120,650,27440,25914,7045,7529,1385,-1140,4510,-16456,-13345,4110,27160
1533,05000US29101,"Johnson County, Missouri",1790,1529,1989,1013,1704,570,597,1555,1509,7879,845,2670,4005,495,4015,4125,1710,2315,945,-2016,2222,-2848,-2570,-201,5564
1534,05000US29103,"Knox County, Missouri",86,83,53,24,111,133,107,243,242,609,139,110,74,18,858,140,120,153,-53,-21,117,-618,103,122,456
1535,05000US29105,"Laclede County, Missouri",980,870,1014,417,1205,550,1063,1233,1265,5383,785,1645,1900,145,3990,2325,1453,1850,195,-886,1477,-2377,-1092,-188,3533
1536,05000US29107,"Lafayette County, Missouri",1064,790,893,330,509,816,1145,2015,1534,4423,1240,1935,335,65,5829,2249,824,826,-176,558,774,-3868,-234,710,3597
1537,05000US29109,"Lawrence County, Missouri",800,613,980,615,1278,690,1089,1659,1683,5577,1030,1235,1815,214,5190,2260,1370,1889,-230,-835,1679,-3411,-601,313,3688
1538,05000US29111,"Lewis County, Missouri",218,176,178,90,358,239,287,347,367,1540,330,430,240,30,1620,513,235,415,-112,-62,418,-1094,-166,132,1125
1539,05000US29113,"Lincoln County, Missouri",1334,955,829,430,753,1290,1329,2705,2370,7414,860,2045,1260,134,6140,5060,1425,2019,474,-431,1049,-3521,-2355,945,5395
1540,05000US29115,"Linn County, Missouri",215,338,406,123,276,185,297,563,598,2155,305,655,335,54,2217,634,333,540,-90,71,345,-1735,-71,265,1615
1541,05000US29117,"Livingston County, Missouri",494,266,443,162,567,258,417,629,545,2150,510,725,569,125,2109,719,439,659,-16,-126,604,-1434,-90,106,1491
1542,05000US29119,"McDonald County, Missouri",410,358,597,317,717,386,515,1128,813,3119,640,695,900,154,2659,1079,660,1403,-230,-303,880,-1758,49,153,1716
1543,05000US29121,"Macon County, Missouri",298,368,492,91,315,218,363,803,823,2520,365,685,465,42,2450,854,510,724,-67,27,364,-1869,-51,313,1796
1544,05000US29123,"Madison County, Missouri",399,266,430,105,219,235,488,467,518,1813,325,590,470,15,1505,925,524,523,74,-40,309,-782,-458,-6,1290
1545,05000US29125,"Maries County, Missouri",175,204,221,160,224,205,225,488,397,1518,259,375,295,64,988,744,425,553,-84,-74,320,-558,-256,-28,965
1546,05000US29127,"Marion County, Missouri",820,783,778,448,1235,485,550,934,874,4446,719,1310,1695,360,2995,2375,739,1343,101,-917,1323,-1960,-1441,135,3103
1547,05000US29129,"Mercer County, Missouri",69,54,81,62,71,103,62,192,177,609,120,114,103,4,620,190,119,130,-51,-22,129,-455,2,58,479
1548,05000US29131,"Miller County, Missouri",552,469,371,347,659,390,779,1194,990,4057,610,580,1140,69,2450,1715,1109,2019,-58,-769,937,-1281,-521,-119,2038
1549,05000US29133,"Mississippi County, Missouri",599,399,524,169,344,287,502,373,417,1555,520,660,780,60,2033,559,254,354,79,-256,453,-1244,-186,163,1201
1550,05000US29135,"Moniteau County, Missouri",298,297,299,140,221,211,297,795,705,2316,370,670,205,10,1995,1009,504,673,-72,94,351,-1487,-214,201,1643
1551,05000US29137,"Monroe County, Missouri",131,171,236,157,216,73,237,431,454,1597,220,410,275,20,1269,649,319,519,-89,-39,353,-959,-218,135,1078
1552,05000US29139,"Montgomery County, Missouri",291,256,316,121,379,208,334,575,561,2020,244,450,609,48,1559,839,370,823,47,-293,452,-1017,-264,191,1197
1553,05000US29141,"Morgan County, Missouri",512,337,322,141,614,848,609,1119,958,2728,515,580,599,220,2418,1238,780,1738,-3,-277,535,-961,-119,178,990
1554,05000US29143,"New Madrid County, Missouri",788,663,540,123,630,413,534,843,712,2363,640,1110,900,94,2893,964,423,435,148,-360,659,-1946,-121,289,1928
1555,05000US29145,"Newton County, Missouri",1020,1014,1415,779,2068,652,1124,2854,2479,9657,1095,1980,2675,535,6040,4318,1999,3679,-75,-1260,2312,-4264,-1464,480,5978
1556,05000US29147,"Nodaway County, Missouri",905,632,924,423,853,308,313,685,608,2975,685,1155,1695,195,2069,1349,508,907,220,-771,1081,-1448,-664,100,2068
1557,05000US29149,"Oregon County, Missouri",392,242,143,75,144,373,409,699,590,1469,295,495,159,54,1884,730,335,544,97,-16,165,-1102,-31,255,925
1558,05000US29151,"Osage County, Missouri",239,196,272,107,88,197,476,752,578,2310,355,445,69,34,1843,1312,495,634,-116,203,161,-1170,-560,83,1676
1559,05000US29153,"Ozark County, Missouri",309,188,222,95,68,278,514,679,540,1309,355,214,305,14,1705,548,370,704,-46,-83,149,-913,131,170,605
1560,05000US29155,"Pemiscot County, Missouri",963,721,732,236,579,259,402,663,637,1974,775,1300,1040,139,2380,675,280,383,188,-308,676,-1719,-12,357,1591
1561,05000US29157,"Perry County, Missouri",345,359,439,169,453,249,650,869,733,3454,360,820,570,20,2234,1804,660,1140,-15,-131,602,-1335,-935,73,2314
1562,05000US29159,"Pettis County, Missouri",1050,834,1163,703,1510,555,1019,1683,1667,6342,670,1075,3110,385,4600,3136,1208,2179,380,-1947,1828,-3026,-1453,459,4163
1563,05000US29161,"Phelps County, Missouri",1795,1240,1493,770,1464,680,1045,1379,1238,6350,1050,1930,3390,410,4205,2705,1330,2660,745,-1897,1824,-2480,-1326,-92,3690
1564,05000US29163,"Pike County, Missouri",331,224,586,220,563,324,367,809,712,2744,385,630,815,115,2309,1188,395,1055,-54,-229,668,-1618,-379,317,1689
1565,05000US29165,"Platte County, Missouri",2054,1894,3090,1734,4509,767,1678,2982,2939,16927,1120,3855,6420,1880,5670,9622,4139,5824,934,-3330,4363,-3225,-6640,-1200,11103
1566,05000US29167,"Polk County, Missouri",677,868,929,374,1072,279,699,1123,1078,4889,355,1220,1875,454,2779,2314,1005,1869,322,-946,992,-1801,-1191,73,3020
1567,05000US29169,"Pulaski County, Missouri",924,929,1215,1093,3805,368,549,1008,1284,4480,1035,1045,3360,2535,2520,2475,1390,1490,-111,-2145,2363,-1603,-1467,-106,2990
1568,05000US29171,"Putnam County, Missouri",162,82,154,44,107,77,179,238,196,785,148,220,150,24,760,209,159,295,14,4,127,-504,29,37,490
1569,05000US29173,"Ralls County, Missouri",136,122,155,83,218,215,234,524,568,1969,260,139,265,44,1365,828,660,454,-124,-110,257,-916,-304,-92,1515
1570,05000US29175,"Randolph County, Missouri",529,544,287,135,562,333,673,1045,873,3668,315,745,890,104,3190,1414,629,1065,214,-603,593,-2184,-369,244,2603
1571,05000US29177,"Ray County, Missouri",802,282,348,132,383,599,769,1154,1130,3337,720,925,264,45,3848,1792,594,550,82,84,470,-2480,-638,536,2787
1572,05000US29179,"Reynolds County, Missouri",118,133,152,22,134,143,226,419,323,1110,180,260,124,0,1100,390,275,335,-62,28,156,-731,29,48,775
1573,05000US29181,"Ripley County, Missouri",309,405,206,119,227,464,539,904,635,1850,355,630,245,20,2225,995,445,570,-46,-39,326,-1222,-91,190,1280
1574,05000US29183,"St. Charles County, Missouri",4195,4720,6785,3993,8559,4894,6379,15083,14232,76399,2645,7275,15270,3085,21110,51450,20925,21769,1550,-8485,9467,-9837,-36367,-6693,54630
1575,05000US29185,"St. Clair County, Missouri",242,202,298,71,222,410,340,493,421,1497,415,375,200,40,1750,494,444,519,-173,98,253,-1000,-1,-23,978
1576,05000US29186,"Ste. Genevieve County, Missouri",370,398,416,169,294,280,399,870,830,3389,530,490,625,8,1835,1775,785,1249,-160,-209,455,-1156,-905,45,2140
1577,05000US29187,"St. Francois County, Missouri",1730,1405,1600,808,2205,930,1673,2695,2785,9294,1075,2755,3485,440,7455,4205,2945,2860,655,-1885,2573,-4852,-1510,-160,6434
1578,05000US29189,"St. Louis County, Missouri",25985,23035,29315,13700,30505,16979,22520,40844,36477,170150,11480,38135,60275,12640,96050,78774,33265,75965,14505,-30960,31565,-56551,-37930,3212,94185
1579,05000US29195,"Saline County, Missouri",495,569,604,359,704,292,534,981,857,3509,470,935,1160,179,3035,1570,573,1018,25,-556,884,-2209,-589,284,2491
1580,05000US29197,"Schuyler County, Missouri",144,91,87,34,120,113,122,188,183,621,159,180,100,19,763,197,30,228,-15,-13,135,-528,-9,153,393
1581,05000US29199,"Scotland County, Missouri",133,105,87,31,185,73,153,236,203,725,128,280,134,0,760,163,43,370,5,-47,216,-534,73,160,355
1582,05000US29201,"Scott County, Missouri",1308,815,948,713,970,609,929,1619,1454,6265,935,1265,2280,258,4923,2954,1210,1710,373,-1332,1425,-3385,-1335,244,4555
1583,05000US29203,"Shannon County, Missouri",248,243,150,88,159,263,343,388,339,1000,350,325,185,39,1140,399,264,544,-102,-35,208,-534,-11,75,456
1584,05000US29205,"Shelby County, Missouri",101,143,140,106,157,120,238,297,246,972,265,245,128,8,1249,275,149,193,-164,12,255,-891,22,97,779
1585,05000US29207,"Stoddard County, Missouri",720,692,874,435,897,574,734,1403,1329,4334,920,1175,1365,150,4290,1785,1094,1224,-200,-491,1182,-2982,-382,235,3110
1586,05000US29209,"Stone County, Missouri",353,543,693,358,647,546,913,1740,1627,6022,420,620,1190,350,2769,2210,1248,4428,-67,-497,655,-1310,-470,379,1594
1587,05000US29211,"Sullivan County, Missouri",90,151,117,45,202,88,193,300,282,948,185,205,200,8,1073,269,135,218,-95,-83,239,-792,31,147,730
1588,05000US29213,"Taney County, Missouri",1459,1560,2309,884,2749,727,1268,2272,2023,7168,830,1385,5190,1565,4645,3859,1880,3310,629,-2881,2068,-2650,-1587,143,3858
1589,05000US29215,"Texas County, Missouri",744,580,489,245,356,587,868,1244,1089,3380,720,875,625,194,3309,1694,865,1330,24,-136,407,-1854,-450,224,2050
1590,05000US29217,"Vernon County, Missouri",483,444,713,269,682,307,448,968,978,3168,485,670,1265,165,2803,1160,735,979,-2,-552,786,-2048,-192,243,2189
1591,05000US29219,"Warren County, Missouri",835,584,424,192,410,627,1053,2270,1550,4590,470,1310,595,60,3695,3222,1055,1790,365,-171,542,-2015,-952,495,2800
1592,05000US29221,"Washington County, Missouri",459,283,332,201,354,650,905,1579,1384,3530,580,650,385,25,4005,1400,809,1360,-121,-53,530,-2450,179,575,2170
1593,05000US29223,"Wayne County, Missouri",408,248,334,84,215,405,600,719,700,1830,269,610,395,4,2610,880,425,465,139,-61,295,-1605,-161,275,1365
1594,05000US29225,"Webster County, Missouri",705,898,945,268,810,768,1008,1630,1485,5090,640,1955,930,110,4390,2595,1060,1775,65,15,968,-2614,-965,425,3315
1595,05000US29227,"Worth County, Missouri",48,46,56,24,55,64,31,76,87,447,115,63,34,12,445,99,40,80,-67,22,67,-350,-23,47,367
1596,05000US29229,"Wright County, Missouri",640,612,602,221,314,548,650,1097,1012,2245,640,1210,480,49,2625,1065,640,864,0,122,486,-1427,32,372,1381
1597,05000US29510,"St. Louis city, Missouri",28415,13910,15655,6095,14815,7173,7344,10684,8857,28763,12565,30390,29565,6365,32265,18675,4605,7840,15850,-13910,14545,-17748,-7991,4252,20923
1598,05000US30001,"Beaverhead County, Montana",404,264,278,99,304,197,243,516,392,1475,340,665,320,25,599,799,324,969,64,-42,378,-159,-283,68,506
1599,05000US30003,"Big Horn County, Montana",312,337,283,177,328,230,314,339,306,1175,510,560,363,8,1324,580,160,210,-198,-80,497,-780,-241,146,965
1600,05000US30005,"Blaine County, Montana",273,193,210,128,128,220,168,286,212,553,530,360,49,14,830,329,95,109,-257,161,242,-442,-43,117,444
1601,05000US30007,"Broadwater County, Montana",108,12,69,105,77,92,236,313,227,1208,125,185,49,25,480,530,328,714,-17,20,157,-152,-217,-101,494
1602,05000US30009,"Carbon County, Montana",234,121,237,108,253,341,335,605,601,1973,225,405,295,30,828,724,509,1570,9,-58,331,-152,-119,92,403
1603,05000US30011,"Carter County, Montana",18,18,30,15,31,59,83,78,78,204,60,33,14,0,258,74,18,109,-42,16,46,-116,4,60,95
1604,05000US30013,"Cascade County, Montana",2799,2265,2960,1370,2435,1411,2399,3664,3295,12651,2020,4890,4245,670,5434,8885,3315,5218,779,-1285,3135,-1624,-5221,-20,7433
1605,05000US30015,"Chouteau County, Montana",189,193,273,71,144,139,178,287,258,651,530,260,64,0,710,357,150,227,-341,209,215,-393,-70,108,424
1606,05000US30017,"Custer County, Montana",278,196,439,131,410,222,337,551,547,1946,340,620,385,115,1239,1207,390,695,-62,54,426,-680,-656,157,1251
1607,05000US30019,"Daniels County, Montana",39,33,64,25,44,32,60,117,122,332,49,94,45,20,345,159,75,104,-10,19,49,-253,-42,47,228
1608,05000US30021,"Dawson County, Montana",183,104,438,188,323,203,223,431,319,1782,195,555,375,115,1094,953,329,453,-12,63,396,-668,-522,-10,1329
1609,05000US30023,"Deer Lodge County, Montana",375,330,124,75,284,225,329,589,559,1298,380,530,285,4,1410,884,215,385,-5,-161,355,-856,-295,344,913
1610,05000US30025,"Fallon County, Montana",34,45,140,44,139,55,72,107,87,490,190,100,105,4,349,315,80,85,-156,35,179,-222,-208,7,405
1611,05000US30027,"Fergus County, Montana",253,271,337,103,531,345,318,658,564,1653,329,635,460,59,1464,980,313,779,-76,-123,575,-801,-322,251,874
1612,05000US30029,"Flathead County, Montana",2440,1875,2154,1234,2950,1988,2288,4794,4248,15279,1970,2710,4345,1625,3920,5069,4015,15120,470,-2191,2559,356,-275,233,159
1613,05000US30031,"Gallatin County, Montana",3710,2949,3904,1530,3540,1513,1587,3593,3445,15664,1695,5310,6920,1704,2685,4610,3760,14355,2015,-3016,3366,415,-1017,-315,1309
1614,05000US30033,"Garfield County, Montana",18,19,32,14,12,35,47,56,46,190,60,29,4,0,198,50,8,105,-42,28,26,-116,6,38,85
1615,05000US30035,"Glacier County, Montana",655,303,400,162,170,672,358,277,252,898,825,630,220,40,1384,729,65,298,-170,180,292,-354,-452,187,600
1616,05000US30037,"Golden Valley County, Montana",26,8,18,12,33,18,44,50,52,109,39,30,29,4,134,48,8,45,-13,-11,41,-72,2,44,64
1617,05000US30039,"Granite County, Montana",77,104,63,22,118,46,72,214,171,480,208,130,35,0,219,185,108,474,-131,28,140,-101,29,63,6
1618,05000US30041,"Hill County, Montana",699,419,445,263,525,328,441,710,609,1988,725,1020,515,84,1805,1205,403,564,-26,-70,704,-1036,-495,206,1424
1619,05000US30043,"Jefferson County, Montana",97,178,158,104,123,300,397,496,477,2277,254,300,115,4,659,830,681,1728,-157,43,223,38,-334,-204,549
1620,05000US30045,"Judith Basin County, Montana",38,73,46,38,79,71,108,100,92,348,174,74,14,0,275,179,45,165,-136,32,117,-96,-79,47,183
1621,05000US30047,"Lake County, Montana",871,567,929,349,620,1044,1082,1482,1327,3873,1020,1285,895,130,1734,1845,1059,4009,-149,34,839,392,-363,268,-136
1622,05000US30049,"Lewis and Clark County, Montana",1789,1855,2104,730,2130,1037,1287,2807,2724,11520,1400,3450,3345,424,3175,6715,4135,5090,389,-1241,2436,-851,-3908,-1411,6430
1623,05000US30051,"Liberty County, Montana",74,47,93,14,107,32,30,125,124,247,213,69,44,0,315,150,25,69,-139,49,121,-253,-25,99,178
1624,05000US30053,"Lincoln County, Montana",597,334,355,145,269,710,1188,1324,1020,2633,420,810,430,34,2145,1425,785,2459,177,-75,380,-247,-101,235,174
1625,05000US30055,"McCone County, Montana",4,14,44,20,50,67,70,120,126,275,65,70,4,0,290,114,49,129,-61,40,70,-153,6,77,146
1626,05000US30057,"Madison County, Montana",128,118,199,108,261,155,293,670,592,1226,315,185,260,40,425,579,314,1474,-187,-61,329,23,91,278,-248
1627,05000US30059,"Meagher County, Montana",48,43,63,39,53,78,62,113,140,204,124,90,20,0,220,144,35,148,-76,43,92,-80,-31,105,56
1628,05000US30061,"Mineral County, Montana",179,99,89,39,95,110,227,185,141,542,175,200,130,0,450,275,103,409,4,-41,134,-113,-90,38,133
1629,05000US30063,"Missoula County, Montana",5010,3865,4359,2255,4233,2007,1914,4449,3824,17135,2025,5480,10105,2120,3660,3939,5435,15370,2985,-5746,4368,261,510,-1611,1765
1630,05000US30065,"Musselshell County, Montana",175,162,144,28,104,129,289,224,219,695,245,210,154,10,560,365,170,465,-70,-10,122,-142,-141,49,230
1631,05000US30067,"Park County, Montana",465,270,634,268,572,458,599,1054,934,2717,405,805,830,159,770,1088,785,2760,60,-196,681,287,-34,149,-43
1632,05000US30069,"Petroleum County, Montana",18,16,14,12,23,12,22,38,46,68,64,8,0,4,68,18,12,32,-46,14,31,-34,20,34,36
1633,05000US30071,"Phillips County, Montana",153,123,48,84,107,106,192,242,237,604,314,165,29,4,675,380,49,175,-161,19,187,-377,-138,188,429
1634,05000US30073,"Pondera County, Montana",142,170,162,36,101,139,122,287,277,832,305,180,129,0,789,477,154,249,-163,33,137,-528,-190,123,583
1635,05000US30075,"Powder River County, Montana",28,62,69,44,61,38,46,67,98,292,204,69,4,0,270,104,15,104,-176,65,105,-186,-37,83,188
1636,05000US30077,"Powell County, Montana",165,83,253,109,118,127,97,344,322,905,285,295,150,15,589,489,148,439,-120,103,212,-365,-145,174,466
1637,05000US30079,"Prairie County, Montana",4,19,4,20,18,34,54,94,87,249,35,19,10,0,288,149,20,40,-31,-6,38,-200,-55,67,209
1638,05000US30081,"Ravalli County, Montana",969,1047,1144,379,867,1238,1578,2194,1919,6334,735,1535,1845,285,1699,2579,1880,6764,234,-701,961,1117,-385,39,-430
1639,05000US30083,"Richland County, Montana",168,379,408,146,584,174,246,239,215,1864,440,690,430,135,835,845,509,695,-272,-22,595,-415,-606,-294,1169
1640,05000US30085,"Roosevelt County, Montana",466,294,232,77,272,277,200,263,257,921,815,390,130,19,980,499,162,224,-349,102,330,-503,-236,95,697
1641,05000US30087,"Rosebud County, Montana",236,189,132,62,263,253,232,278,338,1291,425,340,125,4,1185,749,224,218,-189,7,321,-700,-471,114,1073
1642,05000US30089,"Sanders County, Montana",407,302,216,104,184,476,592,770,609,1412,490,435,250,29,909,715,560,1669,-83,-34,259,159,55,49,-257
1643,05000US30091,"Sheridan County, Montana",88,53,94,53,107,138,135,245,195,627,154,149,84,4,629,360,150,140,-66,10,156,-356,-115,45,487
1644,05000US30093,"Silver Bow County, Montana",1880,980,1029,339,879,822,1100,1782,1674,5097,1150,2215,1470,280,4455,3134,1078,1710,730,-441,938,-2533,-1352,596,3387
1645,05000US30095,"Stillwater County, Montana",77,179,272,58,249,170,253,472,411,1724,294,340,199,4,583,835,404,1163,-217,73,303,-160,-363,7,561
1646,05000US30097,"Sweet Grass County, Montana",62,95,87,49,106,75,154,234,190,611,174,80,110,19,225,258,174,474,-112,-23,136,4,-24,16,137
1647,05000US30099,"Teton County, Montana",105,158,230,58,202,105,155,326,263,931,244,229,235,20,599,463,193,483,-139,-5,240,-339,-137,70,448
1648,05000US30101,"Toole County, Montana",178,108,289,47,159,94,67,136,142,690,370,350,55,10,589,347,109,120,-192,234,196,-428,-211,33,570
1649,05000US30103,"Treasure County, Montana",30,12,18,16,38,18,45,80,52,84,59,33,19,0,155,44,24,30,-29,-1,54,-92,36,28,54
1650,05000US30105,"Valley County, Montana",178,203,178,23,342,162,349,383,309,1448,430,395,70,10,985,999,324,309,-252,108,355,-474,-616,-15,1139
1651,05000US30107,"Wheatland County, Montana",79,62,58,23,84,41,103,121,103,221,194,75,29,0,359,138,24,33,-115,29,107,-215,-17,79,188
1652,05000US30109,"Wibaux County, Montana",10,8,24,20,51,55,56,93,69,167,15,38,40,10,204,79,19,84,-5,-16,61,-93,14,50,83
1653,05000US30111,"Yellowstone County, Montana",4245,4114,4550,2120,5445,2564,3554,6724,5780,25949,2490,7165,8750,2075,7455,14700,9095,12675,1755,-4200,5490,-1337,-7976,-3315,13274
1654,05000US31001,"Adams County, Nebraska",839,1044,973,445,724,480,669,1370,1435,5153,780,1990,1085,150,4650,2385,749,939,59,-112,1019,-3501,-1015,686,4214
1655,05000US31003,"Antelope County, Nebraska",180,147,86,68,167,172,294,406,387,977,319,254,34,25,1498,380,129,150,-139,52,210,-1032,26,258,827
1656,05000US31005,"Arthur County, Nebraska",14,23,12,8,14,16,36,20,12,60,40,24,4,0,60,29,8,23,-26,8,22,-8,-9,4,37
1657,05000US31007,"Banner County, Nebraska",15,18,32,12,28,19,26,22,30,122,64,20,10,0,84,54,25,40,-49,22,40,-39,-32,5,82
1658,05000US31009,"Blaine County, Nebraska",10,8,27,14,41,12,16,30,20,89,65,20,4,0,95,33,14,8,-55,23,55,-67,-3,6,81
1659,05000US31011,"Boone County, Nebraska",98,98,108,44,163,108,175,360,324,963,185,244,85,4,1074,355,115,230,-87,23,203,-791,5,209,733
1660,05000US31013,"Box Butte County, Nebraska",277,315,305,149,248,208,131,373,368,2132,194,880,225,15,2014,858,209,219,83,80,382,-1675,-485,159,1913
1661,05000US31015,"Boyd County, Nebraska",32,46,35,23,44,112,91,118,123,353,103,57,4,4,578,95,23,54,-71,31,63,-375,23,100,299
1662,05000US31017,"Brown County, Nebraska",97,93,59,68,79,124,137,217,197,507,210,174,18,4,860,110,40,69,-113,41,143,-599,107,157,438
1663,05000US31019,"Buffalo County, Nebraska",1648,1425,1665,727,1510,660,905,1940,1723,7253,1290,3155,2305,245,4135,4488,1499,1964,358,-640,1992,-2570,-2548,224,5289
1664,05000US31021,"Burt County, Nebraska",150,192,145,72,166,199,246,366,366,1138,249,290,119,39,1474,524,100,160,-99,26,199,-1029,-158,266,978
1665,05000US31023,"Butler County, Nebraska",150,178,107,102,159,165,218,539,480,1424,164,365,154,4,1514,744,225,265,-14,-47,257,-1131,-205,255,1159
1666,05000US31025,"Cass County, Nebraska",354,275,567,198,409,583,644,1325,1364,4516,420,985,328,70,3408,2439,924,1465,-66,239,537,-2181,-1114,440,3051
1667,05000US31027,"Cedar County, Nebraska",96,144,145,122,189,221,299,447,438,1512,330,279,45,25,1614,708,225,370,-234,100,286,-1094,-261,213,1142
1668,05000US31029,"Chase County, Nebraska",77,69,80,12,98,65,168,200,188,795,165,115,30,15,720,425,95,140,-88,50,95,-487,-225,93,655
1669,05000US31031,"Cherry County, Nebraska",79,175,324,130,304,107,171,208,178,962,585,165,200,60,889,470,54,229,-506,124,374,-611,-262,124,733
1670,05000US31033,"Cheyenne County, Nebraska",254,247,293,125,370,277,218,478,543,1723,335,645,270,40,2019,799,190,185,-81,23,455,-1524,-321,353,1538
1671,05000US31035,"Clay County, Nebraska",118,117,155,83,141,117,197,314,338,1138,189,329,78,4,1512,310,83,125,-71,77,220,-1198,4,255,1013
1672,05000US31037,"Colfax County, Nebraska",74,187,358,93,455,182,330,408,403,1334,360,500,279,15,1619,534,140,224,-286,79,533,-1107,-126,263,1110
1673,05000US31039,"Cuming County, Nebraska",169,257,389,111,294,117,194,492,407,1473,369,579,245,20,1468,715,155,335,-200,144,385,-1157,-223,252,1138
1674,05000US31041,"Custer County, Nebraska",259,297,386,107,303,290,327,632,551,1811,424,715,159,49,2094,741,194,500,-165,227,361,-1477,-109,357,1311
1675,05000US31043,"Dakota County, Nebraska",665,359,604,453,461,395,339,932,734,2604,550,780,1150,60,2354,1884,300,365,115,-546,854,-1620,-952,434,2239
1676,05000US31045,"Dawes County, Nebraska",394,206,260,195,279,167,168,435,415,1206,420,630,200,85,1253,609,190,254,-26,60,389,-918,-174,225,952
1677,05000US31047,"Dawson County, Nebraska",540,583,835,339,645,318,650,1018,965,3139,565,1525,790,70,3600,1534,385,535,-25,45,914,-2632,-516,580,2604
1678,05000US31049,"Deuel County, Nebraska",18,62,49,20,67,48,83,99,109,321,80,98,38,0,464,105,28,35,-62,11,87,-333,-6,81,286
1679,05000US31051,"Dixon County, Nebraska",67,82,107,57,148,126,176,329,273,1011,149,189,94,34,1309,314,100,153,-82,13,171,-1007,15,173,858
1680,05000US31053,"Dodge County, Nebraska",860,843,1665,818,1268,697,854,1433,1608,5453,775,2555,1840,270,4680,3210,680,1160,85,-175,1816,-3129,-1777,928,4293
1681,05000US31055,"Douglas County, Nebraska",22075,15835,19280,9079,16820,8112,10769,20705,17020,77588,9325,33955,34355,5470,56585,45495,12674,17429,12750,-15075,20429,-37704,-24790,4346,60159
1682,05000US31057,"Dundy County, Nebraska",45,68,43,49,69,62,66,137,98,281,203,53,19,4,424,89,19,68,-158,24,114,-296,48,79,213
1683,05000US31059,"Fillmore County, Nebraska",123,107,115,69,198,147,183,267,286,1055,195,350,65,4,1336,304,74,185,-72,50,263,-1006,-37,212,870
1684,05000US31061,"Franklin County, Nebraska",50,16,69,22,87,114,157,176,220,541,109,89,34,0,988,85,14,84,-59,35,109,-717,91,206,457
1685,05000US31063,"Frontier County, Nebraska",44,44,90,23,66,63,74,123,160,448,129,94,15,19,554,194,80,49,-85,75,70,-417,-71,80,399
1686,05000US31065,"Furnas County, Nebraska",143,151,168,33,115,140,161,322,281,762,250,280,44,40,1278,220,29,64,-107,124,108,-977,102,252,698
1687,05000US31067,"Gage County, Nebraska",453,567,730,329,838,447,576,1062,992,3470,600,1470,765,85,3383,1590,643,750,-147,-35,1082,-2360,-528,349,2720
1688,05000US31069,"Garden County, Nebraska",60,18,38,39,30,75,89,134,123,353,93,68,19,0,488,129,24,85,-33,19,69,-324,5,99,268
1689,05000US31071,"Garfield County, Nebraska",88,28,39,39,8,59,71,118,115,315,134,54,0,8,458,119,40,100,-46,39,39,-328,-1,75,215
1690,05000US31073,"Gosper County, Nebraska",12,35,70,12,145,28,73,101,100,328,103,135,30,0,335,120,55,105,-91,40,157,-234,-19,45,223
1691,05000US31075,"Grant County, Nebraska",8,14,18,4,28,28,48,45,45,112,48,4,4,0,164,34,4,23,-40,14,32,-88,11,41,89
1692,05000US31077,"Greeley County, Nebraska",38,32,42,18,67,79,118,159,167,366,89,78,14,19,658,105,20,60,-51,28,66,-461,54,147,306
1693,05000US31079,"Hall County, Nebraska",1724,1919,1855,1090,2162,707,1070,1954,1945,8747,1285,4230,2875,350,5849,5100,1500,1814,439,-1020,2902,-4072,-3146,445,6933
1694,05000US31081,"Hamilton County, Nebraska",154,112,178,65,202,72,257,496,418,1752,240,320,114,19,1568,758,314,459,-86,64,248,-1239,-262,104,1293
1695,05000US31083,"Harlan County, Nebraska",92,92,61,54,73,77,173,202,207,578,174,159,20,14,844,195,95,100,-82,41,113,-594,7,112,478
1696,05000US31085,"Hayes County, Nebraska",18,14,20,29,64,41,37,64,64,115,109,29,4,0,218,25,8,30,-91,16,93,-140,39,56,85
1697,05000US31087,"Hitchcock County, Nebraska",71,76,78,32,83,83,162,186,175,368,140,148,43,4,750,99,20,60,-69,35,111,-505,87,155,308
1698,05000US31089,"Holt County, Nebraska",237,218,265,193,376,251,342,549,488,1744,403,560,284,35,1969,935,170,254,-166,-19,534,-1376,-386,318,1490
1699,05000US31091,"Hooker County, Nebraska",14,16,23,28,4,28,8,59,51,122,30,29,14,0,185,24,14,14,-16,9,32,-149,35,37,108
1700,05000US31093,"Howard County, Nebraska",166,87,208,64,81,113,170,388,363,1153,279,219,90,30,1075,488,255,238,-113,118,115,-792,-100,108,915
1701,05000US31095,"Jefferson County, Nebraska",203,165,289,58,163,234,307,393,434,1123,360,439,75,4,1648,405,140,255,-157,214,217,-1107,-12,294,868
1702,05000US31097,"Johnson County, Nebraska",126,100,119,48,96,66,191,202,246,719,145,265,70,8,944,250,60,149,-19,49,136,-687,-48,186,570
1703,05000US31099,"Kearney County, Nebraska",107,127,257,162,177,143,147,324,284,1100,220,435,134,44,903,615,150,230,-113,123,295,-613,-291,134,870
1704,05000US31101,"Keith County, Nebraska",369,261,319,104,249,140,304,562,531,1310,435,605,235,10,1533,585,300,309,-66,84,343,-1089,-23,231,1001
1705,05000US31103,"Keya Paha County, Nebraska",8,8,46,12,20,22,10,72,58,113,48,23,20,4,169,49,8,39,-40,26,28,-137,23,50,74
1706,05000US31105,"Kimball County, Nebraska",118,79,104,44,154,70,153,243,204,456,115,235,140,20,794,209,10,50,3,-36,178,-571,34,194,406
1707,05000US31107,"Knox County, Nebraska",218,177,228,105,254,223,319,501,517,1317,520,370,74,10,1848,452,175,283,-302,154,349,-1306,49,342,1034
1708,05000US31109,"Lancaster County, Nebraska",12735,10600,10960,5190,8845,3317,4839,11463,10282,44880,5930,21395,18915,2065,24710,28745,8485,11214,6805,-7955,11970,-16554,-17282,1797,33666
1709,05000US31111,"Lincoln County, Nebraska",1075,799,1374,610,1530,618,634,1374,1333,5924,1045,2470,1590,260,4255,2989,1040,1440,30,-216,1880,-3003,-1615,293,4484
1710,05000US31113,"Logan County, Nebraska",16,16,44,8,43,26,36,56,42,127,74,32,4,0,140,55,14,45,-58,40,51,-78,1,28,82
1711,05000US31115,"Loup County, Nebraska",4,8,14,4,14,16,31,44,26,130,35,4,4,0,100,18,20,65,-31,10,18,-53,26,6,65
1712,05000US31117,"McPherson County, Nebraska",12,4,8,12,36,27,22,8,8,85,24,29,4,4,68,25,8,30,-12,4,44,-19,-17,0,55
1713,05000US31119,"Madison County, Nebraska",1384,678,1295,710,865,604,934,1320,1164,5463,1090,2515,1150,180,4285,2874,980,1208,294,145,1395,-2747,-1554,184,4255
1714,05000US31121,"Merrick County, Nebraska",137,170,129,133,247,152,243,382,389,1347,259,395,140,23,1543,489,164,244,-122,-11,357,-1148,-107,225,1103
1715,05000US31123,"Morrill County, Nebraska",63,148,168,108,100,123,137,299,329,630,215,260,105,0,1000,270,74,135,-152,63,208,-740,29,255,495
1716,05000US31125,"Nance County, Nebraska",94,56,84,28,71,122,224,208,177,558,160,149,24,0,914,190,34,109,-66,60,99,-568,18,143,449
1717,05000US31127,"Nemaha County, Nebraska",190,184,144,63,216,183,189,379,391,1019,295,394,73,25,1248,459,85,270,-105,71,254,-876,-80,306,749
1718,05000US31129,"Nuckolls County, Nebraska",144,143,76,63,49,62,221,402,371,694,240,195,50,0,1214,190,34,99,-96,26,112,-931,212,337,595
1719,05000US31131,"Otoe County, Nebraska",308,298,557,229,374,203,460,668,633,2828,354,1010,389,19,2130,1334,530,795,-46,168,584,-1467,-666,103,2033
1720,05000US31133,"Pawnee County, Nebraska",92,41,42,58,12,127,146,163,173,463,108,113,19,4,715,95,50,135,-16,23,66,-442,68,123,328
1721,05000US31135,"Perkins County, Nebraska",72,46,64,34,58,66,105,147,128,560,79,134,34,20,642,135,120,105,-7,30,72,-471,12,8,455
1722,05000US31137,"Phelps County, Nebraska",254,214,290,89,313,98,298,439,439,1575,249,660,195,44,1420,680,325,300,5,95,358,-1024,-241,114,1275
1723,05000US31139,"Pierce County, Nebraska",98,72,224,62,138,193,197,424,417,1344,175,365,34,0,1359,560,219,290,-77,190,200,-969,-136,198,1054
1724,05000US31141,"Platte County, Nebraska",680,719,754,555,1019,640,824,1330,1519,5215,1060,1590,964,104,4184,3010,890,1155,-380,-210,1470,-2720,-1680,629,4060
1725,05000US31143,"Polk County, Nebraska",76,115,77,42,108,106,103,245,256,975,164,184,39,15,1135,280,110,130,-88,38,135,-926,-35,146,845
1726,05000US31145,"Red Willow County, Nebraska",314,332,253,124,130,273,424,710,586,1755,360,600,169,20,2330,774,179,184,-46,84,234,-1633,-64,407,1571
1727,05000US31147,"Richardson County, Nebraska",226,202,173,53,203,280,455,442,356,1458,505,290,69,0,2238,419,80,225,-279,104,256,-1503,23,276,1233
1728,05000US31149,"Rock County, Nebraska",23,18,64,16,51,48,29,74,98,266,94,49,4,4,318,125,40,20,-71,60,63,-241,-51,58,246
1729,05000US31151,"Saline County, Nebraska",340,353,362,119,436,229,214,724,553,1854,259,715,534,98,2130,850,210,288,81,-172,457,-1687,-126,343,1566
1730,05000US31153,"Sarpy County, Nebraska",2745,3448,5140,2578,5485,1428,2275,6058,5589,29650,1565,6745,9795,1270,14145,19175,5865,5584,1180,-4655,6793,-10442,-13117,-276,24066
1731,05000US31155,"Saunders County, Nebraska",383,347,364,238,387,323,489,1098,1074,3717,500,785,370,49,2627,2114,785,995,-117,-6,576,-1815,-1016,289,2722
1732,05000US31157,"Scotts Bluff County, Nebraska",1039,948,1169,444,889,665,963,1783,1488,5412,1020,1600,1590,279,5118,2858,713,1365,19,-421,1054,-3490,-1075,775,4047
1733,05000US31159,"Seward County, Nebraska",508,379,462,127,423,147,416,764,750,2747,475,1055,295,63,1827,1733,485,620,33,167,487,-1264,-969,265,2127
1734,05000US31161,"Sheridan County, Nebraska",128,115,195,144,108,163,247,318,285,717,260,309,99,14,1189,209,105,165,-132,96,238,-779,109,180,552
1735,05000US31163,"Sherman County, Nebraska",28,39,65,30,93,132,97,250,166,534,133,108,15,0,749,200,65,110,-105,50,123,-520,50,101,424
1736,05000US31165,"Sioux County, Nebraska",24,32,32,18,49,41,84,88,67,194,73,44,24,4,259,45,39,99,-49,8,63,-134,43,28,95
1737,05000US31167,"Stanton County, Nebraska",83,47,97,48,114,166,199,292,318,1059,124,99,140,25,1084,530,95,250,-41,-43,137,-719,-238,223,809
1738,05000US31169,"Thayer County, Nebraska",76,70,186,52,139,155,203,337,279,960,220,260,29,10,1328,205,70,215,-144,157,181,-970,132,209,745
1739,05000US31171,"Thomas County, Nebraska",14,27,14,10,27,18,16,31,33,122,54,19,19,0,138,50,15,14,-40,-5,37,-104,-19,18,108
1740,05000US31173,"Thurston County, Nebraska",297,192,152,84,139,131,144,187,159,672,329,415,100,19,897,259,44,115,-32,52,204,-622,-72,115,557
1741,05000US31175,"Valley County, Nebraska",165,74,211,50,62,147,102,226,204,764,190,225,95,45,875,320,70,114,-25,116,67,-626,-94,134,650
1742,05000US31177,"Washington County, Nebraska",605,312,429,272,295,310,393,1055,829,3767,654,890,260,100,2165,2034,855,1240,-49,169,467,-1462,-979,-26,2527
1743,05000US31179,"Wayne County, Nebraska",459,223,283,87,273,53,214,354,458,1394,450,614,230,14,1199,570,125,420,9,53,346,-932,-216,333,974
1744,05000US31181,"Webster County, Nebraska",68,82,82,20,68,104,194,266,211,535,189,90,29,0,844,230,35,115,-121,53,88,-546,36,176,420
1745,05000US31183,"Wheeler County, Nebraska",8,16,28,24,53,20,42,63,40,131,69,40,4,0,140,65,8,40,-61,24,77,-78,-2,32,91
1746,05000US31185,"York County, Nebraska",409,319,244,188,483,182,358,580,574,2491,454,810,329,60,1930,1222,354,530,-45,-85,611,-1390,-642,220,1961
1747,05000US32001,"Churchill County, Nevada",728,594,939,380,828,572,505,1113,763,3514,825,1020,1470,150,1785,2045,795,1634,-97,-531,1058,-708,-932,-32,1880
1748,05000US32003,"Clark County, Nevada",61380,53420,75970,39965,123925,22440,30100,56825,49949,245775,15955,38770,199735,100205,70760,107935,65575,160525,45425,-123765,63685,-18220,-51110,-15626,85250
1749,05000US32005,"Douglas County, Nevada",924,1045,1179,848,2239,828,1020,1962,1958,8724,470,645,3905,1210,1275,1955,1939,9144,454,-2726,1877,573,7,19,-420
1750,05000US32007,"Elko County, Nevada",1045,1015,1120,415,1668,867,785,1519,1709,8047,1490,1490,1960,315,4180,4596,2225,1713,-445,-840,1768,-2528,-3077,-516,6334
1751,05000US32009,"Esmeralda County, Nevada",28,67,59,14,58,15,37,75,75,125,110,110,10,0,182,42,18,35,-82,49,72,-130,33,57,90
1752,05000US32011,"Eureka County, Nevada",80,15,40,55,50,130,0,30,50,318,145,55,40,0,349,79,50,40,-65,0,105,-219,-49,0,278
1753,05000US32013,"Humboldt County, Nevada",259,300,352,103,435,288,386,684,583,3049,345,555,540,10,1625,2074,470,770,-86,-188,528,-951,-1390,113,2279
1754,05000US32015,"Lander County, Nevada",120,70,75,59,89,140,190,205,385,1015,220,135,60,0,855,600,150,175,-100,15,148,-525,-395,235,840
1755,05000US32017,"Lincoln County, Nevada",185,99,114,20,170,59,94,265,215,770,185,290,115,0,595,345,135,260,0,-1,190,-442,-80,80,510
1756,05000US32019,"Lyon County, Nevada",1030,1010,1163,905,1764,1205,1434,2249,2309,7574,695,1500,3175,509,4655,4745,1875,3474,335,-2012,2160,-2016,-2496,434,4100
1757,05000US32021,"Mineral County, Nevada",159,158,109,60,150,139,197,164,114,624,300,250,74,19,765,375,65,69,-141,35,191,-429,-211,49,555
1758,05000US32023,"Nye County, Nevada",1225,1050,1120,640,1510,1350,1365,2505,2210,5630,975,2230,2050,290,5830,3435,1415,2095,250,-930,1860,-3115,-930,795,3535
1759,05000US32027,"Pershing County, Nevada",147,53,134,34,240,123,193,255,193,700,159,235,180,35,860,355,135,105,-12,-46,239,-544,-100,58,595
1760,05000US32029,"Storey County, Nevada",10,25,60,44,145,44,102,249,179,838,80,50,95,55,339,309,205,525,-70,-35,134,-193,-60,-26,313
1761,05000US32031,"Washoe County, Nevada",12889,12385,15140,8215,24740,5259,7329,11905,11490,65710,3980,12245,37880,19275,14040,17135,13985,56845,8909,-22740,13680,-1452,-5230,-2495,8865
1762,05000US32033,"White Pine County, Nevada",180,123,99,110,278,158,289,293,245,1519,200,350,239,10,1060,800,284,475,-20,-140,378,-613,-507,-39,1044
1763,05000US32510,"Carson City, Nevada",1650,2095,2015,1158,3070,890,1170,1935,1750,7144,630,2175,5645,1525,2470,2755,1960,5099,1020,-3630,2703,-410,-820,-210,2045
1764,05000US33001,"Belknap County, New Hampshire",1400,1110,1430,630,1400,1215,1493,3018,2739,10943,955,1490,2905,605,3585,6089,3179,6279,445,-1475,1425,-877,-3071,-440,4664
1765,05000US33003,"Carroll County, New Hampshire",1020,974,900,544,888,1384,2105,2692,2313,8603,715,1075,2145,405,2904,5070,3174,6229,305,-1245,1027,585,-2378,-861,2374
1766,05000US33005,"Cheshire County, New Hampshire",2345,1683,1950,1220,1888,1386,1923,3447,3459,12140,1635,1925,4405,1120,4980,8980,3395,4514,710,-2455,1988,-1671,-5533,64,7626
1767,05000US33007,"Coos County, New Hampshire",1319,905,879,267,629,905,1341,2332,2098,4006,1165,1990,740,95,5550,2654,832,1104,154,139,801,-3304,-322,1266,2902
1768,05000US33009,"Grafton County, New Hampshire",2625,2240,2189,1015,2999,1503,2013,3823,3655,13703,1950,3005,4425,1665,5454,7115,3844,7930,675,-2236,2349,-1938,-3292,-189,5773
1769,05000US33011,"Hillsborough County, New Hampshire",12215,9630,10759,6029,15370,5324,7759,12905,12559,67260,5215,11845,29265,7669,13529,34650,26635,30145,7000,-18506,13730,-446,-21745,-14076,37115
1770,05000US33013,"Merrimack County, New Hampshire",4150,3365,3850,1784,3490,2125,3522,6488,6277,23644,2740,4375,8275,1240,8535,15819,8484,8269,1410,-4425,4034,-2888,-9331,-2207,15375
1771,05000US33015,"Rockingham County, New Hampshire",5045,5325,6130,3625,7810,4980,6385,11065,11365,59618,3125,6395,13750,4660,11330,20265,22890,38435,1920,-7620,6775,35,-9200,-11525,21183
1772,05000US33017,"Strafford County, New Hampshire",4295,3314,3995,1780,3310,1938,2889,5045,4448,18325,2225,5180,7875,1425,8635,11270,5685,6730,2070,-3880,3665,-3808,-6225,-1237,11595
1773,05000US33019,"Sullivan County, New Hampshire",1164,895,1069,606,1003,839,1388,2298,1994,7149,895,1110,2480,249,4174,4660,1680,2768,269,-1411,1360,-1947,-2362,314,4381
1774,05000US34001,"Atlantic County, New Jersey",9710,6080,6665,2775,7589,4387,6044,10120,8584,40315,5240,3625,14360,9590,12440,21440,12560,23200,4470,-7695,774,-2009,-11320,-3976,17115
1775,05000US34003,"Bergen County, New Jersey",28410,16900,16560,13514,44355,15184,16560,17899,17594,152864,11830,12855,47615,47450,10695,10790,25730,173295,16580,-31055,10419,21049,7109,-8136,-20431
1776,05000US34005,"Burlington County, New Jersey",6995,6065,8090,5160,12539,6890,8950,16504,14689,81194,3175,4255,20565,10854,22030,44220,23575,37485,3820,-12475,6845,-6190,-27716,-8886,43709
1777,05000US34007,"Camden County, New Jersey",20784,11290,11839,5695,12395,10113,10838,18065,15905,73304,10130,12115,31670,8090,38475,51660,17853,18919,10654,-19831,10000,-17524,-33595,-1948,54385
1778,05000US34009,"Cape May County, New Jersey",2265,2055,1820,993,1840,2771,2748,4752,4239,17197,1580,1705,4280,1395,3230,6875,5389,17099,685,-2460,1438,2289,-2123,-1150,98
1779,05000US34011,"Cumberland County, New Jersey",5665,3705,3754,1439,3794,2019,2808,4879,4623,18895,3025,1810,7905,5610,8049,14105,4772,5860,2640,-4151,-377,-3222,-9226,-149,13035
1780,05000US34013,"Essex County, New Jersey",54340,31615,25445,14005,30059,8755,10459,13615,12500,81544,25715,39705,67655,22395,16759,19785,18365,73420,28625,-42210,21669,2455,-6170,-5865,8124
1781,05000US34015,"Gloucester County, New Jersey",5720,3984,4990,1835,4869,4710,6388,10860,9710,53924,2480,3005,11960,3930,17675,37455,15655,13704,3240,-6970,2774,-6577,-26595,-5945,40220
1782,05000US34017,"Hudson County, New Jersey",41399,25159,29050,14669,62960,5010,6605,10450,9395,49600,18130,20815,76925,57370,5735,12935,10870,51015,23269,-47875,20259,5880,-2485,-1475,-1415
1783,05000US34019,"Hunterdon County, New Jersey",1965,1355,1065,805,2449,2193,2492,2639,3047,28935,890,1550,3055,2135,3055,4825,6369,25610,1075,-1990,1119,1630,-2186,-3322,3325
1784,05000US34021,"Mercer County, New Jersey",15080,8014,6705,3810,12735,5900,6594,7270,7545,56375,7240,11855,16715,10550,19535,16699,14055,34790,7840,-10010,5995,-7041,-9429,-6510,21585
1785,05000US34023,"Middlesex County, New Jersey",26430,17655,13860,11640,33720,14260,17365,16714,17989,115309,10105,16565,43425,33215,21820,34205,43114,83679,16325,-29565,12145,9805,-17491,-25125,31630
1786,05000US34025,"Monmouth County, New Jersey",15955,12145,9200,6335,17285,10634,12595,16055,15535,118645,7935,6985,26205,19800,12545,18930,28455,114390,8020,-17005,3820,10684,-2875,-12920,4255
1787,05000US34027,"Morris County, New Jersey",7450,5730,7070,5078,19599,6369,7664,11040,10290,100940,4204,3330,18889,18505,5553,10780,18350,102055,3246,-11819,6172,8480,260,-8060,-1115
1788,05000US34029,"Ocean County, New Jersey",12930,9745,7445,4539,9905,21683,22884,26494,24129,88665,5510,6530,22000,10520,37100,45900,36425,62645,7420,-14555,3924,7467,-19406,-12296,26020
1789,05000US34031,"Passaic County, New Jersey",28830,15010,10395,6220,15080,7280,8565,8964,9215,53254,9660,18405,34375,13110,8280,13170,19340,47195,19170,-23980,8190,7565,-4206,-10125,6059
1790,05000US34033,"Salem County, New Jersey",2580,1425,1179,700,1035,1333,1460,2730,2729,9721,1590,1525,3335,430,5939,6959,2270,2600,990,-2156,1305,-3146,-4229,459,7121
1791,05000US34035,"Somerset County, New Jersey",5665,4470,3595,2830,11235,5270,5810,6854,7154,63700,2560,3590,10525,11105,5325,10615,15445,58275,3105,-6930,2960,5755,-3761,-8291,5425
1792,05000US34037,"Sussex County, New Jersey",2054,2009,1474,1094,2634,2219,3689,5195,5320,28439,1105,1820,4815,1535,6790,14809,10110,13575,949,-3341,2193,-882,-9614,-4790,14864
1793,05000US34039,"Union County, New Jersey",20495,16125,13854,8110,18575,7675,8915,12460,11600,71560,8535,14560,39200,14850,10095,19425,22130,61125,11960,-25346,11835,6495,-6965,-10530,10435
1794,05000US34041,"Warren County, New Jersey",2905,2685,2554,1265,2448,1835,2455,3724,3467,18705,1880,3555,5300,1130,5990,9935,6655,7870,1025,-2746,2583,-1700,-6211,-3188,10835
1795,05000US35001,"Bernalillo County, New Mexico",23035,18000,20120,9145,27640,11009,14779,20508,18918,103749,7760,19170,51950,19065,25655,48755,32690,61670,15275,-31830,17720,133,-28247,-13772,42079
1796,05000US35003,"Catron County, New Mexico",8,25,29,0,48,59,153,274,264,733,15,40,25,25,190,320,289,750,-7,4,23,22,-46,-25,-17
1797,05000US35005,"Chaves County, New Mexico",1465,1263,1485,729,2534,1294,1754,2430,2365,8764,1375,1325,3445,1330,6530,4260,1570,3889,90,-1960,1933,-3482,-1830,795,4875
1798,05000US35006,"Cibola County, New Mexico",755,480,434,268,683,649,783,1158,1178,3220,720,710,870,315,3179,1670,459,1205,35,-436,636,-1747,-512,719,2015
1799,05000US35007,"Colfax County, New Mexico",525,485,328,88,407,341,457,603,530,2014,410,570,685,150,1684,734,364,1229,115,-357,345,-886,-131,166,785
1800,05000US35009,"Curry County, New Mexico",1538,1008,1465,915,2880,647,1239,1684,1098,6230,1080,815,3525,2395,3635,2330,1410,3634,458,-2060,1400,-1749,-646,-312,2596
1801,05000US35011,"De Baca County, New Mexico",16,59,80,4,60,29,82,78,68,227,90,50,80,0,285,28,34,160,-74,0,64,-174,50,34,67
1802,05000US35013,"Doña Ana County, New Mexico",7000,5540,5799,2635,7605,3624,5310,7115,6475,28135,3890,4640,13080,6985,14110,11395,7790,16240,3110,-7281,3255,-5176,-4280,-1315,11895
1803,05000US35015,"Eddy County, New Mexico",1139,820,1410,595,2290,1305,1480,2545,1965,8684,1520,1495,2600,645,6090,5105,1845,2180,-381,-1190,2240,-3305,-2560,120,6504
1804,05000US35017,"Grant County, New Mexico",820,494,645,374,945,644,759,1364,1379,4930,605,665,1460,570,2870,2020,775,3180,215,-815,749,-1467,-656,604,1750
1805,05000US35019,"Guadalupe County, New Mexico",76,173,99,25,43,23,114,258,209,328,190,125,84,15,485,175,64,105,-114,15,53,-348,83,145,223
1806,05000US35021,"Harding County, New Mexico",0,20,20,8,16,22,12,38,30,93,30,18,12,4,94,32,8,24,-30,8,20,-60,6,22,69
1807,05000US35023,"Hidalgo County, New Mexico",112,62,79,40,178,197,163,256,207,580,154,150,144,30,800,325,74,135,-42,-65,188,-440,-69,133,445
1808,05000US35025,"Lea County, New Mexico",1500,840,960,710,3015,1309,1339,2050,2050,8945,1500,1395,3150,985,7180,3970,1890,2179,0,-2190,2740,-4532,-1920,160,6766
1809,05000US35027,"Lincoln County, New Mexico",258,364,335,110,644,526,630,998,869,3638,460,200,710,350,1180,1200,1105,3419,-202,-375,404,-24,-202,-236,219
1810,05000US35028,"Los Alamos County, New Mexico",415,335,80,215,923,279,310,200,269,4330,280,1425,175,100,1380,985,1510,1750,135,-95,1038,-791,-785,-1241,2580
1811,05000US35029,"Luna County, New Mexico",1024,680,653,200,916,812,799,1245,985,2184,980,1005,1110,375,2945,1170,620,1045,44,-457,741,-1334,75,365,1139
1812,05000US35031,"McKinley County, New Mexico",1660,1014,753,331,1888,3311,1861,2374,2138,5480,1650,1350,1920,720,8824,2285,1105,2125,10,-1167,1499,-3652,89,1033,3355
1813,05000US35033,"Mora County, New Mexico",78,78,109,8,94,135,279,134,164,434,129,55,159,24,505,245,135,315,-51,-50,78,-91,-111,29,119
1814,05000US35035,"Otero County, New Mexico",1685,1224,1580,1168,2845,1459,1545,2290,2164,8584,1315,1785,3475,1915,7430,3745,1709,3039,370,-1895,2098,-4426,-1455,455,5545
1815,05000US35037,"Quay County, New Mexico",83,254,470,38,134,217,302,499,464,906,205,510,219,35,1304,384,69,349,-122,251,137,-785,115,395,557
1816,05000US35039,"Rio Arriba County, New Mexico",1068,481,641,174,645,1634,1078,1344,1317,4833,830,835,875,460,2215,1955,1189,4782,238,-234,359,497,-611,128,51
1817,05000US35041,"Roosevelt County, New Mexico",810,399,600,248,700,430,434,785,620,2339,545,505,1000,725,1630,1165,494,1225,265,-400,223,-766,-380,126,1114
1818,05000US35043,"Sandoval County, New Mexico",1984,1409,1704,1100,3254,3451,3127,5113,4798,23954,1045,850,4685,2865,6584,13223,6837,14204,939,-2981,1489,-6,-8110,-2039,9750
1819,05000US35045,"San Juan County, New Mexico",2264,1825,2300,1170,3775,3505,2885,4178,3708,17510,2345,2030,4860,2115,11140,6935,4610,8549,-81,-2560,2830,-4750,-2757,-902,8961
1820,05000US35047,"San Miguel County, New Mexico",1375,530,580,225,570,1070,1195,1470,1394,3409,960,565,1370,375,2490,1724,1000,2880,415,-790,420,-225,-254,394,529
1821,05000US35049,"Santa Fe County, New Mexico",3280,3124,3530,1764,6624,3662,3774,5713,4743,26427,2575,2135,8565,5035,6569,6164,5064,26359,705,-5035,3353,867,-451,-321,68
1822,05000US35051,"Sierra County, New Mexico",420,269,200,125,379,400,620,884,813,1705,405,390,500,90,1890,980,535,990,15,-300,414,-870,-96,278,715
1823,05000US35053,"Socorro County, New Mexico",350,194,218,111,227,404,364,743,678,1834,265,250,455,154,1560,664,495,1115,85,-237,184,-792,79,183,719
1824,05000US35055,"Taos County, New Mexico",757,464,618,469,923,1241,1204,1516,1465,4578,605,600,1100,940,1692,1370,818,5614,152,-482,452,753,146,647,-1036
1825,05000US35057,"Torrance County, New Mexico",342,282,169,139,170,859,638,934,649,1730,375,340,365,35,2335,1155,380,745,-33,-196,274,-838,-221,269,985
1826,05000US35059,"Union County, New Mexico",33,73,123,35,222,56,110,217,207,463,189,140,119,35,480,163,109,200,-156,4,222,-314,54,98,263
1827,05000US35061,"Valencia County, New Mexico",1880,855,1150,433,945,2659,2654,4067,3553,10030,1100,1650,2250,275,8578,6900,2624,4105,780,-1100,1103,-3265,-2833,929,5925
1828,05000US36001,"Albany County, New York",14460,9545,12035,5710,12355,3624,4944,10028,9059,45900,7240,17315,24940,4615,15690,30784,11709,14165,7220,-12905,13450,-7122,-20756,-2650,31735
1829,05000US36003,"Allegany County, New York",1284,1069,1060,492,773,1040,1392,2286,2141,7098,940,2520,1000,200,10590,1807,645,703,344,60,1065,-8158,479,1496,6395
1830,05000US36005,"Bronx County, New York",173495,76365,70930,27800,49118,11280,11605,18105,15400,45005,87205,75405,199060,36030,21140,11430,11150,55975,86290,-128130,40888,1745,6675,4250,-10970
1831,05000US36007,"Broome County, New York",8680,5375,4805,2395,5804,3103,4483,8978,7583,29964,3480,11305,10100,2159,28744,15584,3714,4600,5200,-5295,6040,-21158,-6606,3869,25364
1832,05000US36009,"Cattaraugus County, New York",2478,2238,1950,797,1647,1526,2227,3942,3635,12224,2070,4050,2690,299,15599,4704,1111,1728,408,-740,2145,-11846,-762,2524,10496
1833,05000US36011,"Cayuga County, New York",2239,1780,1989,870,2313,1053,2053,3512,3188,13261,1600,3565,3595,415,10965,6884,1902,2859,639,-1606,2768,-7859,-3372,1286,10402
1834,05000US36013,"Chautauqua County, New York",4900,3410,3290,1570,2699,2742,3948,6187,5618,20064,2905,7995,4375,614,25000,7440,2348,3343,1995,-1085,3655,-18310,-1253,3270,16721
1835,05000US36015,"Chemung County, New York",3265,2510,2079,865,2324,1290,2109,3495,3525,13979,1645,3835,4580,989,13630,6710,1575,2100,1620,-2501,2200,-10231,-3215,1950,11879
1836,05000US36017,"Chenango County, New York",1399,1178,969,515,1044,1124,1542,2482,2436,8494,1095,2000,1835,179,9410,3790,1025,1356,304,-866,1380,-6744,-1308,1411,7138
1837,05000US36019,"Clinton County, New York",2594,1714,2240,959,2635,1409,1935,2960,2730,13111,1565,3050,4675,850,8890,7630,2598,2798,1029,-2435,2744,-5546,-4670,132,10313
1838,05000US36021,"Columbia County, New York",1564,1500,1443,799,1735,1231,1615,2621,2652,10988,1350,1715,3150,825,3109,6080,2979,6850,214,-1707,1709,-263,-3459,-327,4138
1839,05000US36023,"Cortland County, New York",1664,1050,1644,789,1198,498,777,1830,1755,7279,1125,2220,2535,450,6394,3585,854,917,539,-891,1537,-5119,-1755,901,6362
1840,05000US36025,"Delaware County, New York",1498,1300,825,367,1105,982,1511,2119,2208,7760,985,1885,1840,385,5620,4034,1458,3269,513,-1015,1087,-3127,-1915,750,4491
1841,05000US36027,"Dutchess County, New York",8650,6455,6255,3435,8320,4593,6005,9817,9446,46428,4155,6215,16520,6230,10570,23320,17705,24495,4495,-10265,5525,28,-13503,-8259,21933
1842,05000US36029,"Erie County, New York",41380,24585,25545,12550,31095,16569,20599,36255,33944,152240,23280,54100,47310,10470,109065,79190,27195,37450,18100,-21765,33175,-71897,-42935,6749,114790
1843,05000US36031,"Essex County, New York",855,579,684,618,919,657,1018,1988,1629,6765,645,1000,1505,505,4454,3429,1219,2938,210,-821,1032,-2779,-1441,410,3827
1844,05000US36033,"Franklin County, New York",1649,874,975,383,1278,1451,1031,1887,1770,7901,1175,2005,1640,310,7702,3080,1052,2164,474,-665,1351,-5220,-1193,718,5737
1845,05000US36035,"Fulton County, New York",1534,1420,1600,564,1340,1019,1425,2734,2448,9026,1110,2100,2900,345,8705,3795,1544,2434,424,-1300,1559,-6261,-1061,904,6592
1846,05000US36037,"Genesee County, New York",1799,1199,1565,647,1367,932,1470,2739,2448,10327,1185,2430,2740,229,9640,5429,1220,1228,614,-1175,1785,-7238,-2690,1228,9099
1847,05000US36039,"Greene County, New York",1165,953,820,318,899,772,897,2271,2042,7602,700,820,1980,650,2805,4913,1874,3808,465,-1160,567,-1136,-2642,168,3794
1848,05000US36041,"Hamilton County, New York",42,35,30,27,66,91,93,159,113,568,57,49,43,8,263,293,123,321,-15,-13,85,-79,-134,-10,247
1849,05000US36043,"Herkimer County, New York",1820,1350,1379,979,1599,1237,1921,3148,2873,9670,1580,3290,1995,275,11135,4525,1104,1739,240,-616,2303,-7977,-1377,1769,7931
1850,05000US36045,"Jefferson County, New York",3644,2915,4389,2329,5920,1437,1875,3692,3211,14646,3630,2530,7600,5440,8235,8294,2924,5239,14,-3211,2809,-4923,-4602,287,9407
1851,05000US36047,"Kings County, New York",224095,106370,112770,53830,163835,32690,31304,45910,36835,146315,115830,102750,271500,170820,17280,14405,15470,241765,108265,-158730,46845,46714,31505,21365,-95450
1852,05000US36049,"Lewis County, New York",617,399,494,166,583,434,800,1387,1384,4462,405,710,880,260,3695,2382,769,1312,212,-386,489,-2461,-995,615,3150
1853,05000US36051,"Livingston County, New York",2103,1494,1439,499,999,1108,1348,3193,2642,10133,1145,3085,1830,479,9315,5885,1505,1383,958,-391,1019,-6859,-2692,1137,8750
1854,05000US36053,"Madison County, New York",1579,1190,1450,575,1539,1223,1907,3192,3062,11406,1455,2495,2150,214,9810,5590,2210,2903,124,-700,1900,-6680,-2398,852,8503
1855,05000US36055,"Monroe County, New York",31504,20404,22665,11129,23009,10059,13909,27938,25384,120485,11480,27885,56880,12465,78530,73110,18510,23490,20024,-34215,21673,-54562,-45172,6874,96995
1856,05000US36057,"Montgomery County, New York",1814,1369,1073,653,1232,967,1429,1935,1926,7792,1055,2160,2740,175,7674,3649,1194,1296,759,-1667,1710,-5278,-1714,732,6496
1857,05000US36059,"Nassau County, New York",25275,15315,11674,8915,24995,28010,31569,34520,35670,231650,14240,13115,26385,32425,19435,30470,62400,249925,11035,-14711,1485,40144,4050,-26730,-18275
1858,05000US36061,"New York County, New York",143040,64190,73030,39335,256290,14434,9235,14734,13563,134430,96000,83370,110855,285670,10600,2720,2395,171290,47040,-37825,9955,13069,12014,11168,-36860
1859,05000US36063,"Niagara County, New York",7765,5630,5620,1984,4089,4234,5758,10759,9503,35423,5125,12995,6125,855,36135,17684,5113,7639,2640,-505,5218,-26143,-6925,4390,27784
1860,05000US36065,"Oneida County, New York",8410,5619,6125,2798,7255,3487,5353,8877,8298,36543,4840,11290,11610,2460,29240,19985,5238,6879,3570,-5485,7593,-20400,-11108,3060,29664
1861,05000US36067,"Onondaga County, New York",19454,11359,13584,5934,14899,6235,8972,16748,16058,76584,8695,20785,30510,5244,52839,42905,11735,15180,10759,-16926,15589,-37632,-26157,4323,61404
1862,05000US36069,"Ontario County, New York",2399,2639,2724,1344,2785,1499,2319,4792,4447,20352,1520,3735,5145,1490,12225,9790,3899,6783,879,-2421,2639,-8407,-4998,548,13569
1863,05000US36071,"Orange County, New York",11580,7645,7720,3555,9535,6269,7294,11440,10510,52155,4385,8220,20455,6945,16630,28810,19480,24220,7195,-12735,6145,-3067,-17370,-8970,27935
1864,05000US36073,"Orleans County, New York",1264,1060,808,339,587,922,1397,2405,2170,5914,840,2385,735,100,8655,2634,474,600,424,73,826,-6336,-229,1696,5314
1865,05000US36075,"Oswego County, New York",4349,2395,2954,1010,1880,2458,2959,5983,5108,17909,2585,5710,3750,534,22270,7944,2130,1735,1764,-796,2356,-16853,-1961,2978,16174
1866,05000US36077,"Otsego County, New York",1579,1104,1235,716,1423,1282,1562,2514,2384,10340,915,1515,2830,825,6568,5240,1829,4225,664,-1595,1314,-3724,-2726,555,6115
1867,05000US36079,"Putnam County, New York",1285,1290,1075,830,1745,1458,2094,3397,2919,18644,905,840,3225,1245,1944,5810,5585,15015,380,-2150,1330,1608,-2413,-2666,3629
1868,05000US36081,"Queens County, New York",111704,76595,86930,43940,112710,39045,39730,60355,51750,166834,44940,51305,202655,132955,20685,35175,34250,261015,66764,-115725,23695,58090,25180,17500,-94181
1869,05000US36083,"Rensselaer County, New York",6590,4659,4969,2535,4835,2351,3473,6134,5620,24107,4110,9200,8350,1915,13495,16905,5634,5460,2480,-3381,5455,-7671,-10771,-14,18647
1870,05000US36085,"Richmond County, New York",19145,7104,9535,4395,10555,11590,11065,16695,14145,64064,9650,8040,25020,8015,4660,7425,13270,92415,9495,-15485,6935,17995,9270,875,-28351
1871,05000US36087,"Rockland County, New York",11115,5805,5070,2885,6225,4275,5244,7140,6265,46630,4710,4125,12675,9595,4835,6945,11200,46745,6405,-7605,-485,4684,195,-4935,-115
1872,05000US36089,"St. Lawrence County, New York",3535,2104,2274,955,2589,2276,3119,4751,4360,16798,2420,3435,4100,1480,19454,6238,1618,3625,1115,-1826,2064,-14059,-1487,2742,13173
1873,05000US36091,"Saratoga County, New York",4739,3970,5955,2880,8979,3753,4870,8994,8519,42113,3290,7170,12085,3960,12530,23440,11950,19284,1449,-6130,7899,-3907,-14446,-3431,22829
1874,05000US36093,"Schenectady County, New York",5594,3559,3849,1380,2910,2346,3204,5973,5498,20608,3040,7415,5900,945,16165,14210,3500,3359,2554,-2051,3345,-10615,-8237,1998,17249
1875,05000US36095,"Schoharie County, New York",1012,630,757,237,433,1157,1216,2099,1732,3945,740,1655,540,130,5180,2923,717,852,272,217,540,-2807,-824,1015,3093
1876,05000US36097,"Schuyler County, New York",492,348,317,181,424,397,622,882,776,3139,340,600,680,139,2672,1473,648,923,152,-363,466,-1653,-591,128,2216
1877,05000US36099,"Seneca County, New York",790,884,780,343,854,474,899,1682,1543,5706,645,1065,1740,185,6110,2179,604,1134,145,-960,1012,-4737,-497,939,4572
1878,05000US36101,"Steuben County, New York",2660,2315,2735,975,2709,1814,2499,4917,4443,16650,2350,4025,4000,1025,17245,6884,1842,3384,310,-1265,2659,-12932,-1967,2601,13266
1879,05000US36103,"Suffolk County, New York",29690,18645,14763,10164,22980,36795,40694,46325,45095,229345,13970,14355,34555,33380,45105,69725,90130,193725,15720,-19792,-236,32384,-23400,-45035,35620
1880,05000US36105,"Sullivan County, New York",2105,1694,1844,878,2669,1447,1592,2946,2743,10947,1605,1815,4650,1090,6105,5735,3100,4619,500,-2806,2457,-3066,-2789,-357,6328
1881,05000US36107,"Tioga County, New York",985,1179,1100,358,940,977,1373,2409,2105,9367,895,2040,1400,230,8730,4660,1130,1140,90,-300,1068,-6380,-2251,975,8227
1882,05000US36109,"Tompkins County, New York",6110,2640,3125,1690,3790,1162,1969,3029,3037,12989,1935,3265,7705,4445,6654,7365,3435,4579,4175,-4580,1035,-3523,-4336,-398,8410
1883,05000US36111,"Ulster County, New York",6025,4200,4470,2210,4410,3460,4448,6997,6073,28624,2570,3830,11650,3270,9064,16750,9008,14485,3455,-7180,3350,-1156,-9753,-2935,14139
1884,05000US36113,"Warren County, New York",1555,1155,1860,690,2390,1013,1333,2558,2558,12719,900,1085,4585,1075,3600,6265,2810,7329,655,-2725,2005,-1254,-3707,-252,5390
1885,05000US36115,"Washington County, New York",1374,1469,1597,668,1435,1269,1549,2602,2337,10127,1025,1640,3295,590,6293,6389,1993,3102,349,-1698,1513,-3475,-3787,344,7025
1886,05000US36117,"Wayne County, New York",2465,1864,1975,744,1410,1590,2335,5628,4884,14830,1690,4100,2390,300,15670,8400,2244,2224,775,-415,1854,-11745,-2772,2640,12606
1887,05000US36119,"Westchester County, New York",42264,23630,16030,11950,39270,15810,16594,15620,15865,149675,19265,25025,42915,45945,21465,14435,18260,162200,22999,-26885,5275,10939,1185,-2395,-12525
1888,05000US36121,"Wyoming County, New York",754,904,903,362,863,615,1107,1782,1617,7087,860,2070,830,34,6725,3510,782,1044,-106,73,1191,-5003,-1728,835,6043
1889,05000US36123,"Yates County, New York",550,513,440,167,467,456,707,1233,1088,3982,375,935,685,140,3239,1859,540,1670,175,-245,494,-2076,-626,548,2312
1890,05000US37001,"Alamance County, North Carolina",4135,4444,4514,2339,6405,2487,3728,6182,5558,24568,2615,4575,10740,3895,11220,12884,6495,11079,1520,-6226,4849,-5005,-6702,-937,13489
1891,05000US37003,"Alexander County, North Carolina",574,763,708,550,780,584,1100,1579,1309,6150,585,1370,1225,184,3435,2595,1910,2630,-11,-517,1146,-1751,-1016,-601,3520
1892,05000US37005,"Alleghany County, North Carolina",245,403,227,92,217,314,342,615,670,1795,375,330,445,38,1165,795,475,1210,-130,-218,271,-509,-180,195,585
1893,05000US37007,"Anson County, North Carolina",855,575,685,255,1020,525,728,1250,1275,3145,865,945,1315,250,3664,1340,555,870,-10,-630,1025,-2411,-90,720,2275
1894,05000US37009,"Ashe County, North Carolina",869,436,653,253,892,780,914,1410,1260,4800,1150,785,905,270,2574,1955,1320,3310,-281,-252,875,-880,-545,-60,1490
1895,05000US37011,"Avery County, North Carolina",231,363,340,183,432,409,693,1057,1027,2415,324,325,665,239,1865,1008,677,1897,-93,-325,376,-763,49,350,518
1896,05000US37013,"Beaufort County, North Carolina",1324,1575,1008,429,1173,803,1344,2120,1820,8114,1225,1450,2235,625,5700,2430,1600,4344,99,-1227,977,-3553,-310,220,3770
1897,05000US37015,"Bertie County, North Carolina",599,392,614,141,355,785,798,1149,920,2525,635,750,605,110,3750,1185,463,614,-36,9,386,-2167,-36,457,1911
1898,05000US37017,"Bladen County, North Carolina",1604,709,820,499,853,1218,1054,1768,1784,4764,1175,1440,1635,234,5345,2043,1015,1619,429,-815,1118,-3073,-275,769,3145
1899,05000US37019,"Brunswick County, North Carolina",2828,1974,2855,1480,2995,3247,3446,6037,5609,23903,1835,3010,5280,1990,9340,9385,5605,18015,993,-2425,2485,-2647,-3348,4,5888
1900,05000US37021,"Buncombe County, North Carolina",6285,6930,8830,4860,11380,4154,6279,9780,9190,40069,5440,5975,14915,11950,11450,13325,11070,32360,845,-6085,4290,-1017,-3545,-1880,7709
1901,05000US37023,"Burke County, North Carolina",2265,2194,2269,774,2330,1710,2374,4024,3673,14144,2020,3020,4165,635,9674,6490,3705,5599,245,-1896,2469,-5590,-2466,-32,8545
1902,05000US37025,"Cabarrus County, North Carolina",4120,3940,5050,2474,4984,3285,4493,7079,6844,29459,2900,7105,8690,1895,14790,18175,6780,11075,1220,-3640,5563,-7012,-11096,64,18384
1903,05000US37027,"Caldwell County, North Carolina",1810,1849,2184,995,2290,1750,2140,3829,3529,12668,1400,3320,3855,545,8905,7135,3230,4058,410,-1671,2740,-5015,-3306,299,8610
1904,05000US37029,"Camden County, North Carolina",170,44,225,25,290,129,430,369,314,1855,175,100,280,200,810,485,790,960,-5,-55,115,-251,-116,-476,895
1905,05000US37031,"Carteret County, North Carolina",1680,1474,1489,820,2714,1536,2378,3414,2971,12439,1570,1660,3605,1360,4659,5460,3015,9505,110,-2116,2174,-745,-2046,-44,2934
1906,05000US37033,"Caswell County, North Carolina",840,445,354,109,395,308,925,1165,1230,3665,605,840,600,115,3400,1655,895,1395,235,-246,389,-2167,-490,335,2270
1907,05000US37035,"Catawba County, North Carolina",3210,3210,4200,2539,5345,1969,3319,4848,5083,27354,2380,3860,10295,1960,11499,11754,6040,13150,830,-6095,5924,-6211,-6906,-957,14204
1908,05000US37037,"Chatham County, North Carolina",2095,1455,1180,640,1325,2014,2239,2984,2995,11799,2265,2540,1395,505,5645,3920,2610,9605,-170,-215,1460,-1392,-936,385,2194
1909,05000US37039,"Cherokee County, North Carolina",453,388,442,313,637,865,975,1754,1620,4389,610,440,895,289,2490,2259,1550,3024,-157,-453,661,-650,-505,70,1365
1910,05000US37041,"Chowan County, North Carolina",449,384,135,200,420,244,379,874,723,2425,215,355,705,315,1535,1115,580,1240,234,-570,305,-912,-241,143,1185
1911,05000US37043,"Clay County, North Carolina",224,343,61,179,329,248,457,800,659,1990,320,230,460,115,880,994,680,1395,-96,-399,393,-175,-194,-21,595
1912,05000US37045,"Cleveland County, North Carolina",3210,2015,2585,1679,2848,2135,2580,3803,3713,14017,1835,3260,6160,1075,10520,7735,2988,4965,1375,-3575,3452,-5805,-3932,725,9052
1913,05000US37047,"Columbus County, North Carolina",2090,1305,1200,514,1445,1504,1994,2529,2379,8230,1625,2440,2080,400,8755,3350,1620,2499,465,-880,1559,-5257,-821,759,5731
1914,05000US37049,"Craven County, North Carolina",2585,2320,3075,2120,4810,1444,2014,3178,3183,16270,2110,2095,6725,3960,6547,7765,4160,8149,475,-3650,2970,-3089,-4587,-977,8121
1915,05000US37051,"Cumberland County, North Carolina",9450,8370,13355,7070,22710,4232,4149,7287,7266,41689,5085,6100,28700,21075,19820,19830,10235,16210,4365,-15345,8705,-11439,-12543,-2969,25479
1916,05000US37053,"Currituck County, North Carolina",338,534,345,205,285,530,685,1194,1069,4649,285,605,580,235,1690,1780,1685,3088,53,-235,255,-475,-586,-616,1561
1917,05000US37055,"Dare County, North Carolina",575,629,1185,699,1584,495,979,1493,1314,6488,545,525,2340,1260,942,1355,1385,7419,30,-1155,1023,532,138,-71,-931
1918,05000US37057,"Davidson County, North Carolina",4420,3065,4325,2270,4334,2420,4350,7519,6914,26915,2430,6940,7645,1375,14555,15545,5960,11595,1990,-3320,5229,-7785,-8026,954,15320
1919,05000US37059,"Davie County, North Carolina",675,835,610,594,839,734,1035,1640,1445,7905,970,1005,1405,195,3815,2465,2035,4460,-295,-795,1238,-2046,-825,-590,3445
1920,05000US37061,"Duplin County, North Carolina",1738,1332,1448,664,1375,1298,1972,2885,2310,7299,1755,1975,2360,475,8349,3205,1719,2080,-17,-912,1564,-5079,-320,591,5219
1921,05000US37063,"Durham County, North Carolina",14485,9395,13260,5750,13375,4032,4270,8898,7219,41625,5700,13780,30035,6745,15345,24499,10845,14925,8785,-16775,12380,-7043,-15601,-3626,26700
1922,05000US37065,"Edgecombe County, North Carolina",2275,1759,2170,683,1850,1065,1473,2420,2018,6480,1840,2305,3820,785,7565,3174,915,1265,435,-1650,1748,-5027,-754,1103,5215
1923,05000US37067,"Forsyth County, North Carolina",12960,10364,11059,5414,14695,5019,6785,11920,10277,58774,5875,11970,28720,7910,22620,32795,13950,23390,7085,-17661,12199,-10816,-20875,-3673,35384
1924,05000US37069,"Franklin County, North Carolina",2135,1683,1250,670,804,2480,2610,3470,2884,6945,2215,3040,1175,120,9750,4950,1655,1710,-80,75,1354,-4660,-1480,1229,5235
1925,05000US37071,"Gaston County, North Carolina",8140,6325,6425,2773,4255,5585,6374,9933,8333,25232,4860,13470,8980,640,26945,16844,3729,6033,3280,-2555,6388,-14986,-6911,4604,19199
1926,05000US37073,"Gates County, North Carolina",240,148,139,164,198,173,369,509,419,2270,265,169,405,35,1329,945,569,805,-25,-266,327,-787,-436,-150,1465
1927,05000US37075,"Graham County, North Carolina",120,50,172,25,218,342,345,523,540,1214,175,200,205,20,1075,530,324,855,-55,-33,223,-388,-7,216,359
1928,05000US37077,"Granville County, North Carolina",1395,1065,1315,509,1289,810,1060,2435,2070,9604,1050,1395,2785,340,5045,4640,2320,3484,345,-1470,1458,-3175,-2205,-250,6120
1929,05000US37079,"Greene County, North Carolina",628,588,370,252,409,378,597,838,632,2819,515,650,980,104,2970,1244,444,519,113,-610,557,-1995,-406,188,2300
1930,05000US37081,"Guilford County, North Carolina",16460,13710,18590,8820,25025,5563,8272,14761,13272,79379,7405,12920,49160,13100,28980,35850,18555,37025,9055,-30570,20745,-15145,-21089,-5283,42354
1931,05000US37083,"Halifax County, North Carolina",2600,1534,1509,810,1359,1138,1864,2115,1945,6925,1840,1810,3275,890,7593,2599,1340,2039,760,-1766,1279,-4591,-484,605,4886
1932,05000US37085,"Harnett County, North Carolina",3370,2604,2954,1569,5099,1947,2188,4114,3643,18038,2320,3140,6670,3455,9063,8570,4363,7764,1050,-3716,3213,-4928,-4456,-720,10274
1933,05000US37087,"Haywood County, North Carolina",1930,1443,1379,552,2129,1154,1969,2903,2439,11101,1595,1485,3360,1005,4184,4145,2548,8395,335,-1981,1676,-1061,-1242,-109,2706
1934,05000US37089,"Henderson County, North Carolina",2380,2715,2814,1745,3589,2695,2602,5362,4984,20138,2160,2950,5485,2645,7155,7690,5644,14815,220,-2671,2689,-1858,-2328,-660,5323
1935,05000US37091,"Hertford County, North Carolina",873,574,527,295,677,645,711,981,886,3052,535,620,1490,259,3494,1343,452,789,338,-963,713,-2138,-362,434,2263
1936,05000US37093,"Hoke County, North Carolina",1345,835,1185,539,1845,970,934,1592,1507,6960,685,1095,2275,1670,3700,3064,2885,2530,660,-1090,714,-1796,-1472,-1378,4430
1937,05000US37095,"Hyde County, North Carolina",110,94,25,25,185,90,118,205,310,770,35,65,250,80,790,190,215,200,75,-225,130,-582,15,95,570
1938,05000US37097,"Iredell County, North Carolina",3955,2760,4065,1805,5170,2980,4287,7264,5709,26729,3105,5320,6940,2400,14154,12413,5560,14865,850,-2875,4575,-6887,-5149,149,11864
1939,05000US37099,"Jackson County, North Carolina",1345,1024,1008,677,1609,833,955,1270,1315,6479,970,1350,2535,800,2015,2074,1480,5129,375,-1527,1486,-227,-804,-165,1350
1940,05000US37101,"Johnston County, North Carolina",6005,4145,4275,1430,2669,4149,5468,9295,7815,21914,4435,9070,4245,780,23100,16945,3840,3670,1570,30,3319,-13483,-7650,3975,18244
1941,05000US37103,"Jones County, North Carolina",390,204,179,48,309,349,328,510,395,1519,395,355,324,65,1525,660,295,545,-5,-145,292,-848,-150,100,974
1942,05000US37105,"Lee County, North Carolina",1699,1525,1165,684,2020,903,1114,2323,1993,8989,1140,1945,3475,525,4979,4494,2320,3250,559,-2310,2179,-2962,-2171,-327,5739
1943,05000US37107,"Lenoir County, North Carolina",2169,1870,1915,820,2490,975,1385,2429,2125,7748,1795,1955,4380,1145,7445,3595,1529,1780,374,-2465,2165,-5085,-1166,596,5968
1944,05000US37109,"Lincoln County, North Carolina",1374,1570,1805,765,1835,1575,2235,3560,3155,14075,1105,2660,2840,755,7515,5775,3219,7640,269,-1035,1845,-3705,-2215,-64,6435
1945,05000US37111,"McDowell County, North Carolina",1144,844,1089,690,1390,885,1515,2504,2315,6425,1180,1735,1995,255,5265,3340,1629,2710,-36,-906,1825,-2865,-836,686,3715
1946,05000US37113,"Macon County, North Carolina",725,880,860,430,1190,830,1075,1959,1785,6416,820,795,1825,630,2015,2924,1925,4949,-95,-965,990,-110,-965,-140,1467
1947,05000US37115,"Madison County, North Carolina",532,582,474,139,412,699,660,1131,1028,2910,715,740,545,115,1814,1309,754,2534,-183,-71,436,-455,-178,274,376
1948,05000US37117,"Martin County, North Carolina",643,589,815,147,789,542,855,1170,965,3229,715,855,1235,190,3974,1319,605,835,-72,-420,746,-2577,-149,360,2394
1949,05000US37119,"Mecklenburg County, North Carolina",32885,27775,36200,18455,55985,13304,15964,29779,24994,144419,10550,34925,95370,30445,55145,69490,26740,75989,22335,-59170,43995,-25877,-39711,-1746,68430
1950,05000US37121,"Mitchell County, North Carolina",332,274,202,147,354,454,575,637,645,2824,479,355,390,84,1475,1240,863,1710,-147,-188,417,-446,-603,-218,1114
1951,05000US37123,"Montgomery County, North Carolina",834,777,742,324,574,490,840,1299,1103,4314,995,1150,1045,64,3483,1649,754,2050,-161,-303,834,-2153,-350,349,2264
1952,05000US37125,"Moore County, North Carolina",2000,1760,1999,845,3179,2355,2754,4509,3809,15834,1805,2695,2920,2355,7555,6315,3825,11770,195,-921,1669,-2446,-1806,-16,4064
1953,05000US37127,"Nash County, North Carolina",2590,2354,2995,1220,3610,1350,1879,2848,2849,15958,2390,2530,5740,2155,8794,6675,3314,5829,200,-2745,2675,-5565,-3827,-465,10129
1954,05000US37129,"New Hanover County, North Carolina",9810,7580,7240,4193,10255,3664,3819,7264,6264,32635,5145,6435,21085,6395,6485,16084,8280,22805,4665,-13845,8053,998,-8820,-2016,9830
1955,05000US37131,"Northampton County, North Carolina",849,599,497,204,573,694,754,1184,959,2919,745,740,1014,210,3545,1180,520,898,104,-517,567,-2097,4,439,2021
1956,05000US37133,"Onslow County, North Carolina",3735,3379,6314,4665,11860,1788,1914,4405,4571,21308,2095,2695,12740,12435,5804,10840,7814,9858,1640,-6426,4090,-2102,-6435,-3243,11450
1957,05000US37135,"Orange County, North Carolina",4810,2885,4730,2330,5149,2049,2199,4265,3700,21307,1865,4695,10080,3270,4944,7275,4570,16155,2945,-5350,4209,-696,-3010,-870,5152
1958,05000US37137,"Pamlico County, North Carolina",257,270,239,171,404,268,405,693,559,2309,325,404,545,85,1558,684,340,1564,-68,-306,490,-885,9,219,745
1959,05000US37139,"Pasquotank County, North Carolina",1294,1155,1005,683,1655,565,610,1059,990,5879,875,885,2560,1465,2464,2500,1640,2624,419,-1555,873,-1289,-1441,-650,3255
1960,05000US37141,"Pender County, North Carolina",1249,649,823,384,1294,1665,1354,2678,2368,9545,945,1000,1785,675,5784,3044,1959,6313,304,-962,1003,-2765,-366,409,3232
1961,05000US37143,"Perquimans County, North Carolina",414,449,295,173,272,176,505,529,447,2630,190,430,615,369,1125,790,590,1909,224,-320,76,-444,-261,-143,721
1962,05000US37145,"Person County, North Carolina",1185,1172,885,393,774,573,857,1558,1544,7304,820,1225,2185,178,4085,3170,1665,2735,365,-1300,989,-2655,-1612,-121,4569
1963,05000US37147,"Pitt County, North Carolina",8850,6160,5990,3310,8530,2050,2320,4230,3710,24464,3175,6385,16385,6915,11630,10565,5210,9685,5675,-10395,4925,-7260,-6335,-1500,14779
1964,05000US37149,"Polk County, North Carolina",311,463,535,242,854,326,435,1143,978,3836,495,515,665,720,1364,964,884,3579,-184,-130,376,-603,179,94,257
1965,05000US37151,"Randolph County, North Carolina",3299,3435,3810,1770,3530,2640,4279,7114,6259,21372,2540,6450,6200,655,16245,13325,4599,6240,759,-2390,4645,-9326,-6211,1660,15132
1966,05000US37153,"Richmond County, North Carolina",2095,1330,1249,574,1105,1124,1418,2204,1769,6059,1300,2120,2710,220,7640,2435,879,1380,795,-1461,1459,-5098,-231,890,4679
1967,05000US37155,"Robeson County, North Carolina",5510,3125,3124,1404,3134,3364,4054,5305,4583,13960,4475,5120,5885,825,19758,5353,2124,3003,1035,-2761,3713,-12340,-48,2459,10957
1968,05000US37157,"Rockingham County, North Carolina",2790,2529,2275,1044,3095,1600,2240,3914,3288,15060,2160,3570,5410,595,10455,7655,3040,4975,630,-3135,3544,-6615,-3741,248,10085
1969,05000US37159,"Rowan County, North Carolina",3525,2944,3149,1500,5405,2595,3050,5429,4163,20975,3090,3335,8765,1335,11429,11160,4385,9070,435,-5616,5570,-5784,-5731,-222,11905
1970,05000US37161,"Rutherford County, North Carolina",1704,1385,1760,965,1718,1445,2365,3053,3070,10207,1320,2925,2745,550,8080,4824,2275,4299,384,-985,2133,-4270,-1771,795,5908
1971,05000US37163,"Sampson County, North Carolina",1809,1850,1734,544,1183,1173,1723,2679,2679,8755,1570,2350,3020,189,9034,3029,1930,2494,239,-1286,1538,-6138,-350,749,6261
1972,05000US37165,"Scotland County, North Carolina",2089,880,785,268,1019,729,942,1599,1449,4265,1195,1390,1985,470,4840,2045,834,659,894,-1200,817,-3169,-446,615,3606
1973,05000US37167,"Stanly County, North Carolina",1590,1295,1480,760,1450,879,1549,2748,2139,10609,1195,1870,3160,350,5345,5604,2370,4304,395,-1680,1860,-2917,-2856,-231,6305
1974,05000US37169,"Stokes County, North Carolina",1205,1010,809,574,729,1098,1629,2410,2350,7934,1220,1665,1260,175,5913,4799,1985,2435,-15,-451,1128,-3186,-2389,365,5499
1975,05000US37171,"Surry County, North Carolina",1879,1555,1815,775,1875,1664,2189,3864,3470,11273,1750,2540,2890,710,7800,5825,3115,5175,129,-1075,1940,-3947,-1961,355,6098
1976,05000US37173,"Swain County, North Carolina",382,152,425,194,383,353,555,785,680,1852,340,555,555,84,1325,930,545,1139,42,-130,493,-417,-145,135,713
1977,05000US37175,"Transylvania County, North Carolina",685,700,850,374,779,790,655,1419,1364,6665,755,805,1375,465,1719,1389,1735,6099,-70,-525,688,-274,30,-371,566
1978,05000US37177,"Tyrrell County, North Carolina",92,102,84,25,73,194,133,249,224,470,165,69,110,30,555,259,260,120,-73,-26,68,-228,-10,-36,350
1979,05000US37179,"Union County, North Carolina",2929,2469,3644,1775,3550,3880,4183,9419,7544,36134,2480,4625,5600,1670,11615,20445,7145,20680,449,-1956,3655,-3552,-11026,399,15454
1980,05000US37181,"Vance County, North Carolina",1799,1520,1375,760,1580,711,1208,1660,1160,5410,1410,1920,3365,355,5089,2350,1165,1600,389,-1990,1985,-3170,-690,-5,3810
1981,05000US37183,"Wake County, North Carolina",26400,22630,31325,15910,40905,11549,14964,32089,28084,163359,10000,33805,80290,13090,43815,76365,40885,87035,16400,-48965,43725,-17302,-44276,-12801,76324
1982,05000US37185,"Warren County, North Carolina",723,441,403,212,507,530,789,970,899,2940,695,845,544,200,3065,1010,530,1440,28,-141,519,-1746,-40,369,1500
1983,05000US37187,"Washington County, North Carolina",795,369,327,194,353,285,239,500,548,1778,730,390,900,45,1920,684,220,465,65,-573,502,-1396,-184,328,1313
1984,05000US37189,"Watauga County, North Carolina",3745,1124,1330,677,1495,908,884,1743,1594,7200,1005,2075,3470,1810,2075,1636,1899,6815,2740,-2140,362,-283,107,-305,385
1985,05000US37191,"Wayne County, North Carolina",3830,3370,4535,1555,5339,1399,2349,4445,3925,18055,3450,3365,8825,2980,11984,6920,4865,5729,380,-4290,3914,-8236,-2475,-940,12326
1986,05000US37193,"Wilkes County, North Carolina",1820,1705,1523,570,1455,1500,3074,3305,3040,10940,1785,1990,2805,500,7525,5275,2635,5605,35,-1282,1525,-2951,-1970,405,5335
1987,05000US37195,"Wilson County, North Carolina",2825,2359,2635,1250,3614,744,1554,2764,2625,12049,1555,2170,6885,2070,7120,5650,2782,4215,1270,-4250,2794,-4822,-2886,-157,7834
1988,05000US37197,"Yadkin County, North Carolina",1010,865,894,414,553,858,1480,2095,1725,5935,880,1775,990,95,4695,3450,1390,2385,130,-96,872,-2357,-1355,335,3550
1989,05000US37199,"Yancey County, North Carolina",530,444,419,312,277,450,489,1061,911,3015,610,505,755,130,1750,1279,795,1963,-80,-336,459,-811,-218,116,1052
1990,05000US38001,"Adams County, North Dakota",77,20,95,27,70,66,111,119,110,398,185,50,34,14,409,138,154,100,-108,61,83,-232,-19,-44,298
1991,05000US38003,"Barnes County, North Dakota",384,258,440,208,389,287,342,593,538,1816,525,999,170,0,2035,764,349,279,-141,270,597,-1406,-171,189,1537
1992,05000US38005,"Benson County, North Dakota",387,168,158,66,94,207,170,268,254,658,660,160,32,4,1153,184,48,79,-273,126,156,-776,84,206,579
1993,05000US38007,"Billings County, North Dakota",4,16,18,12,49,43,32,40,40,184,33,40,20,10,110,99,18,70,-29,-2,51,-35,-59,22,114
1994,05000US38009,"Bottineau County, North Dakota",183,139,95,97,229,232,258,387,288,1240,214,350,174,14,1205,584,220,460,-31,-79,312,-715,-197,68,780
1995,05000US38011,"Bowman County, North Dakota",86,67,46,44,136,108,88,161,167,574,179,133,69,4,584,322,70,109,-93,-23,176,-388,-161,97,465
1996,05000US38013,"Burke County, North Dakota",72,27,42,34,86,72,78,91,101,429,109,83,34,25,460,154,44,68,-37,8,95,-310,-63,57,361
1997,05000US38015,"Burleigh County, North Dakota",2980,2359,3050,1534,2199,1509,1948,4064,3954,16272,2095,6310,3220,495,6215,9195,4965,6654,885,-170,3238,-2758,-5131,-1011,9618
1998,05000US38017,"Cass County, North Dakota",7879,6710,8588,4425,7294,1340,2399,5289,5204,24890,3570,18990,11275,1054,9220,15595,6478,7269,4309,-2687,10665,-5481,-10306,-1274,17621
1999,05000US38019,"Cavalier County, North Dakota",67,62,89,39,67,107,183,191,158,831,205,59,49,0,1168,194,45,79,-138,40,106,-878,-3,113,752
2000,05000US38021,"Dickey County, North Dakota",150,138,158,68,144,65,172,244,243,830,270,345,34,15,1000,419,80,75,-120,124,197,-763,-175,163,755
2001,05000US38023,"Divide County, North Dakota",27,43,49,20,88,170,68,148,122,393,94,55,80,4,434,190,60,129,-67,-31,104,-196,-42,62,264
2002,05000US38025,"Dunn County, North Dakota",67,53,78,45,124,146,67,217,166,707,123,114,90,29,594,313,100,273,-56,-12,140,-381,-96,66,434
2003,05000US38027,"Eddy County, North Dakota",122,49,47,14,77,66,73,122,88,415,195,95,8,4,609,87,25,29,-73,39,87,-470,35,63,386
2004,05000US38029,"Emmons County, North Dakota",74,52,20,88,14,219,198,288,283,472,200,28,20,0,904,219,80,139,-126,0,102,-487,69,203,333
2005,05000US38031,"Foster County, North Dakota",82,89,108,30,81,45,109,218,184,617,209,150,24,4,660,259,90,110,-127,84,107,-506,-41,94,507
2006,05000US38033,"Golden Valley County, North Dakota",68,66,68,30,47,43,103,119,112,242,175,89,14,4,309,169,59,45,-107,54,73,-163,-50,53,197
2007,05000US38035,"Grand Forks County, North Dakota",4505,2923,3378,1575,2759,819,893,1882,1838,9434,2040,6190,6060,830,4250,5889,1949,2624,2465,-2682,3504,-2538,-4007,-111,6810
2008,05000US38037,"Grant County, North Dakota",65,36,33,16,38,129,132,180,157,405,99,44,10,14,698,125,8,113,-34,23,40,-437,55,149,292
2009,05000US38039,"Griggs County, North Dakota",77,53,98,27,55,53,102,128,120,403,245,30,10,10,528,95,75,45,-168,88,72,-373,33,45,358
2010,05000US38041,"Hettinger County, North Dakota",67,32,40,14,53,65,102,187,185,422,119,30,39,4,634,178,45,49,-52,1,63,-467,9,140,373
2011,05000US38043,"Kidder County, North Dakota",52,35,63,32,69,60,116,134,126,377,165,70,20,0,534,144,59,60,-113,43,101,-358,-10,67,317
2012,05000US38045,"LaMoure County, North Dakota",131,81,93,34,92,131,126,231,198,740,259,124,12,20,998,209,110,138,-128,81,106,-741,22,88,602
2013,05000US38047,"Logan County, North Dakota",26,22,48,25,12,94,82,110,130,352,58,53,4,10,604,84,29,34,-32,44,27,-428,26,101,318
2014,05000US38049,"McHenry County, North Dakota",76,142,107,18,92,250,232,348,306,1189,255,139,34,4,1409,578,138,150,-179,73,106,-927,-230,168,1039
2015,05000US38051,"McIntosh County, North Dakota",67,58,101,19,37,147,151,211,186,411,180,74,29,12,812,143,40,60,-113,72,44,-514,68,146,351
2016,05000US38053,"McKenzie County, North Dakota",144,112,185,262,802,179,145,232,236,1339,425,320,340,439,660,705,324,480,-281,-155,625,-336,-473,-88,859
2017,05000US38055,"McLean County, North Dakota",181,146,146,86,257,308,333,570,515,1946,440,254,103,14,1610,1065,449,421,-259,43,329,-969,-495,66,1525
2018,05000US38057,"Mercer County, North Dakota",215,98,103,57,196,261,224,434,435,1744,279,269,95,10,1485,925,315,274,-64,8,243,-1000,-491,120,1470
2019,05000US38059,"Morton County, North Dakota",952,625,778,455,827,608,1105,1585,1349,5233,815,1635,1165,28,3567,3529,1205,1405,137,-387,1254,-1854,-1944,144,3828
2020,05000US38061,"Mountrail County, North Dakota",227,106,186,174,276,181,221,337,297,1342,445,335,154,43,989,640,263,389,-218,32,407,-587,-303,34,953
2021,05000US38063,"Nelson County, North Dakota",83,55,153,58,31,133,113,211,217,534,174,150,34,4,930,118,65,39,-91,119,85,-684,93,152,495
2022,05000US38065,"Oliver County, North Dakota",22,10,4,27,40,77,50,118,77,391,54,34,8,0,284,200,90,118,-32,-4,67,-157,-82,-13,273
2023,05000US38067,"Pembina County, North Dakota",125,177,153,69,223,175,289,428,389,1333,400,245,75,10,1958,397,84,119,-275,78,282,-1494,31,305,1214
2024,05000US38069,"Pierce County, North Dakota",190,124,149,44,57,266,138,243,296,558,245,259,54,0,905,340,89,100,-55,95,101,-501,-97,207,458
2025,05000US38071,"Ramsey County, North Dakota",535,369,400,164,474,253,253,428,533,1712,764,850,220,120,1694,619,345,408,-229,180,518,-1188,-191,188,1304
2026,05000US38073,"Ransom County, North Dakota",142,151,140,49,218,66,182,258,288,913,350,260,78,15,1008,368,130,144,-208,62,252,-760,-110,158,769
2027,05000US38075,"Renville County, North Dakota",57,38,42,24,50,61,58,165,115,480,114,74,20,4,539,159,85,69,-57,22,70,-420,6,30,411
2028,05000US38077,"Richland County, North Dakota",634,383,434,188,343,335,371,783,712,2813,845,890,224,15,3182,994,290,419,-211,210,516,-2476,-211,422,2394
2029,05000US38079,"Rolette County, North Dakota",742,299,187,59,173,784,430,579,518,1162,1160,235,55,20,2589,445,189,62,-418,132,212,-1375,134,329,1100
2030,05000US38081,"Sargent County, North Dakota",60,63,124,103,119,101,120,216,238,754,150,275,32,4,934,284,80,65,-90,92,218,-713,-68,158,689
2031,05000US38083,"Sheridan County, North Dakota",58,30,39,14,16,69,65,100,105,233,135,8,4,10,373,74,45,50,-77,35,20,-239,26,60,183
2032,05000US38085,"Sioux County, North Dakota",211,133,121,51,112,136,62,56,60,216,440,170,14,4,339,87,29,38,-229,107,159,-141,-31,31,178
2033,05000US38087,"Slope County, North Dakota",8,8,18,0,34,36,23,50,46,127,24,35,0,0,144,24,34,40,-16,18,34,-85,26,12,87
2034,05000US38089,"Stark County, North Dakota",849,645,783,269,1459,576,612,909,1039,4892,710,1300,1330,680,2040,3060,1144,1904,139,-547,1048,-852,-2151,-105,2988
2035,05000US38091,"Steele County, North Dakota",12,16,32,37,40,32,66,127,151,437,85,50,0,0,600,124,19,44,-73,32,77,-502,3,132,393
2036,05000US38093,"Stutsman County, North Dakota",795,463,874,298,789,392,434,1031,1212,3179,1030,1485,650,60,3330,1608,490,595,-235,224,1027,-2504,-577,722,2584
2037,05000US38095,"Towner County, North Dakota",45,67,33,33,49,117,74,145,162,384,135,69,8,4,659,105,20,29,-90,25,78,-468,40,142,355
2038,05000US38097,"Traill County, North Dakota",271,153,228,61,160,171,225,405,371,1325,375,395,89,24,1477,724,124,175,-104,139,197,-1081,-319,247,1150
2039,05000US38099,"Walsh County, North Dakota",328,292,303,119,188,294,477,732,666,1690,635,425,165,4,2684,659,155,150,-307,138,303,-1913,73,511,1540
2040,05000US38101,"Ward County, North Dakota",1770,1670,2765,1434,3449,639,1329,2504,2499,9953,1600,2800,4820,1845,4220,5729,3360,3680,170,-2055,3038,-2252,-3225,-861,6273
2041,05000US38103,"Wells County, North Dakota",148,80,89,19,57,123,198,299,289,782,274,115,4,0,1180,315,93,65,-126,85,76,-859,-16,196,717
2042,05000US38105,"Williams County, North Dakota",722,665,662,413,2460,407,509,728,704,5613,745,1825,1260,1090,1989,2554,1475,2204,-23,-598,1783,-1073,-1826,-771,3409
2043,05000US39001,"Adams County, Ohio",1500,847,567,113,402,764,909,1463,1238,3440,1245,1490,625,70,4319,1699,630,985,255,-58,445,-2646,-236,608,2455
2044,05000US39003,"Allen County, Ohio",3454,2640,3170,1305,3110,1498,1865,3728,3368,16903,1930,5135,5820,790,13015,8105,2799,3154,1524,-2650,3625,-9652,-4377,569,13749
2045,05000US39005,"Ashland County, Ohio",1030,850,1445,763,1518,885,1338,2419,2280,8704,825,2435,2135,218,6370,5045,1789,1874,205,-690,2063,-4147,-2626,491,6830
2046,05000US39007,"Ashtabula County, Ohio",3714,2370,2409,963,1945,2129,2680,5184,4554,13873,2360,4925,3795,309,14414,7605,2825,2715,1354,-1386,2599,-9605,-2421,1729,11158
2047,05000US39009,"Athens County, Ohio",3905,1694,1543,750,1835,1250,1369,2048,1709,6863,1540,2805,4020,1359,6229,3259,1474,2115,2365,-2477,1226,-3610,-1211,235,4748
2048,05000US39011,"Auglaize County, Ohio",845,932,1049,531,1093,699,1309,2124,2258,8192,745,2600,795,310,6090,4468,1574,1940,100,254,1314,-4082,-2344,684,6252
2049,05000US39013,"Belmont County, Ohio",1723,1414,1274,533,1555,1281,1831,3400,2884,11975,2115,1715,2285,380,10830,5088,1530,3170,-392,-1011,1708,-7718,-1688,1354,8805
2050,05000US39015,"Brown County, Ohio",1464,688,848,483,974,995,1053,2039,1969,7215,1210,1810,1250,185,5873,4000,1314,2000,254,-402,1272,-3825,-1961,655,5215
2051,05000US39017,"Butler County, Ohio",12375,7115,9775,4195,9645,5435,7363,14795,12839,55688,5720,19085,15630,2660,36935,36020,10434,11369,6655,-5855,11180,-24137,-21225,2405,44319
2052,05000US39019,"Carroll County, Ohio",533,380,490,248,529,665,717,1414,1305,4854,600,875,620,83,4224,2434,980,1345,-67,-130,694,-2842,-1020,325,3509
2053,05000US39021,"Champaign County, Ohio",828,963,655,581,1164,403,918,1884,1829,6527,550,1780,1790,60,4939,3860,1205,1373,278,-1135,1685,-3618,-1976,624,5154
2054,05000US39023,"Clark County, Ohio",4365,3714,4360,1858,4545,1924,2620,5654,4814,22080,2515,5975,9120,1235,18235,10503,3815,4099,1850,-4760,5168,-13691,-4849,999,17981
2055,05000US39025,"Clermont County, Ohio",5040,3950,4055,2385,4159,3340,4588,9100,7995,33269,3245,8820,6835,700,22190,20440,6260,8510,1795,-2780,5844,-14262,-11340,1735,24759
2056,05000US39027,"Clinton County, Ohio",1485,1038,1110,714,1337,450,844,1915,1525,6429,880,2065,2500,238,4675,3335,1245,1648,605,-1390,1813,-3381,-1420,280,4781
2057,05000US39029,"Columbiana County, Ohio",2954,2600,2129,885,2590,1819,3019,6008,5118,16011,2870,4480,3325,450,16709,8469,2789,3160,84,-1196,3025,-11871,-2461,2329,12851
2058,05000US39031,"Coshocton County, Ohio",938,875,830,374,543,770,1280,2185,1970,5265,915,1865,745,29,6220,2440,980,1300,23,85,888,-4170,-255,990,3965
2059,05000US39033,"Crawford County, Ohio",1500,894,1410,579,1094,928,1370,2370,2100,6078,1285,2525,1525,150,8405,2655,744,728,215,-115,1523,-6107,-285,1356,5350
2060,05000US39035,"Cuyahoga County, Ohio",70710,40485,43470,18995,47565,24130,29910,47919,42273,182770,36475,76545,90065,18160,163770,85770,27064,46475,34235,-46595,48400,-109730,-37851,15209,136295
2061,05000US39037,"Darke County, Ohio",1279,1087,1269,720,1379,580,1339,2751,2772,8628,1205,2815,1640,80,7489,4359,1333,2144,74,-371,2019,-5570,-1608,1439,6484
2062,05000US39039,"Defiance County, Ohio",640,664,909,335,1109,539,790,1728,1714,7288,690,1440,1440,85,5835,3540,1205,1264,-50,-531,1359,-4506,-1812,509,6024
2063,05000US39041,"Delaware County, Ohio",1655,1880,2780,1594,4810,1754,1874,4798,4269,42978,1095,2300,7070,2235,5240,13005,9600,27695,560,-4290,4169,-1612,-8207,-5331,15283
2064,05000US39043,"Erie County, Ohio",2070,1550,2464,1325,2325,1065,1618,3013,2779,13974,1430,3350,4289,650,8395,7640,2584,3929,640,-1825,3000,-5712,-4627,195,10045
2065,05000US39045,"Fairfield County, Ohio",3775,3445,3423,1475,3640,1939,3475,5434,4845,24725,2160,6100,6575,930,12270,17325,5239,5520,1615,-3152,4185,-6856,-11891,-394,19205
2066,05000US39047,"Fayette County, Ohio",1080,744,908,444,1264,490,788,1237,1147,3934,585,1905,1900,54,3709,2083,725,834,495,-992,1654,-2431,-846,422,3100
2067,05000US39049,"Franklin County, Ohio",56485,36875,48945,24445,63560,14590,18055,36040,32325,169785,21310,69780,113225,25980,102525,87425,30465,49530,35175,-64280,62025,-69880,-51385,1860,120255
2068,05000US39051,"Fulton County, Ohio",810,774,883,509,760,533,749,2014,1944,7796,485,1935,1220,95,4980,4650,1410,1729,325,-337,1174,-3698,-2636,534,6067
2069,05000US39053,"Gallia County, Ohio",800,660,685,249,449,820,1104,1560,1407,4434,665,1355,795,15,4834,2340,845,875,135,-110,683,-2910,-780,562,3559
2070,05000US39055,"Geauga County, Ohio",1070,830,1063,554,1470,1264,1819,3734,3294,20637,1085,1445,2050,405,4545,8618,5575,11822,-15,-987,1619,-1462,-4884,-2281,8815
2071,05000US39057,"Greene County, Ohio",5250,2940,3668,2000,7585,1838,2444,4658,4085,30839,2390,5195,9805,4045,12345,15295,5930,10245,2860,-6137,5540,-8063,-10637,-1845,20594
2072,05000US39059,"Guernsey County, Ohio",1515,975,810,444,810,965,1010,2173,1889,6030,1235,1945,1280,100,6495,2745,1089,1440,280,-470,1154,-4520,-572,800,4590
2073,05000US39061,"Hamilton County, Ohio",48014,26425,28910,12124,27545,13154,16338,29120,25930,115825,24760,64830,44185,9260,91035,52145,16970,38075,23254,-15275,30409,-61543,-23025,8960,77750
2074,05000US39063,"Hancock County, Ohio",2190,1574,3190,1019,1900,1235,1834,3890,3350,12935,1435,4530,3459,430,10435,6840,2180,2945,755,-269,2489,-7366,-2950,1170,9990
2075,05000US39065,"Hardin County, Ohio",783,719,835,348,724,550,650,1289,1113,4523,770,1555,1040,35,4913,1804,620,870,13,-205,1037,-3713,-515,493,3653
2076,05000US39067,"Harrison County, Ohio",363,143,383,90,314,424,514,843,782,2457,380,635,239,40,3242,970,283,460,-17,144,364,-2304,-127,499,1997
2077,05000US39069,"Henry County, Ohio",415,403,665,315,598,338,725,1637,1309,5159,415,1240,700,50,4495,2840,660,829,0,-35,863,-3432,-1203,649,4330
2078,05000US39071,"Highland County, Ohio",1694,845,940,564,959,949,1450,2150,2105,5754,935,2215,1750,90,6170,3040,1200,1529,759,-810,1433,-3771,-890,905,4225
2079,05000US39073,"Hocking County, Ohio",813,530,710,340,460,479,944,1395,1170,4774,950,1135,695,70,3975,2535,925,1189,-137,15,730,-2552,-1140,245,3585
2080,05000US39075,"Holmes County, Ohio",588,479,543,325,979,439,749,1574,1424,5635,1155,1230,415,120,2285,2560,1485,3274,-567,128,1184,-1097,-986,-61,2361
2081,05000US39077,"Huron County, Ohio",1484,1528,1400,805,1655,734,1287,2577,2491,9423,1415,2945,2330,190,7195,5540,1705,1789,69,-930,2270,-5174,-2963,786,7634
2082,05000US39079,"Jackson County, Ohio",1270,733,975,184,924,940,855,1469,1479,4445,1040,1625,1305,110,5515,1999,785,950,230,-330,998,-3720,-530,694,3495
2083,05000US39081,"Jefferson County, Ohio",2508,1685,1600,774,1954,1377,1591,3273,2843,10632,2105,3225,2825,374,12239,4427,1475,1513,403,-1225,2354,-9271,-1154,1368,9119
2084,05000US39083,"Knox County, Ohio",1599,1039,1335,924,1748,929,1278,2600,2505,9585,1140,2620,2625,280,5710,5690,1985,3320,459,-1290,2392,-3503,-3090,520,6265
2085,05000US39085,"Lake County, Ohio",4109,4025,6119,2595,7275,3535,5664,11049,9968,43734,2220,5560,14825,1530,26430,25205,9365,11040,1889,-8706,8340,-17231,-14156,603,32694
2086,05000US39087,"Lawrence County, Ohio",1525,1134,1374,984,1665,1554,1449,2690,2374,10099,1385,1635,3370,300,7929,4684,2339,2614,140,-1996,2349,-4926,-1994,35,7485
2087,05000US39089,"Licking County, Ohio",4725,3860,4165,1434,3589,2585,3977,7794,6544,27404,2990,7895,5865,1020,18225,18145,5014,6415,1735,-1700,4003,-11663,-10351,1530,20989
2088,05000US39091,"Logan County, Ohio",1225,788,1069,536,1265,934,1173,1799,1779,8453,1055,1600,2045,169,6079,3903,1813,2389,170,-976,1632,-3972,-2104,-34,6064
2089,05000US39093,"Lorain County, Ohio",10239,6589,6970,2875,7240,4170,6810,13520,12125,50304,5895,14355,10690,2980,37630,24614,10100,13640,4344,-3720,7135,-26650,-11094,2025,36664
2090,05000US39095,"Lucas County, Ohio",21605,13625,14095,6635,15700,7559,9194,16069,14729,63684,11280,27330,28850,4190,57610,28000,9584,14435,10325,-14755,18145,-40857,-11931,5145,49249
2091,05000US39097,"Madison County, Ohio",874,705,955,673,1085,515,735,1715,1635,6348,820,2190,1100,165,4050,3705,1325,1770,54,-145,1593,-2800,-1990,310,4578
2092,05000US39099,"Mahoning County, Ohio",8700,6659,6800,2600,5960,5304,6978,10959,9754,36794,5825,12530,10525,1835,39305,17345,5685,7925,2875,-3725,6725,-27023,-6386,4069,28869
2093,05000US39101,"Marion County, Ohio",1915,1890,1694,854,1443,1158,1564,2984,2173,9545,1370,2660,3480,305,10145,4189,1515,1350,545,-1786,1992,-7423,-1205,658,8195
2094,05000US39103,"Medina County, Ohio",2084,2505,3073,1310,4519,2074,3250,6499,6365,36392,1515,3950,6445,1575,9965,22168,9874,12495,569,-3372,4254,-4641,-15669,-3509,23897
2095,05000US39105,"Meigs County, Ohio",699,424,322,263,317,857,913,1299,1025,3389,680,845,445,64,4634,1459,579,795,19,-123,516,-2864,-160,446,2594
2096,05000US39107,"Mercer County, Ohio",600,954,734,339,1004,614,1187,2147,2138,6903,915,2110,544,75,5895,3487,1154,2165,-315,190,1268,-4094,-1340,984,4738
2097,05000US39109,"Miami County, Ohio",2335,2350,2569,1650,3484,1139,2308,4460,3585,17478,1335,4685,6035,325,11325,9244,4065,4200,1000,-3466,4809,-7878,-4784,-480,13278
2098,05000US39111,"Monroe County, Ohio",425,293,217,97,278,433,519,937,824,2198,440,600,244,25,2709,957,415,645,-15,-27,350,-1757,-20,409,1553
2099,05000US39113,"Montgomery County, Ohio",23425,16175,18935,8504,19740,9085,11213,20725,19200,80769,12020,29230,39650,5874,72875,42460,10885,14060,11405,-20715,22370,-52577,-21735,8315,66709
2100,05000US39115,"Morgan County, Ohio",464,299,268,155,155,558,671,820,803,2129,525,575,235,4,2979,910,394,530,-61,33,306,-1750,-90,409,1599
2101,05000US39117,"Morrow County, Ohio",639,708,500,125,289,610,1128,2289,2059,4995,665,1270,299,20,5074,3690,680,1220,-26,201,394,-3336,-1401,1379,3775
2102,05000US39119,"Muskingum County, Ohio",3114,2585,2615,818,2099,1704,2223,3838,4074,12543,2525,4225,4110,375,11213,7355,2345,2635,589,-1495,2542,-7286,-3517,1729,9908
2103,05000US39121,"Noble County, Ohio",200,113,301,48,127,288,523,1028,728,2120,210,330,250,8,2660,860,264,430,-10,51,167,-1849,168,464,1690
2104,05000US39123,"Ottawa County, Ohio",859,730,821,538,863,672,1168,2242,2125,8061,755,1685,1150,215,5370,4378,1387,2875,104,-329,1186,-3530,-2136,738,5186
2105,05000US39125,"Paulding County, Ohio",418,194,582,139,431,304,623,1089,943,3178,295,950,465,55,3838,1289,390,539,123,117,515,-2911,-200,553,2639
2106,05000US39127,"Perry County, Ohio",1128,714,785,311,634,973,780,1764,1564,5460,970,1340,1220,40,5385,2524,860,1425,158,-435,905,-3632,-760,704,4035
2107,05000US39129,"Pickaway County, Ohio",1340,969,1084,498,1203,829,1250,2469,1999,8235,1055,2365,1595,75,5970,5340,1460,1784,285,-511,1626,-3891,-2871,539,6451
2108,05000US39131,"Pike County, Ohio",948,854,615,443,610,589,799,1330,1470,4095,795,1505,995,153,4085,2155,605,855,153,-380,900,-2697,-825,865,3240
2109,05000US39133,"Portage County, Ohio",6070,3025,4170,1868,4370,2269,3539,6755,6399,25218,2290,6465,8835,1905,15104,14795,5725,7558,3780,-4665,4333,-9296,-8040,674,17660
2110,05000US39135,"Preble County, Ohio",887,754,924,359,903,564,1010,1938,1804,7419,795,1400,1450,183,5780,3734,1239,1750,92,-526,1079,-4206,-1796,565,5669
2111,05000US39137,"Putnam County, Ohio",529,600,648,300,520,515,837,1732,1784,6024,665,1425,440,70,4402,3724,1219,1310,-136,208,750,-3050,-1992,565,4714
2112,05000US39139,"Richland County, Ohio",3245,3184,3614,1815,3635,1717,2844,5509,5305,18458,1945,7145,5845,550,17564,9463,3003,2959,1300,-2231,4900,-13003,-3954,2302,15499
2113,05000US39141,"Ross County, Ohio",2295,1585,2080,798,1689,1514,2023,3344,2834,11185,1825,2690,3685,245,9285,6835,2050,2279,470,-1605,2242,-5748,-3491,784,8906
2114,05000US39143,"Sandusky County, Ohio",1749,1404,1238,695,1680,997,1333,2559,2679,10085,1195,2890,2455,230,8525,5259,1620,1820,554,-1217,2145,-6195,-2700,1059,8265
2115,05000US39145,"Scioto County, Ohio",3790,2270,1410,540,1735,2125,2384,3434,3399,9919,2960,4190,2235,345,11860,4660,2110,2134,830,-825,1930,-7351,-1226,1289,7785
2116,05000US39147,"Seneca County, Ohio",1265,1194,1224,729,1559,764,1254,2860,2525,8738,965,2890,2030,90,9040,4043,1170,1570,300,-806,2198,-7022,-1183,1355,7168
2117,05000US39149,"Shelby County, Ohio",894,889,1305,810,1560,489,1278,1862,2023,7772,540,3000,1705,210,5475,4403,1618,1893,354,-400,2160,-3708,-2541,405,5879
2118,05000US39151,"Stark County, Ohio",11340,9480,10749,5155,11340,5206,8153,15891,14120,63637,7200,17565,20985,2314,41995,37719,11435,14259,4140,-10236,14181,-28636,-21828,2685,49378
2119,05000US39153,"Summit County, Ohio",20680,14460,16350,6690,18455,8708,12017,21693,19382,88775,11570,28495,30880,5680,62970,45345,15869,24905,9110,-14530,19465,-42245,-23652,3513,63870
2120,05000US39155,"Trumbull County, Ohio",7000,5213,5614,2459,5250,4183,5216,10618,9555,33729,4845,11020,9090,569,35045,16975,4940,5515,2155,-3476,7140,-25646,-6357,4615,28214
2121,05000US39157,"Tuscarawas County, Ohio",2350,1925,2129,1277,3025,1846,2525,3998,3717,14273,1585,3965,4655,519,11913,7875,2895,3500,765,-2526,3783,-7542,-3877,822,10773
2122,05000US39159,"Union County, Ohio",944,794,888,453,1085,909,1270,2055,1580,9464,565,2140,1350,105,4715,5689,1645,3035,379,-462,1433,-2536,-3634,-65,6429
2123,05000US39161,"Van Wert County, Ohio",614,549,728,413,605,500,619,1523,1138,4978,480,1375,985,45,5005,2544,610,744,134,-257,973,-3886,-1021,528,4234
2124,05000US39163,"Vinton County, Ohio",539,323,239,93,158,348,349,724,639,1800,555,560,200,30,2510,714,270,289,-16,39,221,-1813,10,369,1511
2125,05000US39165,"Warren County, Ohio",2940,2935,3720,2230,6275,2155,3730,7625,7765,42640,2375,5425,7520,2790,14340,22810,8809,16855,565,-3800,5715,-8455,-15185,-1044,25785
2126,05000US39167,"Washington County, Ohio",2034,1350,1275,560,1423,1330,1799,3064,2929,10232,1530,2825,2080,193,8504,5268,2294,2759,504,-805,1790,-5375,-2204,635,7473
2127,05000US39169,"Wayne County, Ohio",2790,1984,2399,1478,3064,1529,2510,5258,4864,18695,2160,4810,4440,320,10750,12210,3830,5290,630,-2041,4222,-6711,-6952,1034,13405
2128,05000US39171,"Williams County, Ohio",765,733,1040,401,658,689,1029,2149,1819,6264,495,1795,1210,95,6950,3059,740,989,270,-170,964,-5232,-910,1079,5275
2129,05000US39173,"Wood County, Ohio",4215,2885,3519,1459,5110,1528,2298,3679,4046,22308,1470,5820,7605,2310,10969,10649,5305,6535,2745,-4086,4259,-7143,-6970,-1259,15773
2130,05000US39175,"Wyandot County, Ohio",399,475,612,455,604,410,645,1040,864,3764,395,1430,665,50,3519,1855,614,690,4,-53,1009,-2464,-815,250,3074
2131,05000US40001,"Adair County, Oklahoma",735,548,374,247,466,713,747,1044,1055,2204,880,845,610,33,3490,935,450,724,-145,-236,680,-2030,109,605,1480
2132,05000US40003,"Alfalfa County, Oklahoma",91,80,113,39,154,103,157,208,204,911,179,185,110,0,1044,224,63,213,-88,3,193,-784,-16,141,698
2133,05000US40005,"Atoka County, Oklahoma",339,393,344,141,217,319,432,692,707,1930,530,500,365,29,1955,699,358,910,-191,-21,329,-1204,-7,349,1020
2134,05000US40007,"Beaver County, Oklahoma",75,89,97,72,141,130,153,293,296,908,160,209,84,14,909,369,134,258,-85,13,199,-626,-76,162,650
2135,05000US40009,"Beckham County, Oklahoma",484,494,595,285,742,252,565,914,899,2825,870,630,1025,79,2510,1375,370,950,-386,-430,948,-1693,-461,529,1875
2136,05000US40011,"Blaine County, Oklahoma",200,173,177,104,249,242,283,445,424,1693,270,420,159,65,1779,590,159,415,-70,18,288,-1254,-145,265,1278
2137,05000US40013,"Bryan County, Oklahoma",1092,1170,1475,724,1798,753,1148,1634,1444,6024,915,1660,3160,525,5169,2625,1209,1844,177,-1685,1997,-3268,-991,235,4180
2138,05000US40015,"Caddo County, Oklahoma",574,647,643,269,907,647,732,1202,1152,3864,960,1215,790,64,4560,1378,709,805,-386,-147,1112,-3181,-176,443,3059
2139,05000US40017,"Canadian County, Oklahoma",1379,1799,2535,1158,3555,1565,1950,4249,4053,22301,1195,2985,5255,975,11264,13739,4058,5055,184,-2720,3738,-7749,-9490,-5,17246
2140,05000US40019,"Carter County, Oklahoma",1129,894,1388,478,1754,1087,1339,2045,1778,7077,1035,1925,2135,529,6428,2910,1368,2244,94,-747,1703,-4002,-865,410,4833
2141,05000US40021,"Cherokee County, Oklahoma",1410,1095,1255,629,1095,967,1103,1637,1484,6027,840,1905,2410,335,4749,2734,1578,2363,570,-1155,1389,-2679,-1097,-94,3664
2142,05000US40023,"Choctaw County, Oklahoma",684,444,336,104,307,520,627,681,582,1903,615,660,540,55,2300,680,440,773,69,-204,356,-1153,1,142,1130
2143,05000US40025,"Cimarron County, Oklahoma",23,39,77,14,119,71,64,111,116,360,175,68,30,0,535,104,29,54,-152,47,133,-400,7,87,306
2144,05000US40027,"Cleveland County, Oklahoma",7570,5935,8625,4505,9945,3565,4228,8844,9018,42713,2855,10185,19520,4020,22685,25380,7864,12015,4715,-10895,10430,-14892,-16536,1154,30698
2145,05000US40029,"Coal County, Oklahoma",126,191,95,50,175,203,166,252,190,868,235,183,190,20,859,297,149,338,-109,-95,205,-490,-45,41,530
2146,05000US40031,"Comanche County, Oklahoma",3819,3154,4490,2435,6015,1604,1634,3197,2908,14444,2190,5535,9630,2565,10215,6570,2575,4323,1629,-5140,5885,-6977,-3373,333,10121
2147,05000US40033,"Cotton County, Oklahoma",170,67,85,54,117,140,179,234,247,1004,144,224,113,0,1219,250,138,189,26,-28,171,-900,-16,109,815
2148,05000US40035,"Craig County, Oklahoma",266,302,381,182,314,257,463,723,658,2016,360,370,615,88,2013,780,459,829,-94,-234,408,-1293,-57,199,1187
2149,05000US40037,"Creek County, Oklahoma",1797,1409,1480,618,1540,1818,2216,3839,3209,9733,1965,2320,2375,184,10309,5480,1569,2469,-168,-895,1974,-6275,-1641,1640,7264
2150,05000US40039,"Custer County, Oklahoma",818,590,893,755,1189,393,435,870,730,4033,665,1155,2050,390,2474,1759,550,1454,153,-1157,1554,-1646,-889,180,2579
2151,05000US40041,"Delaware County, Oklahoma",659,950,1064,442,839,1000,1547,2497,2123,6103,1025,1185,1530,234,5914,2415,1555,3367,-366,-466,1047,-3367,82,568,2736
2152,05000US40043,"Dewey County, Oklahoma",47,134,90,20,183,127,112,194,163,723,235,139,95,0,825,214,85,149,-188,-5,203,-586,-20,78,574
2153,05000US40045,"Ellis County, Oklahoma",108,83,118,32,108,166,144,181,162,613,195,174,74,0,795,243,74,144,-87,44,140,-485,-62,88,469
2154,05000US40047,"Garfield County, Oklahoma",1044,1445,1844,864,3034,1149,1568,2379,2519,8784,1095,2000,4185,940,8263,3769,1540,2340,-51,-2341,2958,-5546,-1390,979,6444
2155,05000US40049,"Garvin County, Oklahoma",759,593,653,419,959,461,815,1173,1014,3978,990,1110,1195,100,3650,1530,649,1340,-231,-542,1278,-2374,-357,365,2638
2156,05000US40051,"Grady County, Oklahoma",1135,769,1019,450,1110,982,1428,2317,2073,8895,1240,1885,1225,120,7585,3705,1955,2265,-105,-206,1440,-5175,-1388,118,6630
2157,05000US40053,"Grant County, Oklahoma",47,93,68,79,172,73,117,256,221,793,215,133,110,4,1005,243,85,145,-168,-42,247,-815,13,136,648
2158,05000US40055,"Greer County, Oklahoma",164,79,154,84,105,139,162,352,376,748,195,280,110,10,1155,233,105,115,-31,44,179,-854,119,271,633
2159,05000US40057,"Harmon County, Oklahoma",87,50,59,49,85,75,99,161,148,399,134,150,39,10,714,70,25,50,-47,20,124,-540,91,123,349
2160,05000US40059,"Harper County, Oklahoma",59,26,94,18,91,97,135,166,127,579,90,104,69,4,780,165,70,64,-31,25,105,-548,1,57,515
2161,05000US40061,"Haskell County, Oklahoma",333,267,304,79,258,263,472,699,564,1818,365,495,349,24,2094,635,420,568,-32,-45,313,-1359,64,144,1250
2162,05000US40063,"Hughes County, Oklahoma",243,227,239,102,263,265,441,553,544,1533,425,405,219,20,2165,469,259,394,-182,20,345,-1459,84,285,1139
2163,05000US40065,"Jackson County, Oklahoma",762,653,827,488,1519,387,514,741,701,3513,685,1280,1700,595,3005,964,723,1244,77,-873,1412,-2104,-223,-22,2269
2164,05000US40067,"Jefferson County, Oklahoma",175,131,158,70,150,179,217,325,267,803,289,269,103,8,1314,267,62,149,-114,55,212,-918,58,205,654
2165,05000US40069,"Johnston County, Oklahoma",342,263,257,101,278,288,318,570,508,1574,575,220,410,19,1880,443,279,514,-233,-153,360,-1274,127,229,1060
2166,05000US40071,"Kay County, Oklahoma",909,1038,1228,639,1748,816,1299,1746,1535,7210,1080,1580,2605,298,7392,2594,1054,1614,-171,-1377,2089,-5277,-848,481,5596
2167,05000US40073,"Kingfisher County, Oklahoma",175,229,334,113,278,333,369,754,799,2534,275,535,300,20,2040,1335,455,735,-100,34,371,-1338,-581,344,1799
2168,05000US40075,"Kiowa County, Oklahoma",304,298,224,100,252,263,262,375,371,1469,430,374,374,4,1975,330,189,208,-126,-150,348,-1450,45,182,1261
2169,05000US40077,"Latimer County, Oklahoma",262,338,231,129,303,230,347,428,462,1484,435,480,345,10,1709,469,260,383,-173,-114,422,-1132,-41,202,1101
2170,05000US40079,"Le Flore County, Oklahoma",1209,889,1029,510,1280,1163,1559,2178,1905,7240,1135,1670,1865,250,6824,3190,1140,2550,74,-836,1540,-4102,-1012,765,4690
2171,05000US40081,"Lincoln County, Oklahoma",618,534,608,197,723,798,984,1644,1418,5715,820,845,925,100,5073,2389,1010,1930,-202,-317,820,-3291,-745,408,3785
2172,05000US40083,"Logan County, Oklahoma",865,778,565,319,690,1055,1450,1514,1429,7247,660,1475,980,85,5300,3045,1809,2563,205,-415,924,-2795,-1531,-380,4684
2173,05000US40085,"Love County, Oklahoma",99,114,162,79,199,159,141,390,343,1475,189,164,295,24,1290,435,295,519,-90,-133,254,-990,-45,48,956
2174,05000US40087,"McClain County, Oklahoma",738,524,635,450,668,663,924,1798,1467,6354,870,1190,770,184,3544,3459,1309,2615,-132,-135,934,-1957,-1661,158,3739
2175,05000US40089,"McCurtain County, Oklahoma",1005,964,880,332,780,1023,1242,1693,1512,4155,1095,1630,1115,94,5705,1384,863,1210,-90,-235,1018,-3440,309,649,2945
2176,05000US40091,"McIntosh County, Oklahoma",459,504,424,158,370,663,734,1144,1009,3229,605,575,650,85,3329,1295,730,1315,-146,-226,443,-1932,-151,279,1914
2177,05000US40093,"Major County, Oklahoma",113,58,134,77,286,198,233,397,362,1209,254,250,160,4,1445,514,120,322,-141,-26,359,-1014,-117,242,887
2178,05000US40095,"Marshall County, Oklahoma",196,258,329,230,505,349,553,789,788,2524,360,440,700,25,2695,920,434,775,-164,-371,710,-1793,-131,354,1749
2179,05000US40097,"Mayes County, Oklahoma",809,789,849,466,1268,878,1093,1979,1714,6532,1025,1045,1830,275,5278,2540,1600,2352,-216,-981,1459,-3307,-561,114,4180
2180,05000US40099,"Murray County, Oklahoma",309,365,309,152,567,314,307,490,514,2088,525,595,550,35,1835,875,413,619,-216,-241,684,-1214,-385,101,1469
2181,05000US40101,"Muskogee County, Oklahoma",2369,1850,1501,849,2175,1576,1614,2685,2148,10004,1335,2500,4290,605,8959,3905,2275,2805,1034,-2789,2419,-5769,-1220,-127,7199
2182,05000US40103,"Noble County, Oklahoma",269,243,279,95,332,228,332,499,507,1848,290,460,440,24,2040,640,204,544,-21,-161,403,-1480,-141,303,1304
2183,05000US40105,"Nowata County, Oklahoma",248,192,147,118,272,270,346,608,572,1564,265,280,340,99,1895,490,305,464,-17,-193,291,-1279,118,267,1100
2184,05000US40107,"Okfuskee County, Oklahoma",283,224,242,106,228,312,382,498,493,1443,400,420,240,20,1814,465,238,445,-117,2,314,-1120,33,255,998
2185,05000US40109,"Oklahoma County, Oklahoma",29185,22825,28135,12625,29150,11488,15456,27233,23649,102841,14410,40300,55975,11235,74150,53680,16764,33255,14775,-27840,30540,-47206,-26447,6885,69586
2186,05000US40111,"Okmulgee County, Oklahoma",1095,904,880,465,998,789,1252,1853,1644,5692,1120,1510,1595,134,6535,1855,959,1359,-25,-715,1329,-4494,-2,685,4333
2187,05000US40113,"Osage County, Oklahoma",1214,850,910,419,797,1431,1573,2682,2288,7014,1430,1355,1330,75,7569,3788,1215,1800,-216,-420,1141,-4565,-1106,1073,5214
2188,05000US40115,"Ottawa County, Oklahoma",893,769,805,361,938,703,1037,1496,1352,4156,810,1035,1705,234,4967,1565,838,1103,83,-900,1065,-3227,-69,514,3053
2189,05000US40117,"Pawnee County, Oklahoma",282,218,393,172,437,360,528,818,723,2619,410,415,615,54,2800,1059,343,649,-128,-222,555,-1912,-241,380,1970
2190,05000US40119,"Payne County, Oklahoma",5160,2760,3080,1184,3164,935,1058,1955,1754,9698,1335,3340,7780,2890,4429,4235,2269,4495,3825,-4700,1458,-2436,-2280,-515,5203
2191,05000US40121,"Pittsburg County, Oklahoma",1069,943,873,462,1507,925,1226,2212,1861,7399,1320,1045,2040,450,6544,3015,1049,2734,-251,-1167,1519,-4393,-803,812,4665
2192,05000US40123,"Pontotoc County, Oklahoma",1120,930,1320,343,1514,625,784,1277,1197,5689,1170,1590,2170,285,3895,2390,814,2344,-50,-850,1572,-2486,-1113,383,3345
2193,05000US40125,"Pottawatomie County, Oklahoma",1735,1480,1750,890,2255,1043,1546,2587,2441,10737,1695,1860,3915,620,7914,4390,2460,3409,40,-2165,2525,-5325,-1803,-19,7328
2194,05000US40127,"Pushmataha County, Oklahoma",367,260,251,87,216,321,376,703,614,1636,505,435,214,44,2240,530,287,389,-138,37,259,-1543,173,327,1247
2195,05000US40129,"Roger Mills County, Oklahoma",120,44,60,47,102,91,112,141,113,535,299,49,35,0,530,170,60,205,-179,25,149,-327,-29,53,330
2196,05000US40131,"Rogers County, Oklahoma",1478,1359,1689,848,2083,1449,2158,3922,3375,16505,1380,2085,3515,465,8904,9938,3045,5219,98,-1826,2466,-5297,-6016,330,11286
2197,05000US40133,"Seminole County, Oklahoma",759,513,629,245,624,547,863,1143,1102,3199,885,920,885,74,4155,1143,529,784,-126,-256,795,-2745,0,573,2415
2198,05000US40135,"Sequoyah County, Oklahoma",1020,865,1045,483,1039,844,1484,1835,1550,5695,905,1090,2095,350,5390,2800,1135,2050,115,-1050,1172,-3062,-965,415,3645
2199,05000US40137,"Stephens County, Oklahoma",1044,933,969,589,1405,939,1178,2077,1843,6854,960,1645,2025,304,6004,3560,994,2059,84,-1056,1690,-3887,-1483,849,4795
2200,05000US40139,"Texas County, Oklahoma",236,492,577,278,873,237,510,518,582,2821,440,620,1220,174,2174,1220,584,564,-204,-643,977,-1427,-702,-2,2257
2201,05000US40141,"Tillman County, Oklahoma",148,153,134,55,207,220,291,389,392,1143,170,294,190,34,1805,249,95,169,-22,-56,228,-1294,140,297,974
2202,05000US40143,"Tulsa County, Oklahoma",22715,18440,21525,11810,27895,8572,11745,20467,18637,91933,12340,25750,53760,10540,53535,51970,15900,29268,10375,-32235,29165,-33218,-31503,2737,62665
2203,05000US40145,"Wagoner County, Oklahoma",1260,985,1205,709,1709,1409,1830,3575,3015,13220,1065,1745,2610,480,7565,8995,2645,3585,195,-1405,1938,-4326,-5420,370,9635
2204,05000US40147,"Washington County, Oklahoma",1373,1064,1354,654,1795,951,1510,2223,2153,8248,1205,2340,2160,540,7294,3930,1463,2107,168,-806,1909,-4833,-1707,690,6141
2205,05000US40149,"Washita County, Oklahoma",245,146,232,124,475,203,322,459,453,1982,399,480,324,14,2199,543,175,445,-154,-92,585,-1674,-84,278,1537
2206,05000US40151,"Woods County, Oklahoma",294,268,123,109,340,242,189,408,298,1254,385,575,154,24,1554,439,145,174,-91,-31,425,-1123,-31,153,1080
2207,05000US40153,"Woodward County, Oklahoma",399,330,534,228,593,423,499,910,669,2958,310,1015,715,49,2815,1705,309,479,89,-181,772,-1893,-795,360,2479
2208,05000US41001,"Baker County, Oregon",420,428,499,273,620,302,464,655,704,2903,545,570,860,250,1294,1345,520,1749,-125,-361,643,-528,-690,184,1154
2209,05000US41003,"Benton County, Oregon",5290,2755,2845,1250,2835,1388,1668,2470,2555,12238,1300,4910,7050,1730,1990,3584,4540,9774,3990,-4205,2355,1066,-1114,-1985,2464
2210,05000US41005,"Clackamas County, Oregon",7630,7875,10530,6314,14450,6060,6950,13155,12615,70745,4150,6195,24050,12395,9045,12550,16175,70525,3480,-13520,8369,3965,605,-3560,220
2211,05000US41007,"Clatsop County, Oregon",870,1170,1658,634,1885,543,709,1297,1347,6235,670,670,3345,1535,1200,1135,1505,6245,200,-1687,984,52,162,-158,-10
2212,05000US41009,"Columbia County, Oregon",1385,1260,1104,409,1014,1168,1265,2269,2069,7560,950,1815,1920,500,2575,4995,2490,4360,435,-816,923,-142,-2726,-421,3200
2213,05000US41011,"Coos County, Oregon",2200,1689,1802,919,2605,1400,1524,2665,2769,9610,1270,1840,4115,1980,3335,3725,2565,8000,930,-2313,1544,-411,-1060,204,1610
2214,05000US41013,"Crook County, Oregon",465,620,714,315,920,420,415,1353,909,3550,450,535,1570,475,1005,1440,855,2995,15,-856,760,-170,-87,54,555
2215,05000US41015,"Curry County, Oregon",594,548,650,384,1179,403,940,1294,1179,3960,390,255,1580,1135,1455,710,690,4510,204,-930,428,-112,584,489,-550
2216,05000US41017,"Deschutes County, Oregon",3225,3835,5110,2895,9140,2875,2785,6669,5340,29225,1630,2230,11675,8655,4680,5319,4395,32295,1595,-6565,3380,980,1350,945,-3070
2217,05000US41019,"Douglas County, Oregon",2284,3085,3200,1685,4110,1555,3005,4775,4365,17837,1965,2800,7150,2440,6165,6998,4180,13683,319,-3950,3355,-1605,-2223,185,4154
2218,05000US41021,"Gilliam County, Oregon",32,39,77,27,129,47,42,105,89,246,80,70,95,49,208,199,40,98,-48,-18,107,-119,-94,49,148
2219,05000US41023,"Grant County, Oregon",137,140,230,70,273,144,242,424,332,1314,163,250,375,60,685,600,232,953,-26,-145,283,-299,-176,100,361
2220,05000US41025,"Harney County, Oregon",127,137,242,144,269,141,277,418,312,1109,309,365,209,39,935,605,144,605,-182,33,374,-517,-187,168,504
2221,05000US41027,"Hood River County, Oregon",399,559,704,590,850,264,408,673,657,3599,845,515,865,865,554,384,370,4190,-446,-161,575,118,289,287,-591
2222,05000US41029,"Jackson County, Oregon",6145,5785,6430,3255,10345,3398,4685,7536,6898,33455,2725,3160,15740,10340,8675,6460,5800,34120,3420,-9310,3260,-592,1076,1098,-665
2223,05000US41031,"Jefferson County, Oregon",482,399,523,185,788,244,418,809,598,3315,350,485,1075,470,1225,1160,635,2285,132,-552,503,-563,-351,-37,1030
2224,05000US41033,"Josephine County, Oregon",2719,2205,2875,1030,3160,1869,2365,3959,3194,13320,1380,1900,4970,3735,2685,2750,3125,15475,1339,-2095,455,1549,1209,69,-2155
2225,05000US41035,"Klamath County, Oregon",2160,1845,2094,934,2445,1025,1455,3009,2537,10142,840,1805,5515,1350,4629,4580,2259,6784,1320,-3421,2029,-2149,-1571,278,3358
2226,05000US41037,"Lake County, Oregon",264,339,406,152,287,199,358,358,374,1035,400,445,504,75,720,684,190,614,-136,-98,364,-163,-326,184,421
2227,05000US41039,"Lane County, Oregon",14065,10305,12920,6499,17445,4880,6445,12130,10823,56395,4810,6420,30475,19505,10125,12835,15495,50269,9255,-17555,4439,1200,-705,-4672,6126
2228,05000US41041,"Lincoln County, Oregon",1209,1380,1710,637,2598,755,1272,2313,2028,7604,1155,620,3360,2400,1599,1985,1629,8475,54,-1650,835,428,328,399,-871
2229,05000US41043,"Linn County, Oregon",3415,2730,3814,1608,5040,1537,2300,4209,3845,18660,1340,2050,10005,3225,4575,7520,5924,12050,2075,-6191,3423,-738,-3311,-2079,6610
2230,05000US41045,"Malheur County, Oregon",1047,1049,865,449,895,428,558,1073,807,3429,950,1170,1970,214,2113,1670,745,1585,97,-1105,1130,-1127,-597,62,1844
2231,05000US41047,"Marion County, Oregon",7975,8500,10255,5230,14765,2885,4089,9528,8843,45858,3625,5395,27420,10290,9319,15535,14334,31325,4350,-17165,9705,-2345,-6007,-5491,14533
2232,05000US41049,"Morrow County, Oregon",224,177,269,102,374,110,221,326,351,1785,205,380,520,40,1065,990,330,485,19,-251,436,-734,-664,21,1300
2233,05000US41051,"Multnomah County, Oregon",37005,23520,28465,15250,41045,11175,11684,23904,20464,109750,12815,19535,72170,40770,11210,27625,24475,111245,24190,-43705,15525,11649,-3721,-4011,-1495
2234,05000US41053,"Polk County, Oregon",2315,1670,2378,1089,2874,724,1315,2114,1764,13318,1075,1640,5215,2400,1930,3679,3840,9710,1240,-2837,1563,109,-1565,-2076,3608
2235,05000US41055,"Sherman County, Oregon",44,67,61,26,98,74,50,101,89,248,49,135,88,14,194,155,38,123,-5,-27,110,-70,-54,51,125
2236,05000US41057,"Tillamook County, Oregon",493,488,937,352,944,453,648,1053,1023,4315,435,350,1615,820,685,904,1250,4615,58,-678,476,416,149,-227,-300
2237,05000US41059,"Umatilla County, Oregon",1715,2054,1845,1280,3125,1034,1339,2284,2119,10673,1725,2195,5055,1040,4004,5790,2290,5020,-10,-3210,3365,-1631,-3506,-171,5653
2238,05000US41061,"Union County, Oregon",743,760,900,294,1080,372,568,920,730,4053,565,910,1840,465,1395,1535,1029,2639,178,-940,909,-455,-615,-299,1414
2239,05000US41063,"Wallowa County, Oregon",214,163,226,67,327,118,212,316,249,1250,185,310,420,90,225,435,278,1229,29,-194,304,105,-119,-29,21
2240,05000US41065,"Wasco County, Oregon",564,554,853,438,1220,243,507,985,853,4205,565,620,1555,905,819,1385,1215,3209,-1,-702,753,-69,-400,-362,996
2241,05000US41067,"Washington County, Oregon",13370,13595,18334,9100,29015,5879,7505,14854,14379,89699,4160,8045,46080,25125,8025,16510,21900,84310,9210,-27746,12990,5359,-1656,-7521,5389
2242,05000US41069,"Wheeler County, Oregon",22,38,24,16,77,69,101,76,99,188,69,53,45,8,178,129,38,189,-47,-21,85,-8,-53,61,-1
2243,05000US41071,"Yamhill County, Oregon",2655,2410,2770,1058,2645,1805,1918,4394,3700,13398,1135,3880,5250,1260,4175,6310,3859,10455,1520,-2480,2443,-452,-1916,-159,2943
2244,05000US42001,"Adams County, Pennsylvania",1710,1655,2334,1033,1913,1379,2344,4616,4486,18403,1630,2020,4325,644,5319,10650,6178,8380,80,-1991,2302,-1596,-6034,-1692,10023
2245,05000US42003,"Allegheny County, Pennsylvania",53029,33969,36604,17715,47100,25064,32184,53047,48833,202835,32520,62225,70615,23070,168910,99280,30310,54849,20509,-34011,41745,-111662,-46233,18523,147986
2246,05000US42005,"Armstrong County, Pennsylvania",1389,1519,1405,779,1744,1436,2417,3607,3167,11841,1845,2725,1975,279,11909,5048,2163,2772,-456,-570,2244,-8056,-1441,1004,9069
2247,05000US42007,"Beaver County, Pennsylvania",5860,3905,3915,1388,3710,3758,5505,9550,8592,26714,5910,8500,3830,535,27830,16315,3930,4633,-50,85,4563,-18567,-6765,4662,22081
2248,05000US42009,"Bedford County, Pennsylvania",1053,752,913,368,945,1023,1717,2642,2431,8443,1050,1605,1115,260,6642,4379,2102,2844,3,-202,1053,-3902,-1737,329,5599
2249,05000US42011,"Berks County, Pennsylvania",11755,8245,8630,4055,10085,6244,9482,16100,15353,67082,6460,11985,19850,4480,32315,40625,18510,21680,5295,-11220,9660,-16589,-24525,-3157,45402
2250,05000US42013,"Blair County, Pennsylvania",4295,3105,3140,1574,3355,2093,3225,6281,5671,20749,2940,5225,6170,1120,16334,9540,4709,5849,1355,-3030,3809,-11016,-3259,962,14900
2251,05000US42015,"Bradford County, Pennsylvania",1148,1374,1329,704,1693,1207,1867,3043,2858,10406,1400,1905,2520,430,7095,5274,2314,4220,-252,-1191,1967,-4021,-2231,544,6186
2252,05000US42017,"Bucks County, Pennsylvania",11300,9424,12509,6605,15395,9490,13067,22705,21994,117334,6170,6865,29315,12890,15170,41860,34419,90945,5130,-16806,9110,7387,-19155,-12425,26389
2253,05000US42019,"Butler County, Pennsylvania",4724,3330,3574,1559,4769,3058,4969,8088,7952,35388,3905,6800,4990,2279,16840,18325,7310,15780,819,-1416,4049,-8813,-10237,642,19608
2254,05000US42021,"Cambria County, Pennsylvania",4315,3329,2990,1308,2765,3036,4086,7316,7106,23353,4115,6050,3815,715,26849,8579,3322,4659,200,-825,3358,-19727,-1263,3784,18694
2255,05000US42023,"Cameron County, Pennsylvania",178,155,114,52,95,74,180,305,315,798,135,340,114,34,1245,224,50,124,43,0,113,-991,81,265,674
2256,05000US42025,"Carbon County, Pennsylvania",1570,1390,1250,758,905,1770,2364,4128,3238,9592,1325,2495,1875,194,9590,6939,2018,2164,245,-625,1469,-5456,-2811,1220,7428
2257,05000US42027,"Centre County, Pennsylvania",6880,4235,4508,2080,4565,1833,2750,5083,4877,22370,1940,5510,10100,4730,7775,11280,6135,10524,4940,-5592,1915,-3192,-6197,-1258,11846
2258,05000US42029,"Chester County, Pennsylvania",9205,6825,9584,5583,15605,6218,8705,16293,14119,100034,4610,6915,21560,13734,12255,28090,25975,76960,4595,-11976,7454,2668,-11797,-11856,23074
2259,05000US42031,"Clarion County, Pennsylvania",1304,1155,939,422,1052,583,1106,2051,2001,5983,1115,2095,1465,194,5609,2603,1119,1876,189,-526,1280,-3920,-552,882,4107
2260,05000US42033,"Clearfield County, Pennsylvania",1848,1575,1750,625,1397,1864,2718,4012,3673,12722,1980,2905,1945,355,14855,4945,2389,2338,-132,-195,1667,-10273,-933,1284,10384
2261,05000US42035,"Clinton County, Pennsylvania",1158,779,805,387,1154,580,933,1898,1673,5879,1010,1130,1835,325,4278,3249,1319,1615,148,-1030,1216,-2765,-1351,354,4264
2262,05000US42037,"Columbia County, Pennsylvania",2390,1530,1719,712,1874,1201,1601,2778,2821,10747,1255,2185,3905,880,6603,5270,2613,4177,1135,-2186,1706,-3801,-2492,208,6570
2263,05000US42039,"Crawford County, Pennsylvania",2005,2170,1844,847,2680,1431,2546,4562,4080,14024,2035,3885,3195,435,13053,7030,2584,3465,-30,-1351,3092,-9076,-2468,1496,10559
2264,05000US42041,"Cumberland County, Pennsylvania",5244,5185,6255,3115,8890,2864,5840,9786,9281,43607,3220,7535,14650,3280,13900,28495,12640,15073,2024,-8395,8725,-5196,-18709,-3359,28534
2265,05000US42043,"Dauphin County, Pennsylvania",10164,7040,9685,4220,9535,4095,5738,10423,9968,42050,5750,11500,19935,3475,25005,27590,8029,11393,4414,-10250,10280,-15172,-17167,1939,30657
2266,05000US42045,"Delaware County, Pennsylvania",16200,10969,13745,6515,14860,9944,12698,20405,18610,85375,7010,15540,31385,8375,42440,37195,20675,45755,9190,-17640,13000,-19798,-16790,-2065,39620
2267,05000US42047,"Elk County, Pennsylvania",513,795,534,309,692,559,962,1812,1948,5879,835,1540,395,80,6089,2413,1139,1123,-322,139,921,-4568,-601,809,4756
2268,05000US42049,"Erie County, Pennsylvania",9835,7755,7985,3490,8354,4283,5638,11796,10774,43378,5985,12140,15505,3790,32200,22259,8995,11164,3850,-7520,8054,-22279,-10463,1779,32214
2269,05000US42051,"Fayette County, Pennsylvania",5790,3139,2683,1010,1959,5353,6268,7310,6480,16227,5650,6640,2195,104,27299,8680,1758,2559,140,488,2865,-15678,-1370,4722,13668
2270,05000US42053,"Forest County, Pennsylvania",34,63,54,20,60,85,167,363,336,425,110,59,40,4,744,274,143,139,-76,14,76,-492,89,193,286
2271,05000US42055,"Franklin County, Pennsylvania",3275,2975,3893,1800,5740,2104,3032,6788,6225,25867,2570,5485,8270,1365,9800,15604,8500,9375,705,-4377,6175,-4664,-8816,-2275,16492
2272,05000US42057,"Fulton County, Pennsylvania",273,247,245,164,338,322,438,765,695,2676,300,510,435,35,1468,1227,810,1232,-27,-190,467,-708,-462,-115,1444
2273,05000US42059,"Greene County, Pennsylvania",873,539,849,434,1109,716,955,1608,1538,6178,1270,1255,1170,115,5575,2205,1104,1959,-397,-321,1428,-3904,-597,434,4219
2274,05000US42061,"Huntingdon County, Pennsylvania",1057,808,924,412,992,863,1256,2192,2017,6948,1375,1800,905,124,5663,3224,1587,2492,-318,19,1280,-3544,-1032,430,4456
2275,05000US42063,"Indiana County, Pennsylvania",2974,2219,1849,842,2280,1558,2246,4207,4037,13253,1975,3440,4010,755,12175,5878,2472,3780,999,-2161,2367,-8371,-1671,1565,9473
2276,05000US42065,"Jefferson County, Pennsylvania",1160,1089,1012,472,903,1023,1323,2409,2322,7422,1125,2050,1265,199,7877,3334,1158,1729,35,-253,1176,-5531,-925,1164,5693
2277,05000US42067,"Juniata County, Pennsylvania",503,388,438,308,647,313,753,1143,1049,4056,645,1020,540,65,2490,2265,1049,1354,-142,-102,890,-1424,-1122,0,2702
2278,05000US42069,"Lackawanna County, Pennsylvania",7755,5559,5965,2669,7610,3575,5201,8404,7800,33886,5065,8065,13585,2830,19505,16150,8534,13250,2690,-7620,7449,-10729,-7746,-734,20636
2279,05000US42071,"Lancaster County, Pennsylvania",11950,11504,15555,7420,16765,6299,10673,20194,17974,83410,6030,15280,32610,9280,27584,53625,24105,31190,5920,-17055,14905,-10612,-33431,-6131,52220
2280,05000US42073,"Lawrence County, Pennsylvania",2680,2070,1909,644,2235,1838,2979,4100,4017,15220,2635,3015,3370,505,15085,6249,2804,3611,45,-1461,2374,-10268,-2149,1213,11609
2281,05000US42075,"Lebanon County, Pennsylvania",3004,2810,3974,2010,4265,1665,2808,5450,5200,22407,2070,5365,7155,1500,9043,14594,5719,7950,934,-3181,4775,-4570,-9144,-519,14457
2282,05000US42077,"Lehigh County, Pennsylvania",12055,9290,9410,5295,11614,4811,7113,13422,12458,54198,5650,7720,26390,7925,21495,31845,13825,23779,6405,-16980,8984,-9571,-18423,-1367,30419
2283,05000US42079,"Luzerne County, Pennsylvania",10379,7540,8305,3974,10345,5647,8249,13340,11569,52127,8540,10905,17460,3640,39355,24565,10744,15394,1839,-9155,10679,-25459,-11225,825,36733
2284,05000US42081,"Lycoming County, Pennsylvania",3395,2329,3140,1369,3604,1634,2443,5082,4692,19667,1955,3255,6800,1835,10569,9905,5265,6699,1440,-3660,3138,-6492,-4823,-573,12968
2285,05000US42083,"McKean County, Pennsylvania",1264,973,904,369,990,668,1415,2133,1877,7131,990,1925,1410,179,9349,2143,699,834,274,-506,1180,-7266,-10,1178,6297
2286,05000US42085,"Mercer County, Pennsylvania",2744,2669,2905,1114,2880,1945,3007,6055,5820,18669,2965,4220,4755,350,16459,8834,3379,5324,-221,-1850,3644,-11507,-2779,2441,13345
2287,05000US42087,"Mifflin County, Pennsylvania",798,1540,1375,733,1185,787,1217,2476,2349,7234,1175,2265,2060,140,6830,3568,1420,1608,-377,-685,1778,-4826,-1092,929,5626
2288,05000US42089,"Monroe County, Pennsylvania",2579,2445,2625,1350,3529,3170,3588,7494,6374,25828,1745,1760,6610,2425,13360,17825,6800,8259,834,-3985,2454,-6602,-10331,-426,17569
2289,05000US42091,"Montgomery County, Pennsylvania",16335,13970,18655,9870,28255,11084,14555,27399,25364,152729,7250,12915,43655,23265,23705,56360,45425,103389,9085,-25000,14860,1934,-28961,-20061,49340
2290,05000US42093,"Montour County, Pennsylvania",514,362,419,249,580,259,569,904,873,2961,720,590,694,120,1523,1618,700,1454,-206,-275,709,-695,-714,173,1507
2291,05000US42095,"Northampton County, Pennsylvania",7249,6500,7024,3250,8265,3989,5994,11569,10829,51623,4760,5355,16520,5650,16045,28945,15125,22430,2489,-9496,5865,-6062,-17376,-4296,29193
2292,05000US42097,"Northumberland County, Pennsylvania",2789,2335,2693,945,2492,1822,2632,4981,4548,15560,2795,4520,3505,454,13869,6945,3143,4565,-6,-812,2983,-9415,-1964,1405,10995
2293,05000US42099,"Perry County, Pennsylvania",754,673,938,359,834,952,1382,2685,2361,7615,780,1770,1000,20,5114,5368,1857,2211,-26,-62,1173,-2780,-2683,504,5404
2294,05000US42101,"Philadelphia County, Pennsylvania",112940,46555,48245,21890,52955,56805,43999,59085,45250,117574,52465,86195,103720,40200,156640,90350,23380,45700,60475,-55475,34645,-55836,-31265,21870,71874
2295,05000US42103,"Pike County, Pennsylvania",705,713,784,332,862,1399,1429,2828,2145,10556,450,435,1660,850,4764,5624,2839,5074,255,-876,344,-1936,-2796,-694,5482
2296,05000US42105,"Potter County, Pennsylvania",352,375,267,111,387,444,580,1032,861,2409,370,565,495,73,2725,1093,538,738,-18,-228,425,-1701,-61,323,1671
2297,05000US42107,"Schuylkill County, Pennsylvania",3325,3018,3380,1579,3519,2783,4388,7418,7005,24670,3260,5240,5475,839,24983,9290,4475,5913,65,-2095,4259,-17812,-1872,2530,18757
2298,05000US42109,"Snyder County, Pennsylvania",659,740,953,498,1134,547,722,1672,1492,6557,790,1230,1815,140,3188,3337,1864,2440,-131,-862,1492,-1919,-1665,-372,4117
2299,05000US42111,"Somerset County, Pennsylvania",1670,1205,1600,639,1529,1525,2411,4358,4002,12499,1775,2835,1660,350,12639,5980,2216,2783,-105,-60,1818,-8703,-1622,1786,9716
2300,05000US42113,"Sullivan County, Pennsylvania",82,100,112,52,151,172,286,364,390,1116,129,180,160,28,749,523,344,602,-47,-48,175,-291,-159,46,514
2301,05000US42115,"Susquehanna County, Pennsylvania",770,857,861,496,991,819,1282,2076,2019,7766,890,1250,1500,355,4733,2998,2298,3689,-120,-639,1132,-2632,-922,-279,4077
2302,05000US42117,"Tioga County, Pennsylvania",790,863,763,581,1200,665,1073,2145,2005,6746,985,1140,1600,475,4754,2860,1530,2969,-195,-837,1306,-3016,-715,475,3777
2303,05000US42119,"Union County, Pennsylvania",725,780,828,659,1314,494,597,1814,1517,6599,855,1245,1715,480,2280,3184,1704,3309,-130,-887,1493,-1189,-1370,-187,3290
2304,05000US42121,"Venango County, Pennsylvania",1165,1354,1304,639,1054,961,1405,2957,2804,9151,1300,2585,1495,145,10600,3580,1064,1510,-135,-191,1548,-8234,-623,1740,7641
2305,05000US42123,"Warren County, Pennsylvania",810,944,1143,309,862,858,1230,2366,2226,7122,925,1855,1195,95,7750,3234,998,1273,-115,-52,1076,-5662,-868,1228,5849
2306,05000US42125,"Washington County, Pennsylvania",5718,3990,4694,1680,4395,4702,5843,10798,9898,35477,5800,8785,4980,910,27065,18195,6175,13190,-82,-286,5165,-16520,-7397,3723,22287
2307,05000US42127,"Wayne County, Pennsylvania",859,823,1028,423,857,1073,1326,2329,2161,8817,1070,860,1765,295,3384,4998,2129,5068,-211,-737,985,-985,-2669,32,3749
2308,05000US42129,"Westmoreland County, Pennsylvania",10875,6900,7215,3149,5935,8640,12402,20121,18407,63238,10265,16645,6265,910,55360,38035,11050,15619,610,950,8174,-34318,-17914,7357,47619
2309,05000US42131,"Wyoming County, Pennsylvania",512,440,442,287,698,438,766,1287,1160,5069,480,660,990,250,2135,2638,1520,2224,32,-548,735,-931,-1351,-360,2845
2310,05000US42133,"York County, Pennsylvania",9390,9315,9665,4905,10085,6509,10028,18629,17843,76514,5410,12740,22155,3050,35065,52975,17995,22325,3980,-12490,11940,-18528,-34346,-152,54189
2311,05000US44001,"Bristol County, Rhode Island",1430,955,1230,700,1730,795,665,1444,1378,9360,675,1220,3185,975,439,1430,2105,9630,755,-1955,1455,1021,14,-727,-270
2312,05000US44003,"Kent County, Rhode Island",5045,3540,3795,2318,5660,2784,3749,6464,5610,31499,3460,3100,9785,4020,5825,20035,8905,14490,1585,-5990,3958,708,-13571,-3295,17009
2313,05000US44005,"Newport County, Rhode Island",3410,1960,2520,1400,4160,1372,1355,2550,2385,14744,2670,1985,5565,3230,1400,2880,4055,13975,740,-3045,2330,1327,-330,-1670,769
2314,05000US44007,"Providence County, Rhode Island",37114,20900,21100,8710,23800,7659,10634,18970,16449,76915,22650,26115,49920,12924,18920,49280,23330,38215,14464,-28820,19586,-627,-30310,-6881,38700
2315,05000US44009,"Washington County, Rhode Island",3685,2519,2265,1150,3629,1644,1958,4293,4003,25535,2390,1935,6050,2880,1869,4610,6805,23680,1295,-3785,1899,1733,-317,-2802,1855
2316,05000US45001,"Abbeville County, South Carolina",449,599,470,154,482,759,669,1350,1170,3814,530,520,820,279,3330,1649,710,1759,-81,-350,357,-1902,-299,460,2055
2317,05000US45003,"Aiken County, South Carolina",4635,3535,3664,1754,4630,3560,4304,7545,6365,27635,3465,4690,8075,1995,18590,13410,5770,10665,1170,-4411,4389,-10726,-5865,595,16970
2318,05000US45005,"Allendale County, South Carolina",563,160,178,68,163,234,380,530,389,801,320,305,389,95,1660,193,120,205,243,-211,136,-1046,337,269,596
2319,05000US45007,"Anderson County, South Carolina",5200,4480,4850,2425,5409,3180,4989,8760,8055,31600,3835,5705,10450,2405,19670,14975,6785,13110,1365,-5600,5429,-11501,-6215,1270,18490
2320,05000US45009,"Bamberg County, South Carolina",365,267,359,114,234,372,613,605,559,2279,330,170,645,210,2550,645,280,759,35,-286,138,-1565,-40,279,1520
2321,05000US45011,"Barnwell County, South Carolina",889,533,438,174,538,553,755,808,752,3215,550,720,1275,64,3310,1049,575,1010,339,-837,648,-2002,-241,177,2205
2322,05000US45013,"Beaufort County, South Carolina",3105,3360,5035,2280,6515,3779,4059,7197,6438,28448,2170,2725,10615,4785,8920,7915,5300,27635,935,-5580,4010,-1082,-718,1138,813
2323,05000US45015,"Berkeley County, South Carolina",3570,3460,4875,2415,7610,3648,4174,7732,7094,30005,2950,3405,10470,5125,14459,18285,7149,11935,620,-5595,4900,-6637,-10553,-55,18070
2324,05000US45017,"Calhoun County, South Carolina",473,250,234,89,228,815,460,560,744,2355,435,510,315,14,2700,1080,360,759,38,-81,303,-1425,-520,384,1596
2325,05000US45019,"Charleston County, South Carolina",13275,8550,11335,5330,22250,6674,6561,11254,9928,61015,6475,6610,25155,22495,15165,15680,10770,54115,6800,-13820,5085,-1930,-4426,-842,6900
2326,05000US45021,"Cherokee County, South Carolina",1594,945,1373,500,1605,1260,1674,2350,1990,7979,1250,1120,3250,405,6575,3525,1965,2634,344,-1877,1700,-3641,-1175,25,5345
2327,05000US45023,"Chester County, South Carolina",844,759,469,229,783,956,1040,1389,1385,5158,855,715,1320,205,4580,2194,1059,1820,-11,-851,807,-2584,-805,326,3338
2328,05000US45025,"Chesterfield County, South Carolina",1325,1144,1093,393,1219,1073,1394,2013,1689,7650,1515,1305,1995,334,7200,2859,1304,2075,-190,-902,1278,-4733,-846,385,5575
2329,05000US45027,"Clarendon County, South Carolina",993,748,665,404,593,885,1160,1640,1494,5475,1165,970,1060,224,4910,2170,785,2535,-172,-395,773,-2865,-530,709,2940
2330,05000US45029,"Colleton County, South Carolina",804,914,948,359,1079,763,1071,2284,2134,5406,1005,815,1805,500,5569,2150,1023,2522,-201,-857,938,-3735,134,1111,2884
2331,05000US45031,"Darlington County, South Carolina",2024,1640,2079,889,1785,1555,2060,2813,2099,10310,2010,1905,3945,560,9814,3825,1760,3600,14,-1866,2114,-6199,-1012,339,6710
2332,05000US45033,"Dillon County, South Carolina",1239,790,579,345,748,858,844,1347,1273,3484,1200,1445,895,174,4589,1495,565,845,39,-316,919,-2887,-148,708,2639
2333,05000US45035,"Dorchester County, South Carolina",3265,2210,3425,1789,4925,2779,2644,5383,4344,23944,1925,1980,7820,3900,8819,14035,6539,9795,1340,-4395,2814,-3396,-8652,-2195,14149
2334,05000US45037,"Edgefield County, South Carolina",789,565,339,120,475,529,579,1090,1050,3849,550,1120,495,115,2960,1655,730,1630,239,-156,480,-1852,-565,320,2219
2335,05000US45039,"Fairfield County, South Carolina",830,568,390,113,359,1073,708,1449,1420,2780,460,1040,770,0,3945,1325,460,1090,370,-380,472,-2164,124,960,1690
2336,05000US45041,"Florence County, South Carolina",4030,3315,3660,1904,4905,2893,3016,5194,4565,19949,3115,4620,8300,1765,13000,9695,4159,8050,915,-4640,5044,-7091,-4501,406,11899
2337,05000US45043,"Georgetown County, South Carolina",1390,1120,1055,474,1805,1520,2100,2794,2589,10714,1260,890,2335,1355,6185,2940,1330,9170,130,-1280,924,-2565,-146,1259,1544
2338,05000US45045,"Greenville County, South Carolina",14345,11730,13810,6184,16955,7958,10995,17567,15366,74225,8070,17735,29585,7635,36184,41500,16035,31065,6275,-15775,15504,-17231,-23933,-669,43160
2339,05000US45047,"Greenwood County, South Carolina",2380,1853,2020,1109,2285,1104,1499,2365,2335,10844,1325,2345,4655,1340,6045,4664,2007,5059,1055,-2635,2054,-3442,-2299,328,5785
2340,05000US45049,"Hampton County, South Carolina",315,315,612,174,314,369,693,1123,1004,2549,650,490,519,65,3094,1350,290,754,-335,93,423,-2032,-227,714,1795
2341,05000US45051,"Horry County, South Carolina",6725,6110,8240,4580,12040,6133,7753,13109,11869,51490,4310,3605,20800,8955,20445,21785,13409,33570,2415,-12560,7665,-6559,-8676,-1540,17920
2342,05000US45053,"Jasper County, South Carolina",494,418,558,450,1040,525,649,1044,1074,3629,230,155,1355,1230,1865,1590,700,2569,264,-797,260,-691,-546,374,1060
2343,05000US45055,"Kershaw County, South Carolina",865,869,1039,415,1405,2400,1545,3159,2930,10805,865,1360,2100,270,8054,5810,2475,4105,0,-1061,1550,-4109,-2651,455,6700
2344,05000US45057,"Lancaster County, South Carolina",1650,1409,1334,605,1660,1715,1975,3514,3134,15410,1290,2010,2395,935,6595,5865,2685,10204,360,-1061,1330,-2905,-2351,449,5206
2345,05000US45059,"Laurens County, South Carolina",1420,1550,1390,894,2030,1195,1884,3055,2990,10489,1335,1545,3270,1145,9380,3885,1720,3654,85,-1880,1779,-6301,-830,1270,6835
2346,05000US45061,"Lee County, South Carolina",665,295,219,92,359,497,694,845,645,2328,500,340,540,255,3055,964,370,588,165,-321,196,-1864,-119,275,1740
2347,05000US45063,"Lexington County, South Carolina",5770,4710,6535,2955,8795,5410,5832,11329,10648,49599,3765,7610,13150,4255,27345,30190,8610,15720,2005,-6615,7495,-16103,-18861,2038,33879
2348,05000US45065,"McCormick County, South Carolina",292,158,168,118,227,237,219,484,451,1882,350,220,315,84,1345,439,264,1170,-58,-147,261,-889,45,187,712
2349,05000US45067,"Marion County, South Carolina",1275,680,774,229,749,845,1055,1465,1425,4014,1470,1020,1055,155,4900,1360,853,1315,-195,-281,823,-3000,105,572,2699
2350,05000US45069,"Marlboro County, South Carolina",978,538,635,290,843,691,868,1042,961,3278,795,1025,1255,200,4534,1125,344,454,183,-620,933,-2975,-83,617,2824
2351,05000US45071,"Newberry County, South Carolina",720,845,934,499,1063,804,1048,1644,1398,6123,860,520,1975,695,4888,1845,1055,3122,-140,-1041,867,-3036,-201,343,3001
2352,05000US45073,"Oconee County, South Carolina",1859,1975,1914,900,1840,1499,2044,3385,3234,13490,1935,2285,3195,1070,7510,5045,2399,8490,-76,-1281,1670,-3967,-1660,835,5000
2353,05000US45075,"Orangeburg County, South Carolina",3203,2064,1734,934,2435,2326,2464,3650,3685,12003,2360,2335,4530,1120,11089,4959,2350,4819,843,-2796,2249,-6299,-1309,1335,7184
2354,05000US45077,"Pickens County, South Carolina",4605,2955,3230,1409,2670,2649,3794,5814,5078,15654,2595,6165,4880,1220,13820,9865,3260,5185,2010,-1650,2859,-7377,-4051,1818,10469
2355,05000US45079,"Richland County, South Carolina",14430,9800,13254,6214,17490,6347,6298,11510,10154,55645,5875,10695,33790,10810,28550,30800,9700,21170,8555,-20536,12894,-15905,-19290,454,34475
2356,05000US45081,"Saluda County, South Carolina",655,375,485,168,305,615,633,945,815,2260,685,995,250,55,3070,1035,360,740,-30,235,418,-1822,-90,455,1520
2357,05000US45083,"Spartanburg County, South Carolina",7590,6505,7770,3935,9280,5044,6333,11652,10528,47549,5595,8005,17025,4475,27085,26389,9289,16984,1995,-9255,8740,-15708,-14737,1239,30565
2358,05000US45085,"Sumter County, South Carolina",3010,2500,3085,1549,4415,1934,2133,3634,3694,16288,2265,2495,6290,3510,10495,6780,3900,6213,745,-3205,2454,-6428,-3146,-206,10075
2359,05000US45087,"Union County, South Carolina",940,559,574,373,988,615,864,1447,1327,4380,815,840,1490,295,4779,1884,459,1045,125,-916,1066,-3300,-437,868,3335
2360,05000US45089,"Williamsburg County, South Carolina",1004,629,509,173,909,1223,1329,1520,1374,4124,1215,805,1010,205,5625,1459,754,1289,-211,-501,877,-3073,61,620,2835
2361,05000US45091,"York County, South Carolina",7290,4964,6624,2544,6245,5215,5509,10420,9745,39205,3945,9140,12500,2085,22115,22175,7815,16635,3345,-5876,6704,-11391,-11755,1930,22570
2362,05000US46003,"Aurora County, South Dakota",22,65,61,37,93,42,87,139,135,549,93,125,44,8,685,115,40,75,-71,17,122,-556,24,95,474
2363,05000US46005,"Beadle County, South Dakota",710,635,425,273,467,267,379,939,938,2939,619,1395,475,25,3084,1149,380,665,91,-50,715,-2438,-210,558,2274
2364,05000US46007,"Bennett County, South Dakota",105,63,79,40,93,93,44,94,92,232,174,149,44,4,460,45,8,64,-69,35,129,-323,49,84,168
2365,05000US46009,"Bon Homme County, South Dakota",138,138,150,87,149,170,199,283,272,1043,280,260,69,19,1350,368,80,155,-142,81,217,-981,-85,192,888
2366,05000US46011,"Brookings County, South Dakota",1280,1125,963,674,1047,198,354,1020,1174,4899,870,2355,1555,310,2340,3019,1039,1169,410,-592,1411,-1788,-1999,135,3730
2367,05000US46013,"Brown County, South Dakota",1094,1415,1224,783,1044,409,829,1609,1739,6602,1095,2555,1585,320,4469,3282,1120,2088,-1,-361,1507,-3231,-1673,619,4514
2368,05000US46015,"Brule County, South Dakota",161,92,174,114,166,118,111,277,257,792,300,270,120,4,730,424,95,228,-139,54,276,-501,-147,162,564
2369,05000US46017,"Buffalo County, South Dakota",122,49,70,23,37,56,30,42,42,76,190,89,35,0,165,45,4,15,-68,35,60,-79,-3,38,61
2370,05000US46019,"Butte County, South Dakota",360,205,208,110,183,273,455,625,560,1378,345,380,335,0,1435,850,299,514,15,-127,293,-707,-225,261,864
2371,05000US46021,"Campbell County, South Dakota",22,4,44,24,19,44,81,113,107,323,49,53,8,4,475,94,14,34,-27,36,39,-350,19,93,289
2372,05000US46023,"Charles Mix County, South Dakota",349,198,223,73,179,195,249,377,389,1093,545,395,79,8,1358,459,94,287,-196,144,244,-914,-82,295,806
2373,05000US46025,"Clark County, South Dakota",43,93,88,52,67,111,148,208,183,572,165,119,29,24,839,160,35,135,-122,59,95,-580,48,148,437
2374,05000US46027,"Clay County, South Dakota",894,443,664,253,302,207,179,314,315,1789,360,1155,840,200,1165,894,410,370,534,-176,355,-779,-580,-95,1419
2375,05000US46029,"Codington County, South Dakota",1170,693,1005,469,844,399,514,1312,1182,4612,800,1980,1080,325,2754,2445,1149,1589,370,-75,988,-1841,-1133,33,3023
2376,05000US46031,"Corson County, South Dakota",287,126,82,26,68,135,81,114,108,268,399,153,25,0,543,80,14,48,-112,57,94,-327,34,94,220
2377,05000US46033,"Custer County, South Dakota",177,111,182,34,174,325,327,425,453,1764,129,159,360,20,939,714,284,1405,48,-178,188,-287,-289,169,359
2378,05000US46035,"Davison County, South Dakota",624,719,880,329,845,385,393,875,823,3010,415,1645,1100,250,2250,1875,420,815,209,-220,924,-1472,-1000,403,2195
2379,05000US46037,"Day County, South Dakota",202,182,142,54,105,150,263,296,333,944,299,290,79,15,1252,270,179,204,-97,63,144,-839,26,154,740
2380,05000US46039,"Deuel County, South Dakota",48,47,118,42,77,118,101,250,282,843,189,115,28,0,869,289,160,205,-141,90,119,-650,-39,122,638
2381,05000US46041,"Dewey County, South Dakota",254,101,161,90,87,125,106,177,148,465,330,295,69,0,767,148,38,24,-76,92,177,-536,29,110,441
2382,05000US46043,"Douglas County, South Dakota",34,52,104,47,55,93,91,144,135,539,89,144,34,19,674,170,59,75,-55,70,83,-490,-26,76,464
2383,05000US46045,"Edmunds County, South Dakota",48,39,68,34,62,109,106,233,226,705,145,90,14,0,760,299,135,204,-97,54,96,-545,-66,91,501
2384,05000US46047,"Fall River County, South Dakota",237,85,198,139,184,279,179,343,319,1255,265,360,195,20,1115,655,185,355,-28,3,303,-657,-312,134,900
2385,05000US46049,"Faulk County, South Dakota",12,46,79,30,53,52,91,149,121,402,90,90,18,14,514,118,19,75,-78,61,69,-371,31,102,327
2386,05000US46051,"Grant County, South Dakota",153,49,188,8,126,143,190,481,516,1495,235,230,65,0,1455,750,255,270,-82,123,134,-1122,-269,261,1225
2387,05000US46053,"Gregory County, South Dakota",156,172,106,48,104,140,190,197,177,673,265,250,53,29,1075,240,29,45,-109,53,123,-745,-43,148,628
2388,05000US46055,"Haakon County, South Dakota",22,47,68,8,38,98,127,145,94,254,130,19,45,0,480,125,50,45,-108,23,46,-255,20,44,209
2389,05000US46057,"Hamlin County, South Dakota",51,64,107,98,104,74,111,263,294,1109,164,195,43,14,969,408,154,319,-113,64,188,-784,-145,140,790
2390,05000US46059,"Hand County, South Dakota",63,108,142,52,88,88,107,152,139,594,259,154,48,4,559,264,54,159,-196,94,136,-364,-112,85,435
2391,05000US46061,"Hanson County, South Dakota",12,42,22,27,30,61,88,186,178,490,70,38,19,0,550,200,84,135,-58,3,57,-401,-14,94,355
2392,05000US46063,"Harding County, South Dakota",23,23,34,28,52,19,24,79,71,214,108,40,8,4,250,54,12,69,-85,26,76,-207,25,59,145
2393,05000US46065,"Hughes County, South Dakota",755,564,739,249,315,279,364,614,810,2729,1050,1260,265,50,2125,1745,504,410,-295,474,514,-1482,-1131,306,2319
2394,05000US46067,"Hutchinson County, South Dakota",194,127,100,86,169,194,178,453,426,1121,359,265,39,20,1539,357,110,230,-165,61,235,-1167,96,316,891
2395,05000US46069,"Hyde County, South Dakota",28,25,18,12,42,60,41,81,81,249,53,53,4,0,320,64,49,40,-25,14,54,-219,17,32,209
2396,05000US46071,"Jackson County, South Dakota",159,98,18,12,84,110,53,119,120,269,235,123,4,4,500,84,4,30,-76,14,92,-337,35,116,239
2397,05000US46073,"Jerauld County, South Dakota",22,20,60,74,69,48,58,146,126,353,135,100,4,0,440,120,24,85,-113,56,143,-334,26,102,268
2398,05000US46075,"Jones County, South Dakota",22,4,32,22,18,45,37,87,68,125,64,34,4,0,224,58,20,4,-42,28,40,-142,29,48,121
2399,05000US46077,"Kingsbury County, South Dakota",154,97,92,72,71,107,137,273,285,1148,249,164,64,0,1050,397,150,284,-95,28,143,-806,-124,135,864
2400,05000US46079,"Lake County, South Dakota",390,313,215,78,234,374,202,465,592,2055,489,580,130,25,1603,910,415,670,-99,85,287,-1027,-445,177,1385
2401,05000US46081,"Lawrence County, South Dakota",819,834,1130,389,733,330,565,1109,924,4269,800,1455,1275,375,2130,1678,1100,2220,19,-145,747,-1235,-569,-176,2049
2402,05000US46083,"Lincoln County, South Dakota",423,588,904,582,1444,325,760,1759,1859,10345,334,1100,2269,245,2589,5899,2225,4305,89,-1365,1781,-1504,-4140,-366,6040
2403,05000US46085,"Lyman County, South Dakota",91,94,116,38,98,56,131,197,179,473,220,164,33,4,650,220,14,90,-129,83,132,-463,-23,165,383
2404,05000US46087,"McCook County, South Dakota",102,90,151,97,120,85,158,271,240,913,274,225,28,25,975,403,95,179,-172,123,192,-732,-132,145,734
2405,05000US46089,"McPherson County, South Dakota",39,52,76,8,54,96,133,129,109,374,89,65,45,8,679,95,25,34,-50,31,54,-450,34,84,340
2406,05000US46091,"Marshall County, South Dakota",97,103,143,54,127,69,115,179,209,774,215,214,85,4,785,255,95,169,-118,58,177,-601,-76,114,605
2407,05000US46093,"Meade County, South Dakota",643,478,583,512,680,509,733,1425,1375,4529,655,745,1310,195,2320,2995,1119,1780,-12,-727,997,-1078,-1570,256,2749
2408,05000US46095,"Mellette County, South Dakota",89,40,44,28,23,103,92,89,91,127,150,44,29,0,409,14,10,29,-61,15,51,-214,75,81,98
2409,05000US46097,"Miner County, South Dakota",56,47,37,44,38,62,75,138,152,389,105,95,15,4,546,119,45,89,-49,22,78,-409,19,107,300
2410,05000US46099,"Minnehaha County, South Dakota",6290,5245,7565,2854,4910,2134,3180,7310,6260,29172,3490,13195,9215,965,14645,20235,5400,7264,2800,-1650,6799,-9331,-12925,860,21908
2411,05000US46101,"Moody County, South Dakota",107,124,138,56,211,179,184,292,208,1213,265,325,55,0,1034,464,210,315,-158,83,267,-671,-172,-2,898
2412,05000US46102,"Oglala Lakota County, South Dakota",590,255,260,84,194,555,200,310,285,350,785,515,85,0,1415,95,0,25,-195,175,278,-660,215,285,325
2413,05000US46103,"Pennington County, South Dakota",3515,2610,3275,1348,3145,1509,1963,4302,4402,17759,2340,3940,6665,960,7257,10375,4380,7370,1175,-3390,3533,-3785,-6073,22,10389
2414,05000US46105,"Perkins County, South Dakota",85,60,56,52,93,83,95,206,166,530,170,129,40,0,629,135,59,149,-85,16,145,-451,71,107,381
2415,05000US46107,"Potter County, South Dakota",16,28,40,22,87,81,71,202,151,415,68,75,39,4,575,153,44,99,-52,1,105,-423,49,107,316
2416,05000US46109,"Roberts County, South Dakota",332,205,285,117,273,178,301,401,406,1409,455,475,219,55,1595,430,210,359,-123,66,335,-1116,-29,196,1050
2417,05000US46111,"Sanborn County, South Dakota",30,90,62,27,72,47,42,128,120,440,140,118,14,4,563,85,45,94,-110,48,95,-474,43,75,346
2418,05000US46115,"Spink County, South Dakota",124,72,245,63,176,65,172,381,291,1077,270,350,59,14,1339,284,100,228,-146,186,225,-1102,97,191,849
2419,05000US46117,"Stanley County, South Dakota",100,4,98,8,38,18,24,178,264,609,75,105,84,4,420,224,100,279,25,14,42,-378,-46,164,330
2420,05000US46119,"Sully County, South Dakota",20,4,35,33,63,38,56,56,54,268,93,44,0,0,250,113,65,39,-73,35,96,-156,-57,-11,229
2421,05000US46121,"Todd County, South Dakota",793,253,222,132,219,309,118,263,229,373,1115,385,85,40,1000,93,24,40,-322,137,311,-573,170,205,333
2422,05000US46123,"Tripp County, South Dakota",248,98,208,49,147,187,114,254,260,934,310,325,95,10,1150,265,70,194,-62,113,186,-849,-11,190,740
2423,05000US46125,"Turner County, South Dakota",262,131,172,68,151,215,318,521,501,1336,375,280,64,60,1683,665,204,224,-113,108,159,-1150,-144,297,1112
2424,05000US46127,"Union County, South Dakota",213,323,298,274,554,219,160,662,643,3081,334,535,690,120,1525,1280,610,1254,-121,-392,708,-1146,-618,33,1827
2425,05000US46129,"Walworth County, South Dakota",132,135,168,123,83,83,204,278,238,955,184,315,145,4,1114,345,70,140,-52,23,202,-827,-67,168,815
2426,05000US46135,"Yankton County, South Dakota",940,648,565,438,604,315,495,924,964,3670,770,1530,830,95,2424,2045,540,1105,170,-265,947,-1614,-1121,424,2565
2427,05000US46137,"Ziebach County, South Dakota",159,56,69,22,48,76,47,76,91,166,190,144,27,0,329,59,8,19,-31,42,70,-206,17,83,147
2428,05000US47001,"Anderson County, Tennessee",2840,2024,2035,1070,1959,1500,2328,3470,3025,11130,2475,3845,3100,520,9023,6020,2104,3960,365,-1065,2509,-5195,-2550,921,7170
2429,05000US47003,"Bedford County, Tennessee",1020,940,1135,625,1705,670,735,1760,1260,7445,750,570,3340,760,3230,3620,1755,3200,270,-2205,1570,-1825,-1860,-495,4245
2430,05000US47005,"Benton County, Tennessee",357,332,460,163,314,609,555,830,814,2574,409,570,545,100,2405,1240,495,1105,-52,-85,377,-1241,-410,319,1469
2431,05000US47007,"Bledsoe County, Tennessee",302,133,263,128,283,270,433,564,552,1985,410,340,375,4,1145,795,405,1360,-108,-112,407,-442,-231,147,625
2432,05000US47009,"Blount County, Tennessee",3070,2380,3130,1394,2590,2944,3693,6013,5293,20559,2340,4840,4595,800,9380,12785,5184,10654,730,-1465,3184,-2743,-6772,109,9905
2433,05000US47011,"Bradley County, Tennessee",2440,2025,2710,1800,4525,1595,1964,3435,3105,16815,2035,1820,7200,2445,5050,7809,4700,9025,405,-4490,3880,-1491,-4374,-1595,7790
2434,05000US47013,"Campbell County, Tennessee",1460,1049,814,352,1209,924,1195,1902,1777,5559,1500,1400,1680,285,5309,2529,1265,2244,-40,-866,1276,-3190,-627,512,3315
2435,05000US47015,"Cannon County, Tennessee",559,335,285,118,144,409,539,674,709,1808,610,685,120,24,1695,1185,408,729,-51,165,238,-747,-511,301,1079
2436,05000US47017,"Carroll County, Tennessee",835,514,604,463,680,597,839,1513,1208,4576,670,1085,1135,220,4157,2129,863,1240,165,-531,923,-2721,-616,345,3336
2437,05000US47019,"Carter County, Tennessee",1909,1620,1374,740,1499,1694,2182,2665,2454,8324,1615,2230,2910,390,5805,5490,2355,3339,294,-1536,1849,-1929,-2825,99,4985
2438,05000US47021,"Cheatham County, Tennessee",659,965,519,380,544,868,1100,2224,1845,5903,495,960,1350,260,3455,4949,1578,1925,164,-831,664,-1487,-2725,267,3978
2439,05000US47023,"Chester County, Tennessee",438,245,302,175,340,195,399,760,604,2664,320,244,835,95,1754,1335,745,760,118,-533,420,-1160,-575,-141,1904
2440,05000US47025,"Claiborne County, Tennessee",1325,612,773,323,753,999,915,1539,1289,4828,1180,1170,1255,154,3810,2589,1049,2005,145,-482,922,-1896,-1050,240,2823
2441,05000US47027,"Clay County, Tennessee",364,174,98,119,58,215,368,439,400,1130,385,330,85,10,1133,410,355,500,-21,13,167,-550,29,45,630
2442,05000US47029,"Cocke County, Tennessee",1445,1080,844,415,840,924,1150,1785,1538,5215,1600,1385,1520,130,3919,2480,1085,2515,-155,-676,1125,-1845,-695,453,2700
2443,05000US47031,"Coffee County, Tennessee",1094,1145,1560,820,2320,895,1140,2025,1769,9224,850,1650,3900,540,5374,4110,1605,3715,244,-2340,2600,-3339,-2085,164,5509
2444,05000US47033,"Crockett County, Tennessee",258,420,367,133,444,247,337,654,604,2103,300,400,775,155,1740,1019,354,844,-42,-408,422,-1156,-365,250,1259
2445,05000US47035,"Cumberland County, Tennessee",1140,1104,1040,814,1370,1165,1699,3258,2779,11150,1025,1240,2790,439,5499,4369,2884,7370,115,-1750,1745,-2635,-1111,-105,3780
2446,05000US47037,"Davidson County, Tennessee",27885,21275,26350,14375,34900,9812,11683,23155,19400,87975,14335,23725,63330,23370,32190,51070,18634,48920,13550,-36980,25905,-10695,-27915,766,39055
2447,05000US47039,"Decatur County, Tennessee",397,282,210,78,288,379,340,547,517,1859,320,480,430,24,1610,750,390,819,77,-220,342,-891,-203,127,1040
2448,05000US47041,"DeKalb County, Tennessee",472,311,468,324,879,360,468,803,808,2748,455,730,1130,153,1618,1285,905,1364,17,-662,1050,-790,-482,-97,1384
2449,05000US47043,"Dickson County, Tennessee",1593,1450,1220,570,629,1220,1674,2570,2100,6365,1655,2775,945,85,5690,4860,1470,1750,-62,275,1114,-2796,-2290,630,4615
2450,05000US47045,"Dyer County, Tennessee",1250,1109,1380,515,1655,479,949,1155,1204,6059,1035,1910,2740,215,4554,2330,894,1760,215,-1360,1955,-3126,-1175,310,4299
2451,05000US47047,"Fayette County, Tennessee",1008,533,697,260,548,769,1249,1434,1194,7623,925,1025,735,370,3204,2759,1504,4679,83,-38,438,-1186,-1325,-310,2944
2452,05000US47049,"Fentress County, Tennessee",569,309,370,218,339,635,738,1029,1234,2230,705,675,405,10,2500,1219,534,1469,-136,-35,547,-1127,-190,700,761
2453,05000US47051,"Franklin County, Tennessee",785,849,880,403,1394,674,1140,1790,1319,7465,820,1515,1755,220,4430,3050,1685,3069,-35,-875,1577,-2616,-1260,-366,4396
2454,05000US47053,"Gibson County, Tennessee",1288,1100,1224,465,1784,625,1248,2225,2004,7842,1155,1375,2545,768,6383,3324,1434,2603,133,-1321,1481,-4510,-1099,570,5239
2455,05000US47055,"Giles County, Tennessee",655,770,804,334,959,430,694,1184,1119,4969,765,905,1670,180,2829,2270,1060,2140,-110,-866,1113,-1705,-1086,59,2829
2456,05000US47057,"Grainger County, Tennessee",389,384,474,192,618,555,564,1280,1120,3935,655,450,820,135,2590,1810,644,2085,-266,-346,675,-1471,-530,476,1850
2457,05000US47059,"Greene County, Tennessee",1630,1255,2154,709,1718,1390,2104,3239,3030,11059,1960,2335,2880,279,7170,5125,2665,5290,-330,-726,2148,-3676,-1886,365,5769
2458,05000US47061,"Grundy County, Tennessee",421,232,269,98,207,458,548,594,530,1627,540,305,310,68,1999,879,300,583,-119,-41,237,-993,-285,230,1044
2459,05000US47063,"Hamblen County, Tennessee",1865,1694,1599,690,2405,1054,1254,2263,1939,10014,1390,1385,4620,870,4024,5300,3055,4090,475,-3021,2225,-1716,-3037,-1116,5924
2460,05000US47065,"Hamilton County, Tennessee",10899,9270,10715,5220,13315,4837,6765,11925,11550,57748,7115,10285,23440,8564,20515,28775,14175,27940,3784,-12725,9971,-8913,-16850,-2625,29808
2461,05000US47067,"Hancock County, Tennessee",182,111,143,24,152,239,328,460,418,860,315,220,79,4,1085,550,195,410,-133,64,172,-518,-90,223,450
2462,05000US47069,"Hardeman County, Tennessee",579,439,554,208,869,543,710,1090,1039,2875,520,845,980,299,3268,1525,435,945,59,-426,778,-2015,-435,604,1930
2463,05000US47071,"Hardin County, Tennessee",590,640,374,310,614,648,870,1159,1148,4138,775,640,990,115,3220,1730,715,2029,-185,-616,809,-1702,-571,433,2109
2464,05000US47073,"Hawkins County, Tennessee",1444,1189,1264,614,1575,1478,1825,3294,2835,8930,1215,1905,2630,320,6865,4960,2645,3405,229,-1366,1869,-3562,-1666,190,5525
2465,05000US47075,"Haywood County, Tennessee",879,504,603,198,674,304,293,680,659,2450,620,815,1250,155,1854,1155,475,900,259,-647,717,-1257,-475,184,1550
2466,05000US47077,"Henderson County, Tennessee",975,629,505,150,740,464,564,1334,1280,4624,645,910,1260,185,3775,2020,700,1429,330,-755,705,-2747,-686,580,3195
2467,05000US47079,"Henry County, Tennessee",809,610,769,404,735,648,1083,1720,1415,5694,540,1205,1525,44,4453,2795,865,2265,269,-756,1095,-2722,-1075,550,3429
2468,05000US47081,"Hickman County, Tennessee",429,524,390,234,332,522,600,1250,1090,3763,540,345,850,190,2680,1865,760,1689,-111,-460,376,-1558,-615,330,2074
2469,05000US47083,"Houston County, Tennessee",163,112,109,113,198,146,268,349,295,1335,129,245,280,34,1030,635,205,495,34,-171,277,-616,-286,90,840
2470,05000US47085,"Humphreys County, Tennessee",460,373,262,168,379,433,414,934,964,2998,295,575,720,44,2514,1674,430,1039,165,-458,503,-1667,-740,534,1959
2471,05000US47087,"Jackson County, Tennessee",299,148,298,80,277,344,744,402,358,1648,415,375,284,14,1485,819,399,864,-116,14,343,-397,-417,-41,784
2472,05000US47089,"Jefferson County, Tennessee",959,935,1039,417,1974,790,944,2389,2139,9003,1180,1040,2290,825,4130,3679,1829,5539,-221,-1251,1566,-2396,-1290,310,3464
2473,05000US47091,"Johnson County, Tennessee",622,343,144,224,293,453,698,1125,755,2465,820,380,375,60,2040,1250,600,1589,-198,-231,457,-889,-125,155,876
2474,05000US47093,"Knox County, Tennessee",17470,11380,13725,6789,16060,7312,9382,16459,14899,72659,11055,14630,31000,8730,30790,39630,16845,31885,6415,-17275,14119,-14096,-23171,-1946,40774
2475,05000US47095,"Lake County, Tennessee",306,198,143,56,178,117,148,137,92,784,310,280,254,39,798,355,80,89,-4,-111,195,-533,-218,12,695
2476,05000US47097,"Lauderdale County, Tennessee",1043,975,850,349,919,309,492,1099,740,3193,765,1275,1960,135,3019,1419,460,774,278,-1110,1133,-2218,-320,280,2419
2477,05000US47099,"Lawrence County, Tennessee",1015,865,924,363,1044,710,1155,1868,1654,6970,1145,1020,1750,305,5199,2955,1360,2510,-130,-826,1102,-3334,-1087,294,4460
2478,05000US47101,"Lewis County, Tennessee",210,330,235,18,210,170,329,759,664,2125,190,505,280,10,1804,860,360,755,20,-45,218,-1305,-101,304,1370
2479,05000US47103,"Lincoln County, Tennessee",600,795,969,454,924,604,750,1469,1260,6128,600,1040,1620,484,3375,2540,1328,2840,0,-651,894,-2021,-1071,-68,3288
2480,05000US47105,"Loudon County, Tennessee",1095,1065,1140,379,1140,908,1414,2175,2355,8960,1195,1840,1495,280,4438,3365,1635,6055,-100,-355,1239,-2116,-1190,720,2905
2481,05000US47107,"McMinn County, Tennessee",1390,1283,974,389,1205,970,1668,2385,2070,8895,1165,1365,2280,430,5422,3675,2245,4270,225,-1306,1164,-2784,-1290,-175,4625
2482,05000US47109,"McNairy County, Tennessee",709,553,720,304,384,669,864,1393,1147,3932,740,910,920,100,3658,1990,610,1220,-31,-200,588,-2125,-597,537,2712
2483,05000US47111,"Macon County, Tennessee",415,534,684,239,545,485,775,1465,990,3329,460,865,1000,105,2410,2089,700,1569,-45,-316,679,-1150,-624,290,1760
2484,05000US47113,"Madison County, Tennessee",3325,2575,2288,1269,4145,1219,1429,3312,2764,15379,1605,2270,6080,3645,7979,7265,3679,5305,1720,-3792,1769,-5331,-3953,-915,10074
2485,05000US47115,"Marion County, Tennessee",864,645,543,334,508,925,815,1280,1213,4512,975,1050,700,150,3905,2070,934,1738,-111,-157,692,-2165,-790,279,2774
2486,05000US47117,"Marshall County, Tennessee",584,513,930,344,1014,365,595,1459,1275,5323,490,850,1950,110,3400,2119,1319,1929,94,-1020,1248,-2440,-660,-44,3394
2487,05000US47119,"Maury County, Tennessee",1895,2040,2125,1175,3225,1164,1955,3285,3270,13640,1515,2785,4715,1420,6845,7260,3355,5740,380,-2590,2980,-3726,-3975,-85,7900
2488,05000US47121,"Meigs County, Tennessee",361,103,213,101,224,252,327,730,634,2044,254,240,394,118,1375,810,395,1230,107,-181,207,-796,-80,239,814
2489,05000US47123,"Monroe County, Tennessee",1060,830,730,389,1214,879,1575,2444,2264,6768,835,1110,1860,405,4915,3140,1528,3945,225,-1130,1198,-2461,-696,736,2823
2490,05000US47125,"Montgomery County, Tennessee",4029,3135,5695,3620,11790,2355,2280,4890,4249,27683,2250,2690,13655,9675,7955,14935,7564,11379,1779,-7960,5735,-3320,-10045,-3315,16304
2491,05000US47127,"Moore County, Tennessee",55,90,65,8,200,145,240,315,379,1202,85,260,65,0,670,475,349,699,-30,0,208,-285,-160,30,503
2492,05000US47129,"Morgan County, Tennessee",313,268,399,128,287,485,825,875,865,3213,350,345,544,159,2705,1720,535,1129,-37,-145,256,-1395,-845,330,2084
2493,05000US47131,"Obion County, Tennessee",930,848,1045,378,966,675,762,1249,1188,5063,940,1225,1865,139,4398,2228,840,1398,-10,-820,1205,-2961,-979,348,3665
2494,05000US47133,"Overton County, Tennessee",575,435,358,139,390,654,715,1344,1078,3588,705,700,395,105,2569,1795,775,1944,-130,-37,424,-1200,-451,303,1644
2495,05000US47135,"Perry County, Tennessee",222,142,96,47,103,380,385,489,433,1230,179,150,244,15,1360,679,210,515,43,-148,135,-595,-190,223,715
2496,05000US47137,"Pickett County, Tennessee",73,141,53,83,58,140,173,274,258,964,139,205,69,0,690,240,235,600,-66,-16,141,-377,34,23,364
2497,05000US47139,"Polk County, Tennessee",282,402,263,209,519,323,653,803,688,3054,400,390,799,80,2104,1120,785,1379,-118,-536,648,-1128,-317,-97,1675
2498,05000US47141,"Putnam County, Tennessee",3345,2220,2490,840,3215,1185,1800,2625,2330,11353,1505,2635,6625,1335,3545,5264,4199,5905,1840,-4135,2720,-560,-2639,-1869,5448
2499,05000US47143,"Rhea County, Tennessee",1110,783,569,319,929,539,694,1484,1470,5175,920,705,1910,190,3395,2105,1200,2435,190,-1341,1058,-2162,-621,270,2740
2500,05000US47145,"Roane County, Tennessee",1800,715,1140,470,1225,1059,1510,2714,2539,9419,1405,1500,1820,615,5955,4270,1565,4919,395,-680,1080,-3386,-1556,974,4500
2501,05000US47147,"Robertson County, Tennessee",1415,1420,1554,900,1039,1060,1774,3349,3069,10079,1095,2525,2465,235,5960,7455,2170,3365,320,-911,1704,-3126,-4106,899,6714
2502,05000US47149,"Rutherford County, Tennessee",7645,6430,7759,4859,10040,3135,5335,10150,10040,42099,3380,9840,19865,3675,17510,30470,9775,13024,4265,-12106,11224,-9040,-20320,265,29075
2503,05000US47151,"Scott County, Tennessee",764,565,527,193,534,735,760,988,797,2960,850,850,860,20,3040,1250,610,1040,-86,-333,707,-1545,-262,187,1920
2504,05000US47153,"Sequatchie County, Tennessee",254,314,285,64,425,324,520,540,669,2235,310,680,265,95,1585,1130,524,1035,-56,20,394,-741,-590,145,1200
2505,05000US47155,"Sevier County, Tennessee",1515,2349,2974,1615,3594,1333,2219,3758,3243,15049,1715,1955,6230,2135,5675,5040,4683,10010,-200,-3256,3074,-2123,-1282,-1440,5039
2506,05000US47157,"Shelby County, Tennessee",38985,27170,28960,15395,43510,13615,16119,25023,21407,123840,12820,26235,83815,31135,82245,47560,22425,46210,26165,-54855,27770,-52511,-22537,-1018,77630
2507,05000US47159,"Smith County, Tennessee",390,377,528,194,424,448,402,1003,872,3189,495,860,505,45,2104,1825,510,1299,-105,23,573,-1254,-822,362,1890
2508,05000US47161,"Stewart County, Tennessee",228,303,277,220,510,353,224,594,514,2182,325,620,440,175,1300,883,635,1029,-97,-163,555,-723,-289,-121,1153
2509,05000US47163,"Sullivan County, Tennessee",3939,3620,4220,1850,4585,2810,4250,7840,7094,28279,4045,4760,7885,1525,15640,13535,7365,12440,-106,-3665,4910,-8580,-5695,-271,15839
2510,05000US47165,"Sumner County, Tennessee",3710,3110,4205,1620,4460,2620,4064,7471,7447,27238,2580,4520,7615,2410,11185,16444,7154,13320,1130,-3410,3670,-4501,-8973,293,13918
2511,05000US47167,"Tipton County, Tennessee",1554,1354,1280,734,1700,959,810,2109,1894,9524,1220,2060,2730,610,5089,5125,2410,2455,334,-1450,1824,-3320,-3016,-516,7069
2512,05000US47169,"Trousdale County, Tennessee",228,180,194,25,220,215,390,414,279,820,265,360,220,0,1200,550,125,250,-37,-26,245,-595,-136,154,570
2513,05000US47171,"Unicoi County, Tennessee",500,384,610,99,515,465,675,1000,850,2830,360,740,895,110,1865,1725,665,1265,140,-285,504,-725,-725,185,1565
2514,05000US47173,"Union County, Tennessee",605,389,459,213,125,695,705,1100,1205,2060,650,780,310,30,2730,1625,615,785,-45,149,308,-1330,-525,590,1275
2515,05000US47175,"Van Buren County, Tennessee",59,57,47,34,69,128,175,395,288,1033,140,84,39,0,840,490,105,459,-81,8,103,-537,-95,183,574
2516,05000US47177,"Warren County, Tennessee",1080,934,1004,722,1220,704,1309,1725,1565,5934,1200,1165,2480,115,4130,3095,1270,2570,-120,-1476,1827,-2117,-1370,295,3364
2517,05000US47179,"Washington County, Tennessee",3880,3545,3965,1935,5295,1525,2080,4700,4375,22609,2650,2740,9540,3695,7205,9245,5695,12615,1230,-5575,3535,-3600,-4545,-1320,9994
2518,05000US47181,"Wayne County, Tennessee",250,297,210,63,314,494,674,870,854,2254,455,355,304,25,2199,1155,395,1008,-205,-94,352,-1031,-285,459,1246
2519,05000US47183,"Weakley County, Tennessee",1340,715,1070,419,998,550,944,1798,1399,4945,755,1705,1905,180,4629,2120,1040,1440,585,-835,1237,-3135,-322,359,3505
2520,05000US47185,"White County, Tennessee",413,509,545,159,475,640,879,1440,1090,3900,505,635,890,90,3250,1890,699,2000,-92,-345,544,-1731,-450,391,1900
2521,05000US47187,"Williamson County, Tennessee",1835,1849,2525,1600,6434,2005,2289,4685,4730,46033,1660,1280,3730,7565,2939,6265,6888,43235,175,-1205,469,1355,-1580,-2158,2798
2522,05000US47189,"Wilson County, Tennessee",2225,1845,2700,1240,2860,1954,2803,5605,5235,22050,1630,3085,4595,1570,5765,11810,7199,11935,595,-1895,2530,-1008,-6205,-1964,10115
2523,05000US48001,"Anderson County, Texas",723,1045,1209,523,1333,869,1317,1913,1994,6065,915,940,2535,428,6390,2585,940,1979,-192,-1326,1428,-4204,-672,1054,4086
2524,05000US48003,"Andrews County, Texas",224,234,225,175,555,292,393,500,520,2480,230,280,635,290,1805,1320,325,525,-6,-410,440,-1120,-820,195,1955
2525,05000US48005,"Angelina County, Texas",2230,2415,1730,990,3129,1520,1730,3335,3155,11775,1695,1920,5380,1515,10670,5100,1680,3450,535,-3650,2604,-7420,-1765,1475,8325
2526,05000US48007,"Aransas County, Texas",595,494,390,330,680,528,710,1170,1089,4000,380,395,1140,575,2344,1290,665,2970,215,-750,435,-1106,-120,424,1030
2527,05000US48009,"Archer County, Texas",109,114,144,70,156,118,203,373,359,1839,205,165,195,39,1104,730,365,555,-96,-51,187,-783,-357,-6,1284
2528,05000US48011,"Armstrong County, Texas",18,18,33,10,63,47,37,60,75,384,19,65,34,19,290,149,50,80,-1,-1,54,-206,-89,25,304
2529,05000US48013,"Atascosa County, Texas",690,485,787,544,1469,925,1025,1675,1609,6859,1100,830,1435,609,6380,2170,1229,1915,-410,-648,1404,-4430,-495,380,4944
2530,05000US48015,"Austin County, Texas",712,734,590,220,594,599,645,1173,1269,4955,635,905,1230,74,2680,1990,855,2815,77,-640,740,-1436,-817,414,2140
2531,05000US48017,"Bailey County, Texas",75,89,160,44,245,170,119,389,220,750,150,145,214,105,1215,170,80,215,-75,-54,184,-926,219,140,535
2532,05000US48019,"Bandera County, Texas",193,343,302,105,330,835,434,993,1005,3930,340,320,508,100,2560,1565,965,2135,-147,-206,335,-1291,-572,40,1795
2533,05000US48021,"Bastrop County, Texas",1565,1235,1320,470,1530,1915,2500,4074,3433,9345,1535,1840,2445,280,9730,5155,2105,3140,30,-1125,1720,-5315,-1081,1328,6205
2534,05000US48023,"Baylor County, Texas",70,70,145,20,75,154,154,270,239,544,110,200,60,0,845,185,64,180,-40,85,95,-537,85,175,364
2535,05000US48025,"Bee County, Texas",800,390,430,409,1119,514,552,927,812,2870,580,570,1210,795,3280,1120,240,780,220,-780,733,-2214,-193,572,2090
2536,05000US48027,"Bell County, Texas",8140,7680,11360,6605,18840,3892,3669,7889,6869,42620,3840,9260,29690,9845,23055,22615,7769,12350,4300,-18330,15600,-15494,-14726,-900,30270
2537,05000US48029,"Bexar County, Texas",55480,42920,54735,25750,80195,27820,31063,54244,43970,222400,25870,35340,137830,60040,151210,112915,39160,71190,29610,-83095,45905,-92327,-58671,4810,151210
2538,05000US48031,"Blanco County, Texas",118,171,269,138,285,232,379,452,437,1844,245,340,365,39,790,609,270,1570,-127,-96,384,-179,-157,167,274
2539,05000US48033,"Borden County, Texas",0,4,8,18,36,12,12,18,18,146,45,8,4,4,104,45,18,19,-45,4,50,-80,-27,0,127
2540,05000US48035,"Bosque County, Texas",253,299,369,219,465,257,609,894,884,3158,405,420,645,120,2575,1115,494,1505,-152,-276,564,-1709,-221,390,1653
2541,05000US48037,"Bowie County, Texas",2795,1945,2569,1053,3218,1545,1712,3084,2513,13327,1800,2465,5535,1785,9744,6073,2105,4123,995,-2966,2486,-6487,-2989,408,9204
2542,05000US48039,"Brazoria County, Texas",7985,4864,7380,4100,8550,7084,7360,13040,11429,49143,5855,12035,11730,3250,43120,27328,8905,6090,2130,-4350,9400,-28676,-14288,2524,43053
2543,05000US48041,"Brazos County, Texas",12480,6915,8740,3605,10485,2558,2200,4300,3619,23683,2360,6970,21490,11410,9029,11290,5069,10330,10120,-12750,2680,-4271,-6990,-1450,13353
2544,05000US48043,"Brewster County, Texas",271,235,509,305,449,100,313,339,298,1200,450,480,630,210,945,494,245,538,-179,-121,544,-532,-155,53,662
2545,05000US48045,"Briscoe County, Texas",26,18,47,14,58,37,69,123,107,222,55,54,53,0,314,113,35,52,-29,-6,72,-208,10,72,170
2546,05000US48047,"Brooks County, Texas",384,120,174,10,90,228,205,189,208,529,265,280,220,10,995,170,10,65,119,-46,90,-562,19,198,464
2547,05000US48049,"Brown County, Texas",820,670,830,286,1200,849,1023,1908,1628,5303,690,905,1875,325,5204,2704,739,1675,130,-1045,1161,-3332,-796,889,3628
2548,05000US48051,"Burleson County, Texas",395,190,205,150,504,494,408,814,848,2765,555,335,440,105,2955,965,370,965,-160,-235,549,-2053,-151,478,1800
2549,05000US48053,"Burnet County, Texas",709,740,879,390,1220,829,989,1969,2034,7679,645,570,2285,435,4035,2524,1530,4820,64,-1406,1175,-2217,-555,504,2859
2550,05000US48055,"Caldwell County, Texas",1155,1000,975,467,610,1009,1114,1739,1310,3889,920,2020,1225,60,5038,2140,715,799,235,-250,1017,-2915,-401,595,3090
2551,05000US48057,"Calhoun County, Texas",515,305,528,110,809,278,420,909,825,3265,565,625,935,145,2759,1490,610,780,-50,-407,774,-2061,-581,215,2485
2552,05000US48059,"Callahan County, Texas",277,121,153,168,223,698,464,819,782,2010,230,295,370,48,2945,798,310,355,47,-217,343,-1783,21,472,1655
2553,05000US48061,"Cameron County, Texas",13700,8820,6235,3054,8295,10813,10599,14854,12744,37755,7645,10075,18300,4105,49905,18545,5805,9045,6055,-12065,7244,-28493,-3691,6939,28710
2554,05000US48063,"Camp County, Texas",268,314,235,164,398,304,318,585,520,1725,200,450,585,150,1885,750,170,535,68,-350,412,-1263,-165,350,1190
2555,05000US48065,"Carson County, Texas",53,63,77,35,128,101,168,239,204,1285,115,150,63,14,1100,550,115,185,-62,14,149,-831,-311,89,1100
2556,05000US48067,"Cass County, Texas",768,388,615,324,539,688,1164,1575,1515,4774,675,900,930,105,5459,1845,643,1350,93,-315,758,-3607,-270,872,3424
2557,05000US48069,"Castro County, Texas",152,129,263,61,277,49,127,389,298,872,330,225,314,14,1035,239,109,205,-178,-51,324,-859,150,189,667
2558,05000US48071,"Chambers County, Texas",459,515,159,330,835,1190,995,1360,1370,6604,415,610,955,325,3665,4014,1345,2125,44,-796,840,-1480,-2654,25,4479
2559,05000US48073,"Cherokee County, Texas",1124,810,970,460,1369,933,1574,2285,2010,7104,1250,1085,2110,270,6844,2929,740,3000,-126,-1140,1559,-4337,-644,1270,4104
2560,05000US48075,"Childress County, Texas",169,195,124,110,423,109,143,319,224,624,200,220,314,290,775,215,110,190,-31,-190,243,-523,104,114,434
2561,05000US48077,"Clay County, Texas",128,153,137,36,148,274,279,573,574,1915,225,200,145,34,1985,825,215,534,-97,-8,150,-1432,-252,359,1381
2562,05000US48079,"Cochran County, Texas",116,24,20,15,73,89,133,146,122,334,109,110,14,8,653,69,0,45,7,6,80,-431,77,122,289
2563,05000US48081,"Coke County, Texas",139,91,83,24,108,109,123,224,162,540,180,189,49,35,790,225,105,70,-41,34,97,-558,-1,57,470
2564,05000US48083,"Coleman County, Texas",291,174,223,49,273,244,319,320,385,1124,249,330,345,75,1594,380,99,459,42,-122,247,-1031,-60,286,665
2565,05000US48085,"Collin County, Texas",14330,12610,21350,13740,49315,8448,9734,19880,17719,159410,4575,7415,55975,43385,24745,62760,39105,87799,9755,-34625,19670,-6563,-42880,-21386,71611
2566,05000US48087,"Collingsworth County, Texas",42,44,75,0,59,58,83,184,224,427,85,84,50,0,720,74,4,85,-43,25,59,-579,110,220,342
2567,05000US48089,"Colorado County, Texas",223,194,329,134,463,564,475,1004,850,3554,285,360,560,169,2775,1364,465,1800,-62,-231,428,-1736,-360,385,1754
2568,05000US48091,"Comal County, Texas",1630,2025,2320,1500,4175,1820,1850,4080,3850,24965,1115,1265,5540,3730,6270,7745,4620,17535,515,-3220,1945,-2600,-3665,-770,7430
2569,05000US48093,"Comanche County, Texas",223,169,279,123,310,458,353,735,583,2038,415,450,210,35,2190,819,264,785,-192,69,398,-1379,-84,319,1253
2570,05000US48095,"Concho County, Texas",44,39,67,34,53,46,71,81,85,313,95,75,50,4,304,119,83,113,-51,17,83,-187,-38,2,200
2571,05000US48097,"Cooke County, Texas",798,992,1268,484,1184,433,703,1495,1320,7069,1025,1275,2195,235,3995,2610,1020,2919,-227,-927,1433,-2859,-1115,300,4150
2572,05000US48099,"Coryell County, Texas",1174,1664,2215,1364,3104,784,1039,1728,1680,7779,930,2025,5105,1445,6913,3954,1190,1135,244,-2890,3023,-5090,-2226,490,6644
2573,05000US48101,"Cottle County, Texas",123,20,64,8,26,24,44,79,114,237,165,40,25,4,369,34,14,45,-42,39,30,-301,45,100,192
2574,05000US48103,"Crane County, Texas",64,43,79,18,108,100,89,170,189,708,115,135,55,20,900,195,29,29,-51,24,106,-711,-25,160,679
2575,05000US48105,"Crockett County, Texas",50,80,150,30,75,104,170,70,85,630,120,185,70,10,620,325,140,10,-70,80,95,-346,-255,-55,620
2576,05000US48107,"Crosby County, Texas",154,105,187,58,164,143,224,296,236,623,239,254,135,24,1230,170,19,30,-85,52,198,-863,126,217,593
2577,05000US48109,"Culberson County, Texas",74,61,14,24,69,53,104,101,89,190,105,49,65,29,394,65,20,19,-31,-51,64,-237,36,69,171
2578,05000US48111,"Dallam County, Texas",56,146,168,268,339,64,145,196,147,832,140,304,465,80,955,314,50,139,-84,-297,527,-746,-118,97,693
2579,05000US48113,"Dallas County, Texas",101140,82035,95400,45195,125150,38425,48649,75855,62580,247175,31130,109165,219465,89155,214905,111200,34720,102820,70010,-124065,81190,-127831,-35345,27860,144355
2580,05000US48115,"Dawson County, Texas",174,404,222,205,260,369,358,380,264,1689,469,435,269,80,2120,539,170,260,-295,-47,385,-1393,-159,94,1429
2581,05000US48117,"Deaf Smith County, Texas",344,375,309,254,865,229,283,658,657,2244,495,430,1055,160,2420,1060,325,304,-151,-746,959,-1908,-402,332,1940
2582,05000US48119,"Delta County, Texas",165,77,68,33,102,111,148,313,267,845,144,165,125,29,1070,279,70,220,21,-57,106,-811,34,197,625
2583,05000US48121,"Denton County, Texas",15720,14285,21685,12520,33415,6333,8880,17965,17025,130187,4115,11640,58225,23655,31170,58980,27989,60740,11605,-36540,22280,-15957,-41015,-10964,69447
2584,05000US48123,"DeWitt County, Texas",482,274,350,98,590,520,805,839,798,2864,524,460,650,165,2890,775,505,1384,-42,-300,523,-1565,64,293,1480
2585,05000US48125,"Dickens County, Texas",79,32,22,35,82,66,84,88,107,302,118,99,14,10,440,104,4,54,-39,8,107,-290,-16,103,248
2586,05000US48127,"Dimmit County, Texas",333,177,68,224,218,284,590,499,515,755,355,264,319,80,1675,445,170,144,-22,-251,362,-801,54,345,611
2587,05000US48129,"Donley County, Texas",60,56,39,18,123,63,111,167,161,489,105,89,84,28,678,174,19,74,-45,-45,113,-504,-7,142,415
2588,05000US48131,"Duval County, Texas",354,200,229,160,305,404,384,474,444,1100,410,355,450,45,2205,220,0,209,-56,-221,420,-1417,254,444,891
2589,05000US48133,"Eastland County, Texas",247,183,483,250,464,755,870,935,834,1835,635,595,350,35,3800,665,125,520,-388,133,679,-2175,270,709,1315
2590,05000US48135,"Ector County, Texas",2134,2285,3425,2105,7535,1979,2594,4904,4114,21510,2420,1565,6840,6655,15120,9029,4500,5735,-286,-3415,2985,-10547,-4125,-386,15775
2591,05000US48137,"Edwards County, Texas",10,15,50,4,4,74,83,60,71,305,54,20,0,4,414,69,39,39,-44,50,4,-257,-9,32,266
2592,05000US48139,"Ellis County, Texas",2894,2790,3844,1813,3380,2794,2930,5475,6032,23625,1905,4635,6950,1260,16544,13070,4044,6720,989,-3106,3933,-10820,-7595,1988,16905
2593,05000US48141,"El Paso County, Texas",22745,18430,22065,9900,27925,13605,16979,25403,21994,89845,14845,17650,47845,20745,60500,64070,18710,22140,7900,-25780,17080,-29916,-38667,3284,67705
2594,05000US48143,"Erath County, Texas",1474,785,875,469,1420,665,733,1188,1209,5257,870,845,2295,1015,3569,1919,880,2813,604,-1420,874,-2171,-731,329,2444
2595,05000US48145,"Falls County, Texas",627,217,197,181,262,459,377,720,593,2059,660,375,383,50,2784,715,170,419,-33,-186,393,-1948,5,423,1640
2596,05000US48147,"Fannin County, Texas",685,544,685,327,822,661,765,1430,1224,5268,705,795,1310,235,4704,2005,805,1764,-20,-625,914,-3278,-575,419,3504
2597,05000US48149,"Fayette County, Texas",302,274,263,145,749,721,804,1260,1355,3985,495,560,570,119,2734,1960,725,2354,-193,-307,775,-1209,-700,630,1631
2598,05000US48151,"Fisher County, Texas",101,73,59,46,182,91,93,176,169,709,188,150,110,12,945,213,60,40,-87,-51,216,-761,-37,109,669
2599,05000US48153,"Floyd County, Texas",147,108,142,54,179,149,149,234,254,969,220,184,179,45,1215,335,19,125,-73,-37,188,-917,-101,235,844
2600,05000US48155,"Foard County, Texas",10,18,29,0,50,19,43,128,99,234,60,14,30,10,374,25,35,10,-50,-1,40,-312,103,64,224
2601,05000US48157,"Fort Bend County, Texas",7185,6305,8245,5380,21685,7595,9010,17288,14713,127449,4050,3990,18345,22405,34000,50735,27240,63880,3135,-10100,4660,-17395,-33447,-12527,63569
2602,05000US48159,"Franklin County, Texas",254,173,174,80,328,210,385,570,464,1445,300,220,470,20,1275,655,305,790,-46,-296,388,-680,-85,159,655
2603,05000US48161,"Freestone County, Texas",415,303,328,152,619,396,649,1030,905,2983,365,640,725,89,3035,1014,343,1099,50,-397,682,-1990,16,562,1884
2604,05000US48163,"Frio County, Texas",329,144,229,279,375,505,370,615,519,1420,395,270,410,285,2030,625,105,415,-66,-181,369,-1155,-10,414,1005
2605,05000US48165,"Gaines County, Texas",225,210,255,104,555,365,373,769,755,2308,545,345,420,35,2175,999,680,510,-320,-165,624,-1437,-230,75,1798
2606,05000US48167,"Galveston County, Texas",9210,6544,8295,3650,11899,5464,6369,9238,8686,51228,4325,7545,19220,8495,25945,25229,11109,17700,4885,-10925,7054,-14112,-15991,-2423,33528
2607,05000US48169,"Garza County, Texas",109,44,113,90,244,14,65,170,184,785,225,160,205,4,675,219,60,160,-116,-92,330,-596,-49,124,625
2608,05000US48171,"Gillespie County, Texas",674,519,324,429,604,504,985,1305,1195,4524,650,405,1155,355,1770,1145,875,4750,24,-831,678,-281,160,320,-226
2609,05000US48173,"Glasscock County, Texas",15,64,25,4,30,33,53,36,42,212,100,24,10,0,94,115,39,95,-85,15,34,-8,-79,3,117
2610,05000US48175,"Goliad County, Texas",159,99,104,34,100,205,198,277,312,1425,254,75,130,44,940,410,209,704,-95,-26,90,-537,-133,103,721
2611,05000US48177,"Gonzales County, Texas",580,323,439,202,659,337,525,688,588,2834,660,455,925,155,2535,760,375,1175,-80,-486,706,-1673,-72,213,1659
2612,05000US48179,"Gray County, Texas",370,443,399,113,649,329,713,1045,1089,3293,510,445,870,165,3910,1073,339,775,-140,-471,597,-2868,-28,750,2518
2613,05000US48181,"Grayson County, Texas",3400,2828,2865,1730,4864,2299,3140,4969,4593,18335,2550,3240,8295,1610,15963,7890,2454,6050,850,-5430,4984,-10524,-2921,2139,12285
2614,05000US48183,"Gregg County, Texas",3515,3085,4700,1485,6010,1454,2015,3784,3399,17317,1930,2045,10600,4190,9775,7809,3739,6138,1585,-5900,3305,-6306,-4025,-340,11179
2615,05000US48185,"Grimes County, Texas",383,605,335,124,569,725,705,945,925,3970,615,615,660,109,3289,1235,845,1735,-232,-325,584,-1859,-290,80,2235
2616,05000US48187,"Guadalupe County, Texas",2160,1735,2435,1672,4760,2494,2589,5344,4957,25189,1560,2005,5790,3420,11370,13174,7150,7954,600,-3355,3012,-6287,-7830,-2193,17235
2617,05000US48189,"Hale County, Texas",1110,639,933,529,1215,367,554,952,1159,4008,1135,1310,1770,235,4450,1293,380,814,-25,-837,1509,-3529,-341,779,3194
2618,05000US48191,"Hall County, Texas",98,84,139,32,105,100,131,184,149,292,164,184,90,30,695,65,20,33,-66,49,107,-464,119,129,259
2619,05000US48193,"Hamilton County, Texas",134,200,161,53,213,217,279,319,340,1345,339,194,209,19,1205,540,135,610,-205,-48,247,-709,-221,205,735
2620,05000US48195,"Hansford County, Texas",54,139,119,75,129,189,75,299,287,767,80,155,265,14,750,319,124,208,-26,-146,190,-486,-20,163,559
2621,05000US48197,"Hardeman County, Texas",72,85,102,0,120,114,224,139,134,582,150,145,69,20,1054,95,20,49,-78,33,100,-716,44,114,533
2622,05000US48199,"Hardin County, Texas",910,362,795,435,1479,1524,1479,2168,2010,9829,535,995,2020,430,8280,3785,2144,2830,375,-1225,1484,-5277,-1617,-134,6999
2623,05000US48201,"Harris County, Texas",151315,123355,146140,69769,216620,59385,73310,117535,103565,526035,46530,136075,354945,169640,350720,257360,72130,188155,104785,-208805,116749,-218025,-139825,31435,337880
2624,05000US48203,"Harrison County, Texas",1224,1040,1134,705,1930,1565,1630,2455,2355,10159,1205,1365,2700,765,7820,4140,1685,4049,19,-1566,1870,-4625,-1685,670,6110
2625,05000US48205,"Hartley County, Texas",63,134,169,78,254,48,163,185,117,614,220,215,235,20,410,369,95,194,-157,-66,312,-199,-184,22,420
2626,05000US48207,"Haskell County, Texas",143,133,57,54,84,135,231,270,267,887,195,205,39,35,1439,173,4,88,-52,18,103,-1073,97,263,799
2627,05000US48209,"Hays County, Texas",7240,5330,5460,2480,5300,2914,2574,6575,5835,25158,2685,5320,14250,3540,11604,14073,5769,11315,4555,-8790,4240,-6116,-7498,66,13843
2628,05000US48211,"Hemphill County, Texas",89,32,70,59,178,53,23,178,163,594,75,155,165,29,485,230,140,115,14,-95,208,-409,-52,23,479
2629,05000US48213,"Henderson County, Texas",1695,1213,1479,674,2434,1663,2383,4186,3735,12533,1590,1485,3440,980,11538,4890,1930,5469,105,-1961,2128,-7492,-704,1805,7064
2630,05000US48215,"Hidalgo County, Texas",24650,13740,12975,5905,18290,21234,23254,26470,22845,71218,14420,17620,34660,8875,96395,35985,10809,16570,10230,-21685,15320,-51907,-9515,12036,54648
2631,05000US48217,"Hill County, Texas",648,644,723,262,1042,746,948,1468,1305,5321,670,890,1530,235,5099,2298,734,1750,-22,-807,1069,-3405,-830,571,3571
2632,05000US48219,"Hockley County, Texas",568,484,533,244,703,399,530,909,844,3114,685,865,780,189,3639,1060,485,430,-117,-247,758,-2710,-151,359,2684
2633,05000US48221,"Hood County, Texas",969,1028,1254,420,1460,1250,1324,2680,2300,9710,765,1445,2330,620,5465,4720,2365,4590,204,-1076,1260,-2891,-2040,-65,5120
2634,05000US48223,"Hopkins County, Texas",878,769,903,379,1168,498,882,1515,1443,5492,700,960,1980,439,4625,2040,693,1870,178,-1077,1108,-3245,-525,750,3622
2635,05000US48225,"Houston County, Texas",809,754,428,184,418,602,736,1119,929,2620,605,970,855,180,3295,1210,325,1090,204,-427,422,-1957,-91,604,1530
2636,05000US48227,"Howard County, Texas",742,695,697,220,1158,644,493,1414,1218,4240,945,595,1465,524,4660,1619,669,774,-203,-768,854,-3523,-205,549,3466
2637,05000US48229,"Hudspeth County, Texas",79,33,14,37,68,149,124,173,144,172,95,69,60,4,569,99,0,4,-16,-46,101,-296,74,144,168
2638,05000US48231,"Hunt County, Texas",3434,1775,1744,789,1889,2675,3240,3632,3153,10215,1685,4375,3285,294,14285,4420,1510,2270,1749,-1541,2384,-8370,-788,1643,7945
2639,05000US48233,"Hutchinson County, Texas",544,245,274,124,409,557,629,854,765,3479,585,285,610,114,4524,974,410,475,-41,-336,419,-3338,-120,355,3004
2640,05000US48235,"Irion County, Texas",24,14,33,0,54,58,42,70,60,335,20,45,70,4,219,113,95,110,4,-37,50,-119,-43,-35,225
2641,05000US48237,"Jack County, Texas",117,112,154,44,130,163,305,418,395,1439,184,164,159,49,1590,450,154,335,-67,-5,125,-1122,-32,241,1104
2642,05000US48239,"Jackson County, Texas",355,263,335,114,524,332,329,424,530,2150,390,490,659,40,2220,845,310,374,-35,-324,598,-1559,-421,220,1776
2643,05000US48241,"Jasper County, Texas",750,715,664,140,695,794,1164,1447,1216,4774,1055,620,1065,235,4994,2089,1105,1214,-305,-401,600,-3036,-642,111,3560
2644,05000US48243,"Jeff Davis County, Texas",0,4,59,18,120,99,96,188,188,334,79,65,30,25,364,250,94,195,-79,29,113,-169,-62,94,139
2645,05000US48245,"Jefferson County, Texas",9010,6249,6525,3660,10414,5259,5599,8165,8545,33104,5515,5675,18565,6089,31200,14395,5830,7774,3495,-12040,7985,-20342,-6230,2715,25330
2646,05000US48247,"Jim Hogg County, Texas",169,115,35,20,45,135,204,259,304,474,150,90,140,0,864,225,85,99,19,-105,65,-525,34,219,375
2647,05000US48249,"Jim Wells County, Texas",1245,830,715,324,1059,964,1179,1610,1595,4870,1215,920,1690,345,5920,1710,715,1200,30,-975,1038,-3777,-100,880,3670
2648,05000US48251,"Johnson County, Texas",2655,2835,3427,1715,3855,2965,3483,6440,6025,22905,1990,3955,7255,1285,20375,11470,4265,5465,665,-3828,4285,-13927,-5030,1760,17440
2649,05000US48253,"Jones County, Texas",269,258,218,204,529,380,494,490,505,2280,455,415,559,39,3000,510,324,405,-186,-341,694,-2126,-20,181,1875
2650,05000US48255,"Karnes County, Texas",270,153,140,192,354,341,348,402,434,1874,305,300,335,155,1815,514,260,605,-35,-195,391,-1126,-112,174,1269
2651,05000US48257,"Kaufman County, Texas",2145,1610,1955,690,1945,2568,2275,4800,4195,15595,1360,2945,3625,430,12875,10070,2790,2934,785,-1670,2205,-8032,-5270,1405,12661
2652,05000US48259,"Kendall County, Texas",650,785,720,435,1130,640,804,1355,1505,6180,510,750,1860,595,2015,1965,1830,4290,140,-1140,970,-571,-610,-325,1890
2653,05000US48261,"Kenedy County, Texas",15,25,14,25,24,20,4,0,0,8,79,25,4,0,35,0,0,4,-64,10,49,-11,0,0,4
2654,05000US48263,"Kent County, Texas",28,12,0,10,29,15,18,27,27,117,49,24,4,0,155,29,4,14,-21,-4,39,-122,-2,23,103
2655,05000US48265,"Kerr County, Texas",554,1069,1479,743,2085,930,1315,1974,2004,8790,1120,610,3025,1170,4465,2900,1570,6260,-566,-1546,1658,-2220,-926,434,2530
2656,05000US48267,"Kimble County, Texas",123,107,94,80,79,115,118,283,259,794,190,105,180,10,635,274,50,500,-67,-86,149,-402,9,209,294
2657,05000US48269,"King County, Texas",8,8,27,10,38,0,4,4,4,12,59,14,8,4,14,0,0,8,-51,19,44,-10,4,4,4
2658,05000US48271,"Kinney County, Texas",40,72,49,4,98,69,209,140,120,389,90,90,90,0,705,120,140,60,-50,-41,102,-427,20,-20,329
2659,05000US48273,"Kleberg County, Texas",1515,815,850,540,1430,440,564,763,619,3558,790,895,2295,1175,3519,1164,480,663,725,-1445,795,-2515,-401,139,2895
2660,05000US48275,"Knox County, Texas",58,22,120,4,61,94,102,159,170,627,114,100,65,0,993,99,34,20,-56,55,65,-797,60,136,607
2661,05000US48277,"Lamar County, Texas",1819,945,1545,904,1598,1040,854,2038,1798,6980,1310,1815,3045,640,6944,2795,875,2015,509,-1500,1862,-5050,-757,923,4965
2662,05000US48279,"Lamb County, Texas",197,223,307,98,568,294,529,600,534,1660,495,458,390,44,2470,525,125,295,-298,-83,622,-1647,75,409,1365
2663,05000US48281,"Lampasas County, Texas",399,322,408,220,650,438,430,779,805,3385,360,490,980,160,2280,1605,794,1160,39,-572,710,-1412,-826,11,2225
2664,05000US48283,"La Salle County, Texas",129,94,94,87,279,108,388,214,195,774,400,100,114,54,1045,188,35,335,-271,-20,312,-549,26,160,439
2665,05000US48285,"Lavaca County, Texas",263,400,329,253,648,339,584,734,673,3529,490,520,685,184,2285,1004,495,2110,-227,-356,717,-1362,-270,178,1419
2666,05000US48287,"Lee County, Texas",374,238,228,120,410,545,379,775,639,2604,435,280,650,10,1980,1060,403,1365,-61,-422,520,-1056,-285,236,1239
2667,05000US48289,"Leon County, Texas",248,243,251,148,463,381,575,948,858,2460,470,445,420,15,2670,1090,220,980,-222,-169,596,-1714,-142,638,1480
2668,05000US48291,"Liberty County, Texas",1770,1460,1310,910,1070,2414,2523,3655,3425,8664,1625,2110,2615,180,12944,3955,1109,1714,145,-1305,1800,-8007,-300,2316,6950
2669,05000US48293,"Limestone County, Texas",519,294,484,124,589,594,623,1125,975,3015,435,545,910,105,3560,1430,310,1015,84,-426,608,-2343,-305,665,2000
2670,05000US48295,"Lipscomb County, Texas",51,43,70,29,136,107,63,176,159,489,124,149,28,24,609,233,55,65,-73,42,141,-439,-57,104,424
2671,05000US48297,"Live Oak County, Texas",98,149,98,16,273,190,320,515,455,1739,250,110,170,103,1635,584,265,600,-152,-72,186,-1125,-69,190,1139
2672,05000US48299,"Llano County, Texas",349,509,390,304,470,427,655,1074,945,3949,254,525,980,270,2015,1115,615,3254,95,-590,504,-933,-41,330,695
2673,05000US48301,"Loving County, Texas",0,4,0,4,8,4,0,4,4,8,8,0,8,0,8,4,0,0,-8,-8,12,-4,0,4,8
2674,05000US48303,"Lubbock County, Texas",10440,8180,10815,4910,14254,3565,4053,7003,7548,40858,3935,6705,25010,12929,26340,16825,6770,12515,6505,-14195,6235,-18722,-9822,778,28343
2675,05000US48305,"Lynn County, Texas",262,102,96,47,162,76,118,264,312,849,355,93,165,65,913,309,84,190,-93,-69,144,-719,-45,228,659
2676,05000US48307,"McCulloch County, Texas",204,217,102,59,156,194,218,378,362,1325,195,174,310,59,1505,355,179,418,9,-208,156,-1093,23,183,907
2677,05000US48309,"McLennan County, Texas",9615,6235,7860,3875,9485,2799,4639,7634,6578,31367,4135,7365,19360,6215,22120,14500,6160,9158,5480,-11500,7145,-14682,-6866,418,22209
2678,05000US48311,"McMullen County, Texas",4,4,0,8,37,18,8,32,14,74,15,19,14,4,94,24,14,8,-11,-14,41,-68,8,0,66
2679,05000US48313,"Madison County, Texas",194,213,199,124,372,324,248,610,419,1614,340,160,460,150,1525,770,144,625,-146,-261,346,-953,-160,275,989
2680,05000US48315,"Marion County, Texas",275,172,272,39,154,439,409,512,554,1714,270,285,275,95,1950,1100,165,434,5,-3,98,-1102,-588,389,1280
2681,05000US48317,"Martin County, Texas",29,70,70,24,175,84,22,197,237,783,155,90,85,45,599,255,120,294,-126,-15,154,-493,-58,117,489
2682,05000US48319,"Mason County, Texas",129,55,108,50,105,82,84,193,169,647,195,59,155,20,310,320,115,438,-66,-47,135,-144,-127,54,209
2683,05000US48321,"Matagorda County, Texas",880,725,715,630,1495,1209,1030,1369,1289,5004,805,865,2090,685,4655,2710,625,1529,75,-1375,1440,-2416,-1341,664,3475
2684,05000US48323,"Maverick County, Texas",1570,1079,764,429,1390,1399,1774,2020,1510,4975,1390,1420,1785,650,5975,3044,1215,975,180,-1021,1169,-2802,-1024,295,4000
2685,05000US48325,"Medina County, Texas",629,480,463,385,754,1430,1280,1865,1955,6540,800,920,890,95,5800,2985,1240,2545,-171,-427,1044,-3090,-1120,715,3995
2686,05000US48327,"Menard County, Texas",44,105,54,30,89,48,49,159,154,274,170,70,80,4,430,135,4,70,-126,-26,115,-333,24,150,204
2687,05000US48329,"Midland County, Texas",2249,2615,3420,1880,8125,2125,2530,5160,4790,23185,1200,2180,7560,7360,11915,10825,4975,9325,1049,-4140,2645,-7260,-5665,-185,13860
2688,05000US48331,"Milam County, Texas",595,695,626,373,704,512,644,1073,872,3539,905,820,1080,180,3665,1270,404,1228,-310,-454,897,-2509,-197,468,2311
2689,05000US48333,"Mills County, Texas",88,47,39,43,65,123,216,216,249,840,138,50,65,25,689,339,79,474,-50,-26,83,-350,-123,170,366
2690,05000US48335,"Mitchell County, Texas",28,102,108,108,303,84,313,228,206,1037,139,279,184,25,1465,304,174,209,-111,-76,386,-1068,-76,32,828
2691,05000US48337,"Montague County, Texas",429,385,663,243,564,377,597,935,939,3354,585,460,960,259,2675,1184,425,1650,-156,-297,548,-1701,-249,514,1704
2692,05000US48339,"Montgomery County, Texas",8430,7580,11425,5845,20485,7959,10802,15130,13180,88245,6050,8235,21885,17610,36705,35370,17069,45454,2380,-10460,8720,-17944,-20240,-3889,42791
2693,05000US48341,"Moore County, Texas",310,387,535,355,838,105,277,609,565,2905,225,675,1165,370,2028,1345,410,515,85,-630,823,-1646,-736,155,2390
2694,05000US48343,"Morris County, Texas",382,278,214,77,324,174,348,825,650,1810,284,444,514,44,2240,805,195,540,98,-300,357,-1718,20,455,1270
2695,05000US48345,"Motley County, Texas",16,29,25,4,53,22,53,63,68,140,63,49,15,4,304,30,30,29,-47,10,53,-229,33,38,111
2696,05000US48347,"Nacogdoches County, Texas",2835,1915,1815,1094,2849,983,1450,1713,1649,7858,1455,2090,5335,1640,5704,3250,1299,3205,1380,-3520,2303,-3271,-1537,350,4653
2697,05000US48349,"Navarro County, Texas",1239,1083,1005,391,1705,766,1096,2168,2062,6473,1240,1055,2470,669,6648,2560,834,2229,-1,-1465,1427,-4786,-392,1228,4244
2698,05000US48351,"Newton County, Texas",254,213,92,65,205,300,565,860,704,2044,510,115,200,4,2280,770,194,720,-256,-108,266,-1415,90,510,1324
2699,05000US48353,"Nolan County, Texas",320,403,318,168,480,302,420,683,609,2137,550,339,625,185,2730,619,209,365,-230,-307,463,-2008,64,400,1772
2700,05000US48355,"Nueces County, Texas",10685,9280,10355,5220,18860,5397,6390,10483,8799,45825,6370,6870,25270,15875,33010,22235,8315,12495,4315,-14915,8205,-21223,-11752,484,33330
2701,05000US48357,"Ochiltree County, Texas",69,159,189,87,463,224,249,573,590,1239,170,265,450,110,1370,620,244,330,-101,-261,440,-897,-47,346,909
2702,05000US48359,"Oldham County, Texas",12,12,31,4,105,40,76,61,61,219,99,24,29,4,280,68,35,54,-87,2,105,-164,-7,26,165
2703,05000US48361,"Orange County, Texas",1920,1199,1559,930,2350,1830,2004,3649,3335,14520,1585,1590,4210,580,12950,5795,2569,3490,335,-2651,2700,-9116,-2146,766,11030
2704,05000US48363,"Palo Pinto County, Texas",715,645,635,320,800,511,839,923,845,4218,485,630,1645,345,4125,1294,504,1734,230,-1010,775,-2775,-371,341,2484
2705,05000US48365,"Panola County, Texas",464,290,509,190,580,643,813,1061,924,3814,620,650,605,159,3782,1485,720,1059,-156,-96,611,-2326,-424,204,2755
2706,05000US48367,"Parker County, Texas",2080,1544,2264,1215,2794,2042,2183,4738,4209,21858,1595,2620,4495,1170,11459,8340,4564,10134,485,-2231,2839,-7234,-3602,-355,11724
2707,05000US48369,"Parmer County, Texas",154,131,229,150,337,82,242,400,439,1279,275,285,340,100,1295,450,210,370,-121,-111,387,-971,-50,229,909
2708,05000US48371,"Pecos County, Texas",207,202,259,177,502,454,185,550,504,1608,385,185,700,84,2224,564,155,130,-178,-441,595,-1585,-14,349,1478
2709,05000US48373,"Polk County, Texas",969,810,795,284,1249,1214,1499,2355,2125,7100,1025,895,1690,500,7464,2704,1315,2400,-56,-895,1033,-4751,-349,810,4700
2710,05000US48375,"Potter County, Texas",4810,3980,4235,1524,3995,2675,2828,4954,3998,11545,2260,6695,7990,1605,16540,4865,1480,2460,2550,-3755,3914,-11037,89,2518,9085
2711,05000US48377,"Presidio County, Texas",415,180,153,95,208,275,269,360,290,498,415,405,180,48,1135,188,44,250,0,-27,255,-591,172,246,248
2712,05000US48379,"Rains County, Texas",184,222,191,27,346,258,520,499,435,1795,200,350,385,44,1655,635,425,630,-16,-194,329,-877,-136,10,1165
2713,05000US48381,"Randall County, Texas",2569,2040,3405,1750,5055,1255,1984,4323,4389,23555,1235,3110,8365,2095,9645,14220,4500,6604,1334,-4960,4710,-6406,-9897,-111,16951
2714,05000US48383,"Reagan County, Texas",44,43,58,40,158,80,124,59,94,473,95,105,130,25,505,164,90,70,-51,-72,173,-301,-105,4,403
2715,05000US48385,"Real County, Texas",75,4,62,29,87,101,150,129,149,352,80,49,90,40,399,229,78,194,-5,-28,76,-148,-100,71,158
2716,05000US48387,"Red River County, Texas",294,234,242,238,252,468,582,879,829,1649,369,525,300,69,2790,700,135,400,-75,-58,421,-1740,179,694,1249
2717,05000US48389,"Reeves County, Texas",204,153,70,141,463,279,374,377,379,1449,265,130,415,250,2255,255,105,109,-61,-345,354,-1602,122,274,1340
2718,05000US48391,"Refugio County, Texas",168,156,119,43,254,130,215,268,258,1167,285,144,275,49,1290,354,70,278,-117,-156,248,-945,-86,188,889
2719,05000US48393,"Roberts County, Texas",4,8,12,10,54,12,18,45,45,158,40,20,20,0,145,60,30,14,-36,-8,64,-115,-15,15,144
2720,05000US48395,"Robertson County, Texas",559,259,239,213,338,338,458,869,744,2569,505,705,380,10,2855,829,345,795,54,-141,541,-2059,40,399,1774
2721,05000US48397,"Rockwall County, Texas",850,900,1160,729,2325,925,1445,2950,2620,17345,400,620,2840,2095,4065,9060,4095,7555,450,-1680,959,-1695,-6110,-1475,9790
2722,05000US48399,"Runnels County, Texas",155,229,339,110,245,238,309,506,451,1449,285,504,259,20,1820,484,150,384,-130,80,335,-1273,22,301,1065
2723,05000US48401,"Rusk County, Texas",705,939,1099,383,1179,954,1435,1868,1857,7905,1025,970,2065,249,5908,3530,1190,3240,-320,-966,1313,-3519,-1662,667,4665
2724,05000US48403,"Sabine County, Texas",179,192,42,29,32,303,431,770,665,1519,195,78,175,15,1810,895,238,680,-16,-133,46,-1076,-125,427,839
2725,05000US48405,"San Augustine County, Texas",298,69,78,35,178,315,434,475,470,1043,325,149,159,34,1540,450,220,405,-27,-81,179,-791,25,250,638
2726,05000US48407,"San Jacinto County, Texas",369,373,329,139,381,758,1142,1279,1234,4010,330,595,540,133,3975,1848,500,1619,39,-211,387,-2075,-569,734,2391
2727,05000US48409,"San Patricio County, Texas",1530,1119,1750,819,2489,1270,1668,2171,2213,8833,1465,1250,3375,1600,8175,4389,1369,1737,65,-1625,1708,-5237,-2218,844,7096
2728,05000US48411,"San Saba County, Texas",137,173,119,60,228,111,237,266,221,738,384,164,135,15,734,229,185,340,-247,-16,273,-386,37,36,398
2729,05000US48413,"Schleicher County, Texas",60,38,25,18,99,103,54,153,129,463,145,60,40,0,700,100,40,44,-85,-15,117,-543,53,89,419
2730,05000US48415,"Scurry County, Texas",284,190,349,190,503,248,492,749,535,2540,415,370,590,135,2660,989,335,330,-131,-241,558,-1920,-240,200,2210
2731,05000US48417,"Shackelford County, Texas",75,29,27,50,94,132,98,154,170,494,95,90,60,19,700,139,60,130,-20,-33,125,-470,15,110,364
2732,05000US48419,"Shelby County, Texas",884,689,460,234,369,483,758,1145,1045,3222,1060,845,545,180,4399,1120,210,989,-176,-85,423,-3158,25,835,2233
2733,05000US48421,"Sherman County, Texas",77,28,26,22,45,28,88,167,136,474,54,80,53,14,599,149,40,94,23,-27,53,-483,18,96,380
2734,05000US48423,"Smith County, Texas",4880,5048,5585,3129,7875,3630,4549,7680,6925,30469,2800,4050,14650,5025,18819,15170,6100,12265,2080,-9065,5979,-10640,-7490,825,18204
2735,05000US48425,"Somervell County, Texas",89,228,215,109,198,188,328,220,224,1514,120,160,455,119,640,619,195,1065,-31,-240,188,-124,-399,29,449
2736,05000US48427,"Starr County, Texas",1649,979,794,220,544,2459,2212,2360,2130,3940,1305,1820,1020,29,8980,2270,575,510,344,-226,735,-4309,90,1555,3430
2737,05000US48429,"Stephens County, Texas",155,148,104,24,279,294,248,419,340,1420,230,265,205,10,1759,445,265,320,-75,-101,293,-1217,-26,75,1100
2738,05000US48431,"Sterling County, Texas",4,4,0,40,29,48,49,69,65,203,29,19,30,0,259,45,25,65,-25,-30,69,-162,24,40,138
2739,05000US48433,"Stonewall County, Texas",30,28,38,0,22,38,44,47,43,200,70,23,15,0,299,29,10,14,-40,23,22,-217,18,33,186
2740,05000US48435,"Sutton County, Texas",18,68,40,135,234,79,100,154,189,659,139,145,145,70,580,230,155,105,-121,-105,299,-401,-76,34,554
2741,05000US48437,"Swisher County, Texas",249,174,77,114,151,173,263,351,347,843,155,309,290,35,1320,349,63,79,94,-213,230,-884,2,284,764
2742,05000US48439,"Tarrant County, Texas",52325,44720,57900,30820,85320,24554,30114,54899,47620,270990,17395,47825,151630,54215,154205,137100,45410,87345,34930,-93730,61925,-99537,-82201,2210,183645
2743,05000US48441,"Taylor County, Texas",3195,3405,4804,2385,6504,1994,2302,4013,3654,18024,2345,3330,10475,4145,14235,7420,3510,4740,850,-5671,4744,-9939,-3407,144,13284
2744,05000US48443,"Terrell County, Texas",29,10,8,4,22,45,50,55,40,85,20,35,15,15,214,65,0,15,9,-7,11,-119,-10,40,70
2745,05000US48445,"Terry County, Texas",145,277,308,209,294,204,207,694,586,1559,295,330,505,130,1968,544,230,210,-150,-197,373,-1557,150,356,1349
2746,05000US48447,"Throckmorton County, Texas",57,35,33,14,48,47,69,86,78,252,120,55,20,0,374,104,25,39,-63,13,62,-258,-18,53,213
2747,05000US48449,"Titus County, Texas",593,609,765,364,1179,439,714,1250,1080,3950,475,1270,1520,250,3690,1900,625,1135,118,-755,1293,-2537,-650,455,2815
2748,05000US48451,"Tom Green County, Texas",2909,2420,4355,1389,4813,1588,2064,4342,3798,16447,2155,2575,8365,2815,12130,7364,3280,4862,754,-4010,3387,-8478,-3022,518,11585
2749,05000US48453,"Travis County, Texas",40095,31384,45020,24205,72625,13480,14735,27264,24388,158705,12040,22320,116875,62105,39055,59730,30450,108385,28055,-71855,34725,-10840,-32466,-6062,50320
2750,05000US48455,"Trinity County, Texas",335,249,238,145,354,433,800,799,769,2010,305,275,710,14,2780,1089,280,560,30,-472,485,-1547,-290,489,1450
2751,05000US48457,"Tyler County, Texas",369,189,200,59,322,682,564,1162,1034,3192,379,264,430,64,3860,1214,379,849,-10,-230,317,-2614,-52,655,2343
2752,05000US48459,"Upshur County, Texas",659,568,588,393,1027,804,900,1834,1735,6264,855,620,1320,434,4744,2685,1095,2574,-196,-732,986,-3040,-851,640,3690
2753,05000US48461,"Upton County, Texas",77,25,69,59,123,110,94,157,102,573,119,130,90,10,755,129,34,34,-42,-21,172,-551,28,68,539
2754,05000US48463,"Uvalde County, Texas",580,385,488,248,635,520,895,1139,950,3105,770,550,815,205,3779,1285,325,940,-190,-327,678,-2364,-146,625,2165
2755,05000US48465,"Val Verde County, Texas",1290,789,1340,574,1605,985,1060,1415,1458,5275,1045,1740,1810,995,5014,2453,860,1370,245,-470,1184,-2969,-1038,598,3905
2756,05000US48467,"Van Zandt County, Texas",790,820,659,509,1659,944,1488,2725,2574,8384,905,925,2110,495,6720,3520,1345,3715,-115,-1451,1673,-4288,-795,1229,4669
2757,05000US48469,"Victoria County, Texas",1980,1764,2260,1228,4065,1259,1604,2890,2530,13760,1205,1650,6100,2330,8714,5884,2920,4155,775,-3840,2963,-5851,-2994,-390,9605
2758,05000US48471,"Walker County, Texas",3635,1639,1775,870,2134,874,1105,1740,1639,6518,860,1990,5760,1440,4989,2715,1270,2490,2775,-3985,1564,-3010,-975,369,4028
2759,05000US48473,"Waller County, Texas",1430,770,1243,289,869,834,922,1660,1575,5749,530,1855,1940,295,4425,2410,1219,2275,900,-697,863,-2669,-750,356,3474
2760,05000US48475,"Ward County, Texas",209,139,118,103,633,320,299,259,278,1665,335,275,505,79,1784,509,243,239,-126,-387,657,-1165,-250,35,1426
2761,05000US48477,"Washington County, Texas",488,618,615,285,790,739,885,1410,1360,5525,495,455,1450,410,3065,2555,1335,2710,-7,-835,665,-1441,-1145,25,2815
2762,05000US48479,"Webb County, Texas",9290,4489,5179,2029,5793,4994,5553,7145,6192,23304,3340,4630,13020,5785,18279,14190,6449,7300,5950,-7841,2037,-7732,-7045,-257,16004
2763,05000US48481,"Wharton County, Texas",964,889,940,499,1675,780,1020,1388,1145,6129,1120,880,2370,585,4279,2899,965,2269,-156,-1430,1589,-2479,-1511,180,3860
2764,05000US48483,"Wheeler County, Texas",89,157,141,95,348,72,123,186,185,914,220,360,194,64,829,394,69,200,-131,-53,379,-634,-208,116,714
2765,05000US48485,"Wichita County, Texas",4205,2765,4025,1940,5840,2339,2474,4114,3905,18210,2665,3045,9930,3130,16310,7975,2235,3974,1540,-5905,4650,-11497,-3861,1670,14236
2766,05000US48487,"Wilbarger County, Texas",252,377,334,169,680,263,469,512,401,1839,389,515,775,134,2330,774,75,220,-137,-441,715,-1598,-262,326,1619
2767,05000US48489,"Willacy County, Texas",490,228,240,30,288,1069,769,724,614,1498,365,495,355,50,3678,569,100,193,125,-115,268,-1840,155,514,1305
2768,05000US48491,"Williamson County, Texas",6445,8620,11995,7600,18184,5057,6408,14544,13548,79838,2850,5880,32600,11500,21424,45570,22023,29700,3595,-20605,14284,-9959,-31026,-8475,50138
2769,05000US48493,"Wilson County, Texas",441,428,434,283,1004,913,1215,1679,1460,8304,780,465,1020,335,4585,2954,1790,3944,-339,-586,952,-2457,-1275,-330,4360
2770,05000US48495,"Winkler County, Texas",73,94,64,58,280,275,234,329,329,1018,129,180,150,95,1600,254,55,149,-56,-86,243,-1091,75,274,869
2771,05000US48497,"Wise County, Texas",999,1009,838,704,1494,990,1559,2239,2202,10268,860,804,2935,459,6767,4565,1344,4260,139,-2097,1739,-4218,-2326,858,6008
2772,05000US48499,"Wood County, Texas",638,619,764,228,905,939,1174,2144,2085,7432,630,660,1535,335,5470,2998,1464,3269,8,-771,798,-3357,-854,621,4163
2773,05000US48501,"Yoakum County, Texas",49,75,240,90,149,275,149,218,193,1185,160,240,165,30,1345,380,135,190,-111,75,209,-921,-162,58,995
2774,05000US48503,"Young County, Texas",344,290,344,225,322,340,639,979,909,3029,440,550,505,50,3225,1259,300,735,-96,-161,497,-2246,-280,609,2294
2775,05000US48505,"Zapata County, Texas",525,245,115,90,255,515,375,649,540,1360,430,600,205,0,2375,505,135,210,95,-90,345,-1485,144,405,1150
2776,05000US48507,"Zavala County, Texas",615,224,112,49,84,357,393,539,449,855,445,315,320,4,2195,168,40,84,170,-208,129,-1445,371,409,771
2777,05000US49001,"Beaver County, Utah",100,170,185,55,158,98,185,298,338,793,195,290,175,10,625,698,200,194,-95,10,203,-342,-400,138,599
2778,05000US49003,"Box Elder County, Utah",789,699,1215,529,802,560,820,2297,2097,7711,665,2095,1235,65,2195,6259,1923,2788,124,-20,1266,-815,-3962,174,4923
2779,05000US49005,"Cache County, Utah",2989,2944,3725,1404,2529,653,1462,3958,3248,14398,1360,5665,5495,1085,2225,9325,5130,6900,1629,-1770,2848,-110,-5367,-1882,7498
2780,05000US49007,"Carbon County, Utah",565,534,272,178,580,508,638,1155,905,2794,480,1030,560,65,2595,1889,575,794,85,-288,693,-1449,-734,330,2000
2781,05000US49009,"Daggett County, Utah",0,0,0,8,4,8,27,26,22,90,10,4,0,0,42,74,29,38,-10,0,12,-7,-48,-7,52
2782,05000US49011,"Davis County, Utah",3900,3884,6194,3099,5910,3499,4484,11284,11800,48582,2340,6800,12025,1815,9770,29299,17335,23045,1560,-5831,7194,-1787,-18015,-5535,25537
2783,05000US49013,"Duchesne County, Utah",387,228,415,148,529,346,445,728,703,2818,365,585,650,104,1177,1994,778,1107,22,-235,573,-386,-1266,-75,1711
2784,05000US49015,"Emery County, Utah",212,119,150,85,146,141,240,588,485,1478,280,345,90,4,1278,995,275,395,-68,60,227,-897,-407,210,1083
2785,05000US49017,"Garfield County, Utah",40,92,87,22,114,151,131,291,273,691,85,125,135,0,455,559,130,324,-45,-48,136,-173,-268,143,367
2786,05000US49019,"Grand County, Utah",195,344,202,45,364,234,290,519,420,1378,195,384,510,65,465,445,515,1293,0,-308,344,59,74,-95,85
2787,05000US49021,"Iron County, Utah",1745,1205,1125,390,1095,865,800,1998,1669,5173,1135,2160,2040,210,2073,3910,1915,2434,610,-915,1275,-408,-1912,-246,2739
2788,05000US49023,"Juab County, Utah",107,106,207,90,114,201,249,566,546,1184,150,350,123,4,745,935,430,555,-43,84,200,-295,-369,116,629
2789,05000US49025,"Kane County, Utah",73,33,158,45,168,224,304,308,247,980,85,119,269,4,403,819,275,705,-12,-111,209,125,-511,-28,275
2790,05000US49027,"Millard County, Utah",147,140,310,57,249,195,246,603,613,1773,264,445,195,10,1239,1460,225,449,-117,115,296,-798,-857,388,1324
2791,05000US49029,"Morgan County, Utah",64,135,105,19,165,52,139,473,392,1743,100,135,215,50,113,683,564,1380,-36,-110,134,78,-210,-172,363
2792,05000US49031,"Piute County, Utah",12,8,22,4,18,68,75,100,72,181,14,28,19,0,173,182,40,79,-2,3,22,-30,-82,32,102
2793,05000US49033,"Rich County, Utah",25,33,71,10,16,26,42,72,83,279,85,35,18,4,133,183,53,165,-60,53,22,-65,-111,30,114
2794,05000US49035,"Salt Lake County, Utah",24625,22160,27945,13740,33260,11853,17560,35559,32774,147340,11410,27920,67485,14915,29495,75365,49435,89865,13215,-39540,32085,-82,-39806,-16661,57475
2795,05000US49037,"San Juan County, Utah",193,115,158,98,214,713,395,564,589,1187,275,345,140,28,1370,979,430,508,-82,18,284,-262,-415,159,679
2796,05000US49039,"Sanpete County, Utah",509,419,635,139,474,333,838,1159,1063,3082,544,955,550,129,1449,2653,884,1259,-35,85,484,-278,-1494,179,1823
2797,05000US49041,"Sevier County, Utah",379,445,368,178,318,497,627,927,848,2780,395,645,600,19,1905,2165,695,906,-16,-232,477,-781,-1238,153,1874
2798,05000US49043,"Summit County, Utah",825,664,539,510,1335,687,819,803,938,7546,665,1395,835,995,1050,979,1009,7980,160,-296,850,456,-176,-71,-434
2799,05000US49045,"Tooele County, Utah",744,744,904,303,1355,539,949,2781,2441,9019,545,1230,1990,295,2659,7075,2959,2977,199,-1086,1363,-1171,-4294,-518,6042
2800,05000US49047,"Uintah County, Utah",663,244,473,288,818,624,693,1488,1221,4495,505,625,1245,144,1895,3380,1363,1869,158,-772,962,-578,-1892,-142,2626
2801,05000US49049,"Utah County, Utah",9975,8995,12780,6290,12935,4483,5879,15407,13988,66194,5910,11705,25230,8120,7835,31965,24374,41710,4065,-12450,11105,2527,-16558,-10386,24484
2802,05000US49051,"Wasatch County, Utah",413,339,547,358,1078,314,402,1094,1088,3770,200,489,1515,525,235,913,1360,3880,213,-968,911,481,181,-272,-110
2803,05000US49053,"Washington County, Utah",2704,2675,3639,1959,4689,1904,3190,6103,5573,21199,1865,2355,7995,3440,4350,7715,6320,18899,839,-4356,3208,744,-1612,-747,2300
2804,05000US49055,"Wayne County, Utah",69,49,48,38,32,79,62,161,168,332,85,120,20,8,164,289,95,239,-16,28,62,-23,-128,73,93
2805,05000US49057,"Weber County, Utah",6370,4780,4920,2820,4015,3537,4748,11000,9255,31180,3720,10545,8195,425,19160,22035,8409,9904,2650,-3275,6410,-10875,-11035,846,21276
2806,05000US50001,"Addison County, Vermont",729,700,889,408,1329,678,984,1704,1594,6164,760,900,1855,530,1294,3115,2258,4225,-31,-966,1207,368,-1411,-664,1939
2807,05000US50003,"Bennington County, Vermont",927,880,1063,302,969,708,1120,1850,1694,6155,800,800,2075,454,2077,3199,1550,4424,127,-1012,817,-249,-1349,144,1731
2808,05000US50005,"Caledonia County, Vermont",758,670,860,369,613,632,1018,1845,1741,4251,650,1050,1355,189,2695,3129,1259,2018,108,-495,793,-1045,-1284,482,2233
2809,05000US50007,"Chittenden County, Vermont",6539,4040,5064,2785,5485,2118,3091,5779,5108,26020,3175,3315,11920,5525,3594,10955,9620,17060,3364,-6856,2745,1615,-5176,-4512,8960
2810,05000US50009,"Essex County, Vermont",136,193,134,55,67,347,322,460,424,799,145,295,115,18,994,616,257,312,-9,19,104,-325,-156,167,487
2811,05000US50011,"Franklin County, Vermont",1350,839,1045,625,944,1375,1214,2530,2422,6630,1175,1700,1760,160,3505,5760,2388,2425,175,-715,1409,-916,-3230,34,4205
2812,05000US50013,"Grand Isle County, Vermont",154,95,137,51,146,199,151,492,366,1201,125,205,215,44,359,724,398,1016,29,-78,153,-9,-232,-32,185
2813,05000US50015,"Lamoille County, Vermont",770,555,644,266,739,567,717,1166,1031,4242,610,489,1460,410,1167,1812,1330,3253,160,-816,595,117,-646,-299,989
2814,05000US50017,"Orange County, Vermont",492,512,493,292,592,830,911,1492,1497,5407,495,490,1095,275,2194,3063,2030,2813,-3,-602,609,-453,-1571,-533,2594
2815,05000US50019,"Orleans County, Vermont",715,580,529,172,547,1034,1224,1659,1476,4002,600,895,980,90,3044,2840,1107,2135,115,-451,629,-786,-1181,369,1867
2816,05000US50021,"Rutland County, Vermont",1765,1680,1463,529,1579,1307,1597,2941,2824,10083,1130,1330,3775,785,4314,6344,3210,4648,635,-2312,1323,-1410,-3403,-386,5435
2817,05000US50023,"Washington County, Vermont",2052,1094,1440,679,1773,1212,1653,2468,2017,10596,1510,1420,3410,669,3395,5495,3064,6164,542,-1970,1783,-530,-3027,-1047,4432
2818,05000US50025,"Windham County, Vermont",1569,1275,1374,551,1395,923,1294,2116,2017,7176,900,1345,3165,745,2125,3465,2523,5043,669,-1791,1201,92,-1349,-506,2133
2819,05000US50027,"Windsor County, Vermont",1760,1264,1378,730,1680,1203,1528,2710,2480,10063,1100,1300,3275,1150,3610,4844,2884,6389,660,-1897,1260,-879,-2134,-404,3674
2820,05000US51001,"Accomack County, Virginia",1040,722,737,497,1065,695,738,1753,1453,5240,565,1065,1980,449,2855,2105,1229,3569,475,-1243,1113,-1422,-352,224,1671
2821,05000US51003,"Albemarle County, Virginia",2575,1939,2900,1920,5225,1619,1923,3329,3113,16249,1785,2110,7820,2840,2820,4990,4029,13869,790,-4920,4305,722,-1661,-916,2380
2822,05000US51005,"Alleghany County, Virginia",554,235,315,124,405,418,554,705,619,3034,550,350,595,149,2030,1765,415,1080,4,-280,380,-1058,-1060,204,1954
2823,05000US51007,"Amelia County, Virginia",310,170,125,70,95,320,415,690,695,2025,290,345,120,15,1355,1225,535,810,20,5,150,-620,-535,160,1215
2824,05000US51009,"Amherst County, Virginia",659,637,615,289,593,693,749,1894,1739,4929,520,1135,1040,104,2829,3369,1433,1770,139,-425,778,-1387,-1475,306,3159
2825,05000US51011,"Appomattox County, Virginia",359,299,159,88,227,348,424,702,643,2800,260,610,265,4,1779,1204,770,1104,99,-106,311,-1007,-502,-127,1696
2826,05000US51013,"Arlington County, Virginia",8739,5175,3155,4760,34944,2055,1914,1264,1484,38399,2960,2785,8340,42705,1515,825,1430,42025,5779,-5185,-3001,2454,439,54,-3626
2827,05000US51015,"Augusta County, Virginia",1145,810,1195,585,2285,1089,1865,2780,2720,14769,1135,1105,2535,1245,3545,4780,4670,10220,10,-1340,1625,-591,-2000,-1950,4549
2828,05000US51017,"Bath County, Virginia",10,55,50,195,170,140,140,255,170,635,265,145,55,15,425,360,250,400,-255,-5,350,-145,-105,-80,235
2829,05000US51019,"Bedford County, Virginia",1140,870,1020,614,2110,1729,1824,3735,3315,15494,1105,1715,2480,455,4945,6104,4150,10265,35,-1460,2269,-1392,-2369,-835,5229
2830,05000US51021,"Bland County, Virginia",109,73,99,49,110,149,190,404,429,1130,150,160,110,30,1040,565,180,330,-41,-11,129,-701,-161,249,800
2831,05000US51023,"Botetourt County, Virginia",362,273,445,179,715,845,944,1500,1355,6904,350,535,785,295,1904,3000,1700,4869,12,-340,599,-115,-1500,-345,2035
2832,05000US51025,"Brunswick County, Virginia",390,441,300,68,359,387,489,637,626,2479,520,435,439,175,2005,1234,244,1044,-130,-139,252,-1129,-597,382,1435
2833,05000US51027,"Buchanan County, Virginia",719,305,299,134,429,974,1350,1395,1294,2795,439,730,620,115,4760,1155,220,1065,280,-321,448,-2436,240,1074,1730
2834,05000US51029,"Buckingham County, Virginia",359,235,303,98,395,342,368,615,660,2489,399,290,555,164,1470,1215,650,1130,-40,-252,329,-760,-600,10,1359
2835,05000US51031,"Campbell County, Virginia",1029,1315,1240,613,1460,1580,1613,2849,2704,9225,1015,2075,2190,365,5554,5730,2645,3110,14,-950,1708,-2361,-2881,59,6115
2836,05000US51033,"Caroline County, Virginia",462,201,678,268,545,705,909,1604,1264,4489,530,489,985,145,2490,3350,1400,1645,-68,-307,668,-876,-1746,-136,2844
2837,05000US51035,"Carroll County, Virginia",545,755,614,210,635,744,1040,1800,1450,5280,865,960,825,105,4470,2705,1005,1835,-320,-211,740,-2686,-905,445,3445
2838,05000US51036,"Charles City County, Virginia",129,92,105,63,113,331,258,446,348,1139,175,160,120,25,968,835,208,433,-46,-15,151,-379,-389,140,706
2839,05000US51037,"Charlotte County, Virginia",423,213,285,78,278,407,281,454,523,1644,425,514,294,65,1479,735,250,739,-2,-9,291,-791,-281,273,905
2840,05000US51041,"Chesterfield County, Virginia",4295,4449,7233,3660,10230,4075,5255,12584,10648,59915,1690,3990,18830,5345,13800,38015,17245,22865,2605,-11597,8545,-4470,-25431,-6597,37050
2841,05000US51043,"Clarke County, Virginia",509,398,135,65,295,454,405,380,420,2475,490,615,30,260,685,685,750,2055,19,105,100,174,-305,-330,420
2842,05000US51045,"Craig County, Virginia",270,69,79,84,118,145,165,234,238,1060,225,295,69,24,530,585,224,400,45,10,178,-220,-351,14,660
2843,05000US51047,"Culpeper County, Virginia",1060,724,914,590,1270,670,985,1865,1425,7610,595,915,2325,730,1525,3290,2290,5520,465,-1411,1130,130,-1425,-865,2090
2844,05000US51049,"Cumberland County, Virginia",264,190,249,94,310,304,410,355,290,1535,240,100,645,120,980,745,320,820,24,-396,284,-266,-390,-30,715
2845,05000US51051,"Dickenson County, Virginia",564,333,288,91,213,649,618,1030,908,1728,514,515,425,18,2925,954,309,545,50,-137,286,-1658,76,599,1183
2846,05000US51053,"Dinwiddie County, Virginia",704,363,578,319,412,1064,935,1485,1220,3690,339,920,1060,59,3410,2740,885,1050,365,-482,672,-1411,-1255,335,2640
2847,05000US51057,"Essex County, Virginia",109,288,264,189,465,213,274,395,399,2018,230,119,850,120,620,860,419,1348,-121,-586,534,-133,-465,-20,670
2848,05000US51059,"Fairfax County, Virginia",21619,16289,10015,14539,64230,12384,14204,10865,15169,212694,9705,7860,21255,87860,11680,7500,20290,229410,11914,-11240,-9091,14908,3365,-5121,-16716
2849,05000US51061,"Fauquier County, Virginia",1425,884,600,555,1705,1409,1659,1394,1664,12672,1205,2305,895,775,2125,2188,3759,10980,220,-295,1485,943,-794,-2095,1692
2850,05000US51063,"Floyd County, Virginia",178,212,289,110,467,458,408,1004,719,2763,419,430,354,45,1215,1650,500,2004,-241,-65,532,-349,-646,219,759
2851,05000US51065,"Fluvanna County, Virginia",285,195,500,210,699,539,779,1450,1300,4175,430,435,865,155,1714,2945,1185,2310,-145,-365,754,-396,-1495,115,1865
2852,05000US51067,"Franklin County, Virginia",1120,1000,1195,495,999,1580,1640,2655,2515,10825,1345,1780,1575,110,4240,4845,2440,7230,-225,-380,1384,-1020,-2190,75,3595
2853,05000US51069,"Frederick County, Virginia",815,1040,1305,775,2940,1140,1485,2845,2760,15869,1035,830,3435,1570,3400,5810,4339,10320,-220,-2130,2145,-775,-2965,-1579,5549
2854,05000US51071,"Giles County, Virginia",257,262,278,246,714,329,474,930,784,3044,330,730,625,105,2030,1768,585,959,-73,-347,855,-1227,-838,199,2085
2855,05000US51073,"Gloucester County, Virginia",550,779,865,309,843,719,858,1600,1489,6834,495,1105,1505,270,1790,3833,2239,3639,55,-640,882,-213,-2233,-750,3195
2856,05000US51075,"Goochland County, Virginia",215,195,170,115,390,444,420,860,754,4864,305,245,435,85,925,1370,960,3924,-90,-265,420,-61,-510,-206,940
2857,05000US51077,"Grayson County, Virginia",500,296,291,138,194,524,904,945,1012,2323,575,610,175,55,2659,1500,380,900,-75,116,277,-1231,-555,632,1423
2858,05000US51079,"Greene County, Virginia",298,373,333,149,262,420,585,930,1045,2930,545,330,465,59,975,2139,1095,1725,-247,-132,352,30,-1209,-50,1205
2859,05000US51081,"Greensville County, Virginia",138,173,225,94,264,254,334,497,347,1499,129,195,455,110,1575,439,364,450,9,-230,248,-987,58,-17,1049
2860,05000US51083,"Halifax County, Virginia",1075,809,889,264,838,1000,1135,1594,1358,5519,1140,1485,1040,200,4465,2950,905,2019,-65,-151,902,-2330,-1356,453,3500
2861,05000US51085,"Hanover County, Virginia",1440,835,1484,815,2570,1200,1674,4198,3304,21208,975,1040,4360,760,2035,9750,7544,12289,465,-2876,2625,839,-5552,-4240,8919
2862,05000US51087,"Henrico County, Virginia",8830,6865,10635,5790,14680,4019,5459,10915,9614,50767,3995,6555,29040,7210,14305,28465,13180,24434,4835,-18405,13260,-4827,-17550,-3566,26333
2863,05000US51089,"Henry County, Virginia",1475,1305,1325,565,1264,1415,2305,2965,3050,7663,1255,2740,1695,255,8610,4415,1179,2355,220,-370,1574,-4890,-1450,1871,5308
2864,05000US51091,"Highland County, Virginia",14,49,45,4,54,89,77,162,83,515,63,75,10,20,304,200,100,455,-49,35,38,-138,-38,-17,60
2865,05000US51093,"Isle of Wight County, Virginia",810,585,645,335,845,865,610,1573,1539,6855,880,670,1200,470,2510,2035,2130,4355,-70,-555,710,-1035,-462,-591,2500
2866,05000US51095,"James City County, Virginia",1250,1135,1575,960,2355,845,1144,2345,1840,15204,745,1190,2805,2545,1550,3480,3274,13205,505,-1230,770,439,-1135,-1434,1999
2867,05000US51097,"King and Queen County, Virginia",114,44,214,30,200,150,225,244,314,1320,130,165,264,45,615,500,364,775,-16,-50,185,-240,-256,-50,545
2868,05000US51099,"King George County, Virginia",334,458,467,295,624,344,429,975,775,4284,399,840,735,214,1010,1790,1810,2343,-65,-268,705,-237,-815,-1035,1941
2869,05000US51101,"King William County, Virginia",145,243,165,120,185,287,450,815,845,2913,205,230,400,10,1185,2240,1010,869,-60,-235,295,-448,-1425,-165,2044
2870,05000US51103,"Lancaster County, Virginia",398,249,238,127,364,254,435,640,535,2117,475,300,430,155,789,844,368,1833,-77,-192,336,-100,-204,167,284
2871,05000US51105,"Lee County, Virginia",1030,690,304,150,427,758,984,1019,944,3085,875,1235,425,75,3945,1565,445,950,155,-121,502,-2203,-546,499,2135
2872,05000US51107,"Loudoun County, Virginia",4150,3840,3130,2940,12810,3740,4265,3889,4875,77413,2210,3845,5050,15755,5559,3890,9655,76279,1940,-1920,-5,2446,-1,-4780,1134
2873,05000US51109,"Louisa County, Virginia",679,464,579,348,653,969,800,1475,1650,6144,635,510,1360,225,1820,2979,1840,4269,44,-781,776,-51,-1504,-190,1875
2874,05000US51111,"Lunenburg County, Virginia",214,317,308,132,269,265,332,604,575,1734,270,470,454,59,1495,845,325,600,-56,-146,342,-898,-241,250,1134
2875,05000US51113,"Madison County, Virginia",206,204,290,209,443,240,180,464,440,2505,410,255,480,210,190,565,370,2625,-204,-190,442,230,-101,70,-120
2876,05000US51115,"Mathews County, Virginia",130,50,70,125,155,205,410,560,575,1725,115,155,240,10,655,1035,420,1295,15,-170,270,-40,-475,155,430
2877,05000US51117,"Mecklenburg County, Virginia",782,555,719,239,1007,770,864,1369,1280,4580,960,805,1190,330,3119,2380,725,2475,-178,-471,916,-1485,-1011,555,2105
2878,05000US51119,"Middlesex County, Virginia",185,179,119,173,228,354,363,538,464,2094,220,165,395,94,734,465,415,2198,-35,-276,307,-17,73,49,-104
2879,05000US51121,"Montgomery County, Virginia",5305,2490,2815,1529,3915,1030,1295,2235,2360,12985,1670,3535,8220,2625,4035,5305,3240,7140,3635,-5405,2819,-1710,-3070,-880,5845
2880,05000US51125,"Nelson County, Virginia",545,239,610,220,225,630,530,660,665,2215,900,535,310,90,1490,1090,635,1555,-355,300,355,-330,-430,30,660
2881,05000US51127,"New Kent County, Virginia",205,195,309,250,414,194,389,764,784,4155,360,470,405,140,830,1555,1460,2340,-155,-96,524,-247,-791,-676,1815
2882,05000US51131,"Northampton County, Virginia",550,262,302,314,413,304,288,434,444,1952,620,225,755,235,754,910,350,1458,-70,-453,492,-162,-476,94,494
2883,05000US51133,"Northumberland County, Virginia",274,125,230,60,173,370,490,569,763,2950,165,380,245,60,1120,784,404,3010,109,-15,173,-260,-215,359,-60
2884,05000US51135,"Nottoway County, Virginia",570,490,695,215,358,328,234,539,515,1920,450,265,1205,400,1070,1000,340,905,120,-510,173,-508,-461,175,1015
2885,05000US51137,"Orange County, Virginia",780,584,634,480,594,755,800,1500,1380,6245,770,895,1210,180,1565,3525,2075,3555,10,-576,894,-10,-2025,-695,2690
2886,05000US51139,"Page County, Virginia",540,549,483,578,788,349,533,1035,935,3909,530,860,1285,275,1059,1909,1165,2510,10,-802,1091,-177,-874,-230,1399
2887,05000US51141,"Patrick County, Virginia",543,492,282,120,324,450,785,1024,825,3085,499,835,389,50,2530,1725,410,1435,44,-107,394,-1295,-701,415,1650
2888,05000US51143,"Pittsylvania County, Virginia",1448,1197,1419,724,1854,1509,2125,3215,2800,11153,1259,2350,2675,329,7990,6414,2170,3844,189,-1256,2249,-4356,-3199,630,7309
2889,05000US51145,"Powhatan County, Virginia",85,140,364,60,365,469,755,1010,1200,5800,255,275,409,85,855,2620,2155,3460,-170,-45,340,369,-1610,-955,2340
2890,05000US51147,"Prince Edward County, Virginia",444,515,469,300,828,365,445,860,775,2540,560,640,1090,270,1320,1250,565,1590,-116,-621,858,-510,-390,210,950
2891,05000US51149,"Prince George County, Virginia",864,428,927,254,1115,333,589,1218,993,4705,305,615,2120,555,1460,3070,1573,1595,559,-1193,814,-538,-1852,-580,3110
2892,05000US51153,"Prince William County, Virginia",8060,6710,4425,5084,14065,5720,7489,6029,8708,72473,2590,6670,14115,14975,12560,13669,20275,55515,5470,-9690,4174,649,-7640,-11567,16958
2893,05000US51155,"Pulaski County, Virginia",885,549,760,449,1315,693,940,1499,1455,6314,775,1600,1335,255,3485,3020,1559,2815,110,-575,1509,-1852,-1521,-104,3499
2894,05000US51157,"Rappahannock County, Virginia",243,168,168,79,124,164,109,365,264,1465,145,125,425,80,105,335,284,1700,98,-257,123,168,30,-20,-235
2895,05000US51159,"Richmond County, Virginia",248,232,194,84,148,209,209,238,173,1388,175,179,455,109,563,654,390,729,73,-261,123,-145,-416,-217,659
2896,05000US51161,"Roanoke County, Virginia",1775,1254,1899,1235,3515,1520,1750,4170,3700,18375,1045,2145,5285,1200,3620,11955,5325,8385,730,-3386,3550,-350,-7785,-1625,9990
2897,05000US51163,"Rockbridge County, Virginia",373,334,519,155,724,369,674,1018,730,4385,464,565,625,464,1398,1490,910,3540,-91,-106,415,-355,-472,-180,845
2898,05000US51165,"Rockingham County, Virginia",1209,1185,1990,1044,2720,1163,1465,3229,3208,13854,1325,1920,3685,1225,3504,5215,4055,9875,-116,-1695,2539,-876,-1986,-847,3979
2899,05000US51167,"Russell County, Virginia",805,409,404,204,640,805,1240,1374,1235,4425,1010,1025,370,49,4455,1950,830,1590,-205,34,795,-2410,-576,405,2835
2900,05000US51169,"Scott County, Virginia",646,289,381,123,604,640,849,1189,959,3598,885,710,360,95,3724,1510,738,1145,-239,21,632,-2235,-321,221,2453
2901,05000US51171,"Shenandoah County, Virginia",950,935,1307,674,1374,639,857,1833,1468,7827,650,935,2970,675,1865,2733,2240,5518,300,-1663,1373,-369,-900,-772,2309
2902,05000US51173,"Smyth County, Virginia",1175,665,735,364,884,628,955,1648,1634,4729,1125,1520,955,210,4900,2440,570,1294,50,-220,1038,-3317,-792,1064,3435
2903,05000US51175,"Southampton County, Virginia",544,273,408,154,514,200,400,493,473,3074,620,400,700,168,1250,1250,924,1429,-76,-292,500,-650,-757,-451,1645
2904,05000US51177,"Spotsylvania County, Virginia",2644,1989,1250,1195,2740,2924,3684,3074,3890,20083,1185,3730,3465,1415,10414,6790,7490,9298,1459,-2215,2520,-3806,-3716,-3600,10785
2905,05000US51179,"Stafford County, Virginia",2085,2319,1135,1874,3564,1710,2790,2265,2678,24965,1035,3580,3860,2505,5430,5894,9480,14029,1050,-2725,2933,-930,-3629,-6802,10936
2906,05000US51181,"Surry County, Virginia",159,199,119,64,127,141,147,309,243,1364,270,150,209,35,554,579,230,810,-111,-90,156,-266,-270,13,554
2907,05000US51183,"Sussex County, Virginia",344,165,267,80,157,333,393,453,359,989,365,354,235,35,1475,569,232,185,-21,32,202,-749,-116,127,804
2908,05000US51185,"Tazewell County, Virginia",864,665,1014,199,1280,1155,1593,2369,2219,6544,1089,1385,1405,155,6770,3585,1183,2129,-225,-391,1324,-4022,-1216,1036,4415
2909,05000US51187,"Warren County, Virginia",570,555,1005,350,840,625,820,1575,1480,6729,510,845,1515,435,1380,3020,2245,4350,60,-510,755,65,-1445,-765,2379
2910,05000US51191,"Washington County, Virginia",1164,1099,924,517,1769,1065,1549,2769,2495,10069,1060,1450,2480,470,5495,3930,2635,5175,104,-1556,1816,-2881,-1161,-140,4894
2911,05000US51193,"Westmoreland County, Virginia",412,240,424,118,524,335,385,1005,634,3484,325,335,785,270,1069,1265,1160,2515,87,-361,372,-349,-260,-526,969
2912,05000US51195,"Wise County, Virginia",1540,950,799,370,994,578,1158,2160,1960,5385,1425,1545,1505,175,6039,2300,765,1585,115,-706,1189,-4303,-140,1195,3800
2913,05000US51197,"Wythe County, Virginia",550,608,580,309,805,625,889,1409,1239,5210,860,905,915,175,3250,2764,825,2445,-310,-335,939,-1736,-1355,414,2765
2914,05000US51199,"York County, Virginia",635,958,1370,719,3095,630,713,1854,1710,12790,290,370,3055,3065,1290,2755,3400,10415,345,-1685,749,53,-901,-1690,2375
2915,05000US51510,"Alexandria city, Virginia",6745,5350,3585,4200,19205,1179,1330,1250,1580,24343,2965,2070,8740,25315,1804,1565,2770,23695,3780,-5155,-1910,705,-315,-1190,648
2916,05000US51520,"Bristol city, Virginia",849,685,484,243,774,184,400,750,705,2570,530,680,1355,484,1495,1570,649,645,319,-871,533,-911,-820,56,1925
2917,05000US51530,"Buena Vista city, Virginia",180,230,310,75,185,140,170,339,284,760,215,215,470,85,590,770,160,110,-35,-160,175,-280,-431,124,650
2918,05000US51540,"Charlottesville city, Virginia",3225,1600,1880,884,2720,488,595,1163,1094,5024,1245,2060,5070,1915,935,1845,1625,3784,1980,-3190,1689,148,-682,-531,1240
2919,05000US51550,"Chesapeake city, Virginia",4325,3800,5349,2769,7955,2964,3229,7154,6995,39075,2240,2370,11430,8155,5525,15910,13050,24980,2085,-6081,2569,668,-8756,-6055,14095
2920,05000US51570,"Colonial Heights city, Virginia",540,565,680,215,629,409,465,845,494,2250,200,690,1600,135,1489,2340,520,265,340,-920,709,-615,-1495,-26,1985
2921,05000US51580,"Covington city, Virginia",175,105,200,44,75,185,150,425,325,830,80,190,270,50,1365,215,55,170,95,-70,69,-1030,210,270,660
2922,05000US51590,"Danville city, Virginia",2210,1490,1967,845,2154,625,1120,1700,1584,5090,1315,2850,3785,720,5585,2685,685,1185,895,-1818,2279,-3840,-985,899,3905
2923,05000US51595,"Emporia city, Virginia",384,314,159,129,210,69,178,88,73,535,225,215,605,165,370,240,115,175,159,-446,174,-123,-152,-42,360
2924,05000US51600,"Fairfax city, Virginia",623,430,169,230,1084,344,369,239,419,4510,205,224,475,1645,220,225,295,5210,418,-306,-331,493,14,124,-700
2925,05000US51610,"Falls Church city, Virginia",375,205,185,200,1155,88,75,85,169,2770,175,110,255,1590,59,45,80,2990,200,-70,-235,104,40,89,-220
2926,05000US51620,"Franklin city, Virginia",218,538,469,110,399,114,160,250,155,1090,190,305,1050,205,390,390,445,509,28,-581,304,-116,-140,-290,581
2927,05000US51630,"Fredericksburg city, Virginia",2125,1250,1025,539,1738,285,260,339,373,2494,860,3715,1395,705,579,458,865,2005,1265,-370,1572,-34,-119,-492,489
2928,05000US51640,"Galax city, Virginia",344,270,274,54,215,114,225,275,288,834,134,475,470,75,850,555,135,300,210,-196,194,-511,-280,153,534
2929,05000US51650,"Hampton city, Virginia",5370,4000,5444,2740,5520,2410,2679,4930,3959,17077,2130,3155,13695,4105,7340,14295,5140,4608,3240,-8251,4155,-2251,-9365,-1181,12469
2930,05000US51660,"Harrisonburg city, Virginia",2599,1830,2080,1110,2770,279,383,879,705,4252,1049,2105,5290,1955,500,1973,1795,2264,1550,-3210,1925,162,-1094,-1090,1988
2931,05000US51670,"Hopewell city, Virginia",1539,740,950,324,930,530,790,954,809,1825,890,1870,1470,244,2895,1485,245,140,649,-520,1010,-1575,-531,564,1685
2932,05000US51678,"Lexington city, Virginia",200,210,169,55,165,135,45,190,165,700,205,135,270,185,265,210,70,615,-5,-101,35,-85,-20,95,85
2933,05000US51680,"Lynchburg city, Virginia",4000,2508,3320,1155,3190,619,1285,2269,1973,8343,1845,3435,7315,1580,4149,5580,1920,2795,2155,-3995,2765,-2245,-3311,53,5548
2934,05000US51683,"Manassas city, Virginia",1085,1229,685,535,1030,549,834,665,834,5098,194,1195,2025,1145,1650,1375,2279,2908,891,-1340,420,-267,-710,-1445,2190
2935,05000US51685,"Manassas Park city, Virginia",340,180,70,255,705,305,455,324,379,1744,75,120,580,785,835,690,949,745,265,-510,175,-75,-366,-570,999
2936,05000US51690,"Martinsville city, Virginia",750,455,530,254,589,255,390,500,430,1754,445,875,1110,145,1764,925,190,345,305,-580,698,-1119,-425,240,1409
2937,05000US51700,"Newport News city, Virginia",8395,6399,8120,3845,7555,2224,2588,5639,4854,19759,4480,5370,19640,4830,8400,15045,6699,5235,3915,-11520,6570,-3588,-9406,-1845,14524
2938,05000US51710,"Norfolk city, Virginia",13885,8660,10255,4775,11818,3225,3443,5882,5018,20960,5725,7755,26440,9479,7700,16043,5709,9565,8160,-16185,7114,-1032,-10161,-691,11395
2939,05000US51720,"Norton city, Virginia",357,164,183,79,119,45,110,140,145,469,260,255,395,0,395,300,70,110,97,-212,198,-240,-160,75,359
2940,05000US51730,"Petersburg city, Virginia",2985,1440,1595,675,1040,850,765,1145,903,2090,1455,2430,3585,260,3755,1485,234,215,1530,-1990,1455,-2140,-340,669,1875
2941,05000US51735,"Poquoson city, Virginia",60,145,220,84,410,205,215,370,369,2585,50,60,615,205,195,620,685,2155,10,-395,289,225,-250,-316,430
2942,05000US51740,"Portsmouth city, Virginia",4605,3343,3724,1550,3445,1464,2123,3339,3029,10447,2300,2865,9755,1755,5695,9410,3295,2018,2305,-6031,3240,-2108,-6071,-266,8429
2943,05000US51750,"Radford city, Virginia",1248,605,455,228,410,325,223,378,418,1364,514,1095,1045,295,653,1100,360,439,734,-590,343,-105,-722,58,925
2944,05000US51760,"Richmond city, Virginia",17845,8805,10190,4960,10239,3517,3209,5999,4573,20908,8010,11925,24480,7635,10710,9435,4608,12830,9835,-14290,7564,-3984,-3436,-35,8078
2945,05000US51770,"Roanoke city, Virginia",5770,4085,4025,1964,4519,1923,2265,4029,3349,11055,2610,7030,9230,1485,9170,8190,2090,3324,3160,-5205,4998,-4982,-4161,1259,7731
2946,05000US51775,"Salem city, Virginia",459,574,1090,409,910,289,505,1004,968,3995,260,955,1980,255,1159,2840,960,1595,199,-890,1064,-365,-1836,8,2400
2947,05000US51790,"Staunton city, Virginia",749,1040,999,390,1285,264,419,795,699,3782,595,980,2269,600,1060,2323,1119,1690,154,-1270,1075,-377,-1528,-420,2092
2948,05000US51800,"Suffolk city, Virginia",2525,1869,1735,1109,2705,1450,1394,2869,2557,14314,1730,1560,4270,2384,3545,6600,5168,7564,795,-2535,1430,-701,-3731,-2611,6750
2949,05000US51810,"Virginia Beach city, Virginia",7760,7820,14025,8924,22120,4859,6755,13173,12214,71549,3585,3105,31535,22410,8670,28055,23679,48680,4175,-17510,8634,2944,-14882,-11465,22869
2950,05000US51820,"Waynesboro city, Virginia",815,625,945,420,965,415,429,1029,889,2945,505,655,2170,425,975,2285,850,1535,310,-1225,960,-131,-1256,39,1410
2951,05000US51830,"Williamsburg city, Virginia",590,469,359,290,744,97,168,269,219,1412,165,300,1155,835,138,450,355,1255,425,-796,199,127,-181,-136,157
2952,05000US51840,"Winchester city, Virginia",820,1034,1610,705,1560,150,385,770,620,3129,355,755,3615,985,525,1604,925,1945,465,-2005,1280,10,-834,-305,1184
2953,05000US53001,"Adams County, Washington",525,282,458,273,538,282,320,769,557,2015,510,640,795,140,1198,1264,569,845,15,-337,671,-596,-495,-12,1170
2954,05000US53003,"Asotin County, Washington",459,580,678,264,725,480,559,1054,919,3798,355,785,1350,205,1474,1604,1115,2505,104,-672,784,-435,-550,-196,1293
2955,05000US53005,"Benton County, Washington",4275,4605,4630,2330,6580,2945,3164,6013,5524,31043,2310,4445,12815,2855,8260,17095,8265,14685,1965,-8185,6055,-2151,-11082,-2741,16358
2956,05000US53007,"Chelan County, Washington",1320,1449,2130,1214,3244,1574,1454,2035,1995,11279,1480,1610,4465,1820,1480,2250,3385,11065,-160,-2335,2638,1548,-215,-1390,214
2957,05000US53009,"Clallam County, Washington",2030,1895,2330,1133,2399,1767,2139,3318,3174,12918,1435,1990,4620,1750,3590,4170,3160,12094,595,-2290,1782,316,-852,14,824
2958,05000US53011,"Clark County, Washington",10455,10190,13500,6773,16450,5848,7733,15330,14409,69219,5040,9380,32800,10160,9745,27355,23665,50820,5415,-19300,13063,3836,-12025,-9256,18399
2959,05000US53013,"Columbia County, Washington",106,94,112,28,173,76,174,189,175,668,94,125,260,19,364,343,204,359,12,-148,182,-114,-154,-29,309
2960,05000US53015,"Cowlitz County, Washington",3045,3015,3100,1244,3280,1634,1715,4320,3595,16828,1445,3075,7135,2040,4750,6970,5775,9949,1600,-4035,2484,-1401,-2650,-2180,6879
2961,05000US53017,"Douglas County, Washington",565,750,988,595,1454,467,958,1384,1099,6592,865,680,2080,745,1625,1558,1960,5309,-300,-1092,1304,-200,-174,-861,1283
2962,05000US53019,"Ferry County, Washington",291,146,216,53,199,290,172,353,336,994,310,290,270,34,655,490,365,688,-19,-54,218,-193,-137,-29,306
2963,05000US53021,"Franklin County, Washington",1819,1465,1900,1050,1755,1050,1490,2974,2519,10485,1065,2645,3845,445,4660,6475,2975,3820,754,-1945,2360,-2120,-3501,-456,6665
2964,05000US53023,"Garfield County, Washington",74,78,48,8,109,14,63,143,100,414,70,174,55,10,260,264,99,110,4,-7,107,-183,-121,1,304
2965,05000US53025,"Grant County, Washington",1740,1845,3110,1290,3610,1064,1753,2724,2244,11655,2265,3365,4850,1100,5339,5285,3615,5069,-525,-1740,3800,-2522,-2561,-1371,6586
2966,05000US53027,"Grays Harbor County, Washington",2174,1670,2505,1113,2058,1583,1599,2834,2374,10779,1595,2290,4670,970,5675,4709,3025,5640,579,-2165,2201,-2493,-1875,-651,5139
2967,05000US53029,"Island County, Washington",1614,1485,2445,1820,3475,1580,1785,3202,2897,14433,1175,1230,5395,3055,1884,2210,3419,16105,439,-2950,2240,1481,992,-522,-1672
2968,05000US53031,"Jefferson County, Washington",874,649,944,359,869,809,908,1525,1175,6030,700,530,1750,705,1155,1010,1025,7350,174,-806,523,562,515,150,-1320
2969,05000US53033,"King County, Washington",82770,54965,50514,38915,135340,30144,36565,44175,45330,336680,39115,70720,113385,139305,37795,46845,60645,348740,43655,-62871,34950,28914,-2670,-15315,-12060
2970,05000US53035,"Kitsap County, Washington",6610,5700,7155,3665,10270,4024,4374,9163,8702,42139,4035,5410,17705,6255,8009,15453,12794,32095,2575,-10550,7680,389,-6290,-4092,10044
2971,05000US53037,"Kittitas County, Washington",2370,1449,1358,749,1564,574,713,1317,1338,6364,925,1795,3675,1075,1025,2215,1640,5415,1445,-2317,1238,262,-898,-302,949
2972,05000US53039,"Klickitat County, Washington",584,457,676,153,793,277,331,1028,825,3320,610,510,1165,395,960,1235,850,2660,-26,-489,551,-352,-207,-25,660
2973,05000US53041,"Lewis County, Washington",1989,1770,2075,1180,2380,1604,1859,3824,3279,11188,1330,1770,4795,1470,4383,5616,3870,7454,659,-2720,2090,-920,-1792,-591,3734
2974,05000US53043,"Lincoln County, Washington",159,186,204,98,280,294,268,595,533,1960,275,345,249,60,1244,959,489,924,-116,-45,318,-682,-364,44,1036
2975,05000US53045,"Mason County, Washington",1244,1003,999,419,1614,1360,1630,2583,2352,10405,790,740,2770,950,3094,4010,2745,8505,454,-1771,1083,-104,-1427,-393,1900
2976,05000US53047,"Okanogan County, Washington",1639,1044,1374,453,1069,1013,1360,1933,1814,5984,1890,1615,1870,208,3264,2715,1629,4179,-251,-496,1314,-891,-782,185,1805
2977,05000US53049,"Pacific County, Washington",560,460,450,141,477,669,959,1328,1119,3125,570,510,825,170,1834,1834,1174,2180,-10,-375,448,-206,-506,-55,945
2978,05000US53051,"Pend Oreille County, Washington",294,283,217,94,358,500,354,769,752,2370,340,275,549,79,1060,944,544,1935,-46,-332,373,-206,-175,208,435
2979,05000US53053,"Pierce County, Washington",24009,18800,27360,14940,36105,10974,12083,25087,23068,124355,9255,16985,64345,30635,22420,50425,38630,84080,14754,-36985,20410,637,-25338,-15562,40275
2980,05000US53055,"San Juan County, Washington",417,294,434,229,632,370,568,804,730,3400,430,325,790,455,223,332,378,4959,-13,-356,406,715,472,352,-1559
2981,05000US53057,"Skagit County, Washington",3420,2580,3469,1699,4079,2072,2317,4690,4386,19769,1665,1855,8350,3400,3720,5525,4939,18405,1755,-4881,2378,669,-835,-553,1364
2982,05000US53059,"Skamania County, Washington",434,309,216,184,298,281,422,559,473,1603,415,520,490,34,519,930,420,1470,19,-274,448,184,-371,53,133
2983,05000US53061,"Snohomish County, Washington",23260,17365,16219,11089,27115,12949,15565,20405,23090,119530,11370,25875,38225,19570,23969,30210,40140,96800,11890,-22006,18634,4545,-9805,-17050,22730
2984,05000US53063,"Spokane County, Washington",16485,13920,17050,8044,17700,7162,9220,16895,14634,76320,7005,16890,39410,9920,19955,43210,20945,39690,9480,-22360,15824,-3573,-26315,-6311,36630
2985,05000US53065,"Stevens County, Washington",1089,837,1070,307,700,1042,1294,2274,1829,7479,975,1465,1280,280,2710,3439,2720,5029,114,-210,727,-374,-1165,-891,2450
2986,05000US53067,"Thurston County, Washington",7345,5545,8674,4695,12120,4158,4144,8520,8090,44174,3245,4470,20615,10040,8670,15760,15275,28960,4100,-11941,6775,-368,-7240,-7185,15214
2987,05000US53069,"Wahkiakum County, Washington",121,111,42,12,61,83,147,260,243,838,55,104,184,4,245,325,335,605,66,-142,69,-15,-65,-92,233
2988,05000US53071,"Walla Walla County, Washington",1695,1480,1669,834,2270,828,1048,2122,2244,8706,895,2250,3310,1485,2529,4150,2334,5714,800,-1641,1619,-653,-2028,-90,2992
2989,05000US53073,"Whatcom County, Washington",7730,6355,6530,3245,8059,3255,3829,7284,6539,32174,3295,4690,17385,6550,4340,5425,8145,34335,4435,-10855,4754,2744,1859,-1606,-2161
2990,05000US53075,"Whitman County, Washington",3420,2085,1625,904,1780,487,538,1116,1089,4948,1350,3810,3805,840,2084,1889,1535,2485,2070,-2180,1844,-1059,-773,-446,2463
2991,05000US53077,"Yakima County, Washington",5565,6795,7220,3555,7345,3248,4604,8903,7104,28693,4235,7235,15225,3805,12475,15939,9365,14060,1330,-8005,7095,-4623,-7036,-2261,14633
2992,05000US54001,"Barbour County, West Virginia",612,289,368,130,377,293,403,934,894,2407,615,620,510,40,2020,1078,664,870,-3,-142,467,-1324,-144,230,1537
2993,05000US54003,"Berkeley County, West Virginia",2325,1870,2465,1170,3275,1995,2670,4525,4345,18559,1895,2005,5995,1215,8985,11414,5140,6540,430,-3530,3230,-4320,-6889,-795,12019
2994,05000US54005,"Boone County, West Virginia",675,414,368,216,488,688,1020,1029,949,3728,510,720,900,35,4614,1359,335,978,165,-532,669,-2906,-330,614,2750
2995,05000US54007,"Braxton County, West Virginia",358,116,209,143,398,485,473,648,609,2218,535,435,235,30,2129,945,449,805,-177,-26,511,-1171,-297,160,1413
2996,05000US54009,"Brooke County, West Virginia",644,430,485,270,690,324,779,1235,1130,4419,565,1150,765,40,4589,1719,549,645,79,-280,920,-3486,-484,581,3774
2997,05000US54011,"Cabell County, West Virginia",4724,3270,2665,1435,3625,1773,2518,3404,2980,14473,3025,3250,7075,2350,9725,6435,3990,4794,1699,-4410,2710,-5434,-3031,-1010,9679
2998,05000US54013,"Calhoun County, West Virginia",204,48,100,0,96,238,237,533,432,1178,220,115,115,4,1449,455,184,310,-16,-15,92,-974,78,248,868
2999,05000US54015,"Clay County, West Virginia",240,160,147,45,33,440,440,540,575,1090,440,155,34,0,1790,420,300,240,-200,113,78,-910,120,275,850
3000,05000US54017,"Doddridge County, West Virginia",63,94,78,39,153,153,199,314,324,1348,280,44,99,4,945,575,173,599,-217,-21,188,-593,-261,151,749
3001,05000US54019,"Fayette County, West Virginia",1030,845,703,440,788,1134,1449,2415,2089,7359,1065,1070,1415,260,7260,3430,1295,2084,-35,-712,968,-4677,-1015,794,5275
3002,05000US54021,"Gilmer County, West Virginia",253,140,124,28,132,160,250,320,284,1108,220,295,160,12,995,445,188,375,33,-36,148,-585,-125,96,733
3003,05000US54023,"Grant County, West Virginia",171,208,165,80,246,174,439,698,640,1909,260,235,360,34,1079,784,670,1030,-89,-195,292,-466,-86,-30,879
3004,05000US54025,"Greenbrier County, West Virginia",915,704,1074,325,1149,798,1040,1905,1955,6087,870,905,1665,750,4639,2414,1460,2870,45,-591,724,-2801,-509,495,3217
3005,05000US54027,"Hampshire County, West Virginia",1083,884,719,258,503,705,800,1434,1270,2519,1790,1365,270,0,2940,1935,625,1054,-707,449,761,-1435,-501,645,1465
3006,05000US54029,"Hancock County, West Virginia",773,624,1029,225,963,658,850,1730,1490,4902,460,1515,1505,140,5595,1964,735,849,313,-476,1048,-4087,-234,755,4053
3007,05000US54031,"Hardy County, West Virginia",145,214,493,268,400,273,372,685,590,2330,245,475,710,84,1240,1305,620,1090,-100,-217,584,-595,-620,-30,1240
3008,05000US54033,"Harrison County, West Virginia",2080,1285,1400,664,1595,1340,1819,3554,2945,11959,1950,1965,2680,430,10530,4670,2353,3450,130,-1280,1829,-7371,-1116,592,8509
3009,05000US54035,"Jackson County, West Virginia",705,380,595,105,735,839,975,1388,1335,4470,860,615,880,150,3490,2795,710,1690,-155,-285,690,-1676,-1407,625,2780
3010,05000US54037,"Jefferson County, West Virginia",1464,1045,940,470,1480,975,1240,2350,2215,9069,970,1955,1990,470,4145,4915,2905,3700,494,-1050,1480,-1930,-2565,-690,5369
3011,05000US54039,"Kanawha County, West Virginia",6295,4180,4664,2410,7250,3193,5504,8503,8174,32552,5785,5490,11410,2110,27199,15435,5859,8504,510,-6746,7550,-18502,-6932,2315,24048
3012,05000US54041,"Lewis County, West Virginia",525,133,470,209,634,298,410,749,692,2494,685,420,640,220,2083,1099,524,939,-160,-170,623,-1375,-350,168,1555
3013,05000US54043,"Lincoln County, West Virginia",533,503,262,148,378,520,754,1155,1120,3180,949,460,395,15,3469,1360,500,950,-416,-133,511,-2195,-205,620,2230
3014,05000US54045,"Logan County, West Virginia",1130,675,593,193,1038,1145,1065,1814,1494,5393,1015,1205,1195,230,5615,2515,1220,1354,115,-602,1001,-3405,-701,274,4039
3015,05000US54047,"McDowell County, West Virginia",664,372,301,90,153,959,1160,1364,1358,1923,745,540,240,63,5575,365,203,175,-81,61,180,-3456,999,1155,1748
3016,05000US54049,"Marion County, West Virginia",1285,1023,1255,467,1628,1094,1899,2785,2345,9819,1250,1350,2590,459,7755,4690,1725,3030,35,-1335,1636,-4762,-1905,620,6789
3017,05000US54051,"Marshall County, West Virginia",743,633,534,217,642,644,1008,1754,1838,5333,645,1145,855,125,4833,2524,965,1700,98,-321,734,-3181,-770,873,3633
3018,05000US54053,"Mason County, West Virginia",615,538,465,144,735,705,890,1540,1525,4499,975,720,755,40,5174,1785,655,1125,-360,-290,839,-3579,-245,870,3374
3019,05000US54055,"Mercer County, West Virginia",1815,1383,1765,504,1589,1574,2179,2764,2835,9670,1565,2190,2955,350,9202,3840,2335,2950,250,-1190,1743,-5449,-1076,500,6720
3020,05000US54057,"Mineral County, West Virginia",1169,1041,805,198,533,552,735,1414,1149,3845,1395,2040,290,25,3384,2245,1125,1069,-226,515,706,-2097,-831,24,2776
3021,05000US54059,"Mingo County, West Virginia",959,710,349,255,594,998,1279,1505,1395,3510,1100,835,875,45,5178,1748,865,474,-141,-526,804,-2901,-243,530,3036
3022,05000US54061,"Monongalia County, West Virginia",5490,2580,2810,1615,3760,1618,1754,3154,2844,13823,2295,4455,6685,2830,6509,5970,3625,6534,3195,-3875,2545,-3137,-2816,-781,7289
3023,05000US54063,"Monroe County, West Virginia",174,247,314,148,265,374,445,1090,975,2320,365,480,229,80,1950,1550,470,825,-191,85,333,-1131,-460,505,1495
3024,05000US54065,"Morgan County, West Virginia",292,175,428,156,303,390,550,1365,1130,2915,290,370,645,39,1324,1555,1055,2050,2,-217,420,-384,-190,75,865
3025,05000US54067,"Nicholas County, West Virginia",664,464,505,169,394,674,689,1580,1700,4465,830,680,660,30,4329,1954,815,1460,-166,-155,533,-2966,-374,885,3005
3026,05000US54069,"Ohio County, West Virginia",1519,937,1169,480,1350,781,924,1855,1641,7702,1305,1460,2245,454,5289,3235,1210,2754,214,-1076,1376,-3584,-1380,431,4948
3027,05000US54071,"Pendleton County, West Virginia",104,142,80,105,178,228,293,479,474,1165,215,225,140,30,1040,520,280,590,-111,-60,253,-519,-41,194,575
3028,05000US54073,"Pleasants County, West Virginia",136,66,109,100,110,129,205,404,318,1403,180,100,230,10,1079,595,289,429,-44,-121,200,-745,-191,29,974
3029,05000US54075,"Pocahontas County, West Virginia",157,93,193,72,139,214,349,724,625,1450,240,210,204,10,1232,714,419,688,-83,-11,201,-669,10,206,762
3030,05000US54077,"Preston County, West Virginia",699,389,553,189,428,1103,1289,1830,1758,4644,905,920,415,10,5744,2405,920,1240,-206,138,607,-3352,-575,838,3404
3031,05000US54079,"Putnam County, West Virginia",1009,569,825,440,1240,1380,1725,2674,2920,9849,1120,1175,1405,370,6585,5489,2445,3479,-111,-580,1310,-3480,-2815,475,6370
3032,05000US54081,"Raleigh County, West Virginia",2054,1925,1470,604,2279,1399,2289,3840,3550,12943,2355,1750,3340,885,10373,5460,3504,3920,-301,-1870,1998,-6685,-1620,46,9023
3033,05000US54083,"Randolph County, West Virginia",835,533,735,169,887,638,820,1420,1289,4685,720,1060,1230,150,4040,2014,908,1554,115,-495,906,-2582,-594,381,3131
3034,05000US54085,"Ritchie County, West Virginia",258,177,103,89,186,185,283,504,459,1733,355,240,205,30,1627,599,359,470,-97,-102,245,-1159,-95,100,1263
3035,05000US54087,"Roane County, West Virginia",367,332,257,53,173,334,549,820,774,2378,535,465,169,24,2295,1045,584,748,-168,88,202,-1412,-225,190,1630
3036,05000US54089,"Summers County, West Virginia",336,269,413,103,300,229,544,779,684,1965,485,365,500,68,1985,995,560,545,-149,-87,335,-1212,-216,124,1420
3037,05000US54091,"Taylor County, West Virginia",337,233,334,129,400,409,624,657,567,2955,420,455,465,80,2629,760,720,1254,-83,-131,449,-1596,-103,-153,1701
3038,05000US54093,"Tucker County, West Virginia",176,122,98,89,73,162,214,438,419,1344,229,175,124,30,1173,443,204,654,-53,-26,132,-797,-5,215,690
3039,05000US54095,"Tyler County, West Virginia",272,125,119,89,201,132,262,504,468,1548,275,250,265,8,1354,814,309,339,-3,-146,282,-960,-310,159,1209
3040,05000US54097,"Upshur County, West Virginia",564,435,494,224,655,699,735,1124,1029,3585,745,565,920,144,2935,1619,925,1565,-181,-426,735,-1501,-495,104,2020
3041,05000US54099,"Wayne County, West Virginia",1428,635,693,404,964,1275,1230,2210,2175,6059,1470,920,1570,169,6290,3150,1259,1585,-42,-877,1199,-3785,-940,916,4474
3042,05000US54101,"Webster County, West Virginia",488,177,141,68,178,253,364,393,368,1297,470,310,260,8,1774,500,205,154,18,-119,238,-1157,-107,163,1143
3043,05000US54103,"Wetzel County, West Virginia",480,226,203,104,254,385,394,749,690,2662,360,370,480,50,2430,1279,513,570,120,-277,308,-1651,-530,177,2092
3044,05000US54105,"Wirt County, West Virginia",135,59,82,55,67,174,218,433,318,1044,200,115,85,4,1170,349,195,315,-65,-3,118,-778,84,123,729
3045,05000US54107,"Wood County, West Virginia",2430,1925,2035,995,3015,1409,2244,3920,3640,15734,2105,2460,4685,1175,10605,6700,3904,4945,325,-2650,2835,-6952,-2780,-264,10789
3046,05000US54109,"Wyoming County, West Virginia",592,318,301,60,401,746,949,1319,1185,3778,790,419,365,114,5385,1415,335,430,-198,-64,347,-3690,-96,850,3348
3047,05000US55001,"Adams County, Wisconsin",277,302,295,106,247,531,977,1388,1251,3132,310,500,395,44,3104,2118,769,1269,-33,-100,309,-1596,-730,482,1863
3048,05000US55003,"Ashland County, Wisconsin",516,507,439,287,308,369,585,848,781,2056,495,895,560,100,2410,1198,450,517,21,-121,495,-1456,-350,331,1539
3049,05000US55005,"Barron County, Wisconsin",1079,1194,1050,654,924,941,1319,2602,2326,7684,840,2265,1680,99,5327,4484,1711,2965,239,-630,1479,-3067,-1882,615,4719
3050,05000US55007,"Bayfield County, Wisconsin",247,272,260,115,252,487,664,1010,901,2979,445,350,305,30,1768,1638,763,1787,-198,-45,337,-617,-628,138,1192
3051,05000US55009,"Brown County, Wisconsin",9145,6954,8800,3875,7250,3148,5249,11030,10060,40099,3690,19820,11705,790,23520,26579,8474,9710,5455,-2905,10335,-15123,-15549,1586,30389
3052,05000US55011,"Buffalo County, Wisconsin",253,334,301,147,390,236,443,670,651,2519,380,640,300,95,1486,1498,469,945,-127,1,442,-807,-828,182,1574
3053,05000US55013,"Burnett County, Wisconsin",457,260,277,170,246,527,711,1103,976,2870,510,465,395,32,2014,1751,678,1618,-53,-118,384,-776,-648,298,1252
3054,05000US55015,"Calumet County, Wisconsin",900,775,1024,308,715,533,1149,2373,2432,9612,770,1905,900,140,5749,5993,2114,1840,130,124,883,-4067,-3620,318,7772
3055,05000US55017,"Chippewa County, Wisconsin",1428,1368,1653,702,1852,1072,1663,3097,2812,10323,1250,2625,3010,139,6275,6569,2288,3254,178,-1357,2415,-3540,-3472,524,7069
3056,05000US55019,"Clark County, Wisconsin",581,563,634,350,714,746,1157,1890,1563,4904,1025,1265,470,70,5105,2792,807,1426,-444,164,994,-3202,-902,756,3478
3057,05000US55021,"Columbia County, Wisconsin",1248,1223,1327,679,1592,837,1174,2543,2738,10413,1245,2445,2150,245,4660,6648,2358,3854,3,-823,2026,-2649,-4105,380,6559
3058,05000US55023,"Crawford County, Wisconsin",405,409,267,207,280,406,503,951,802,2559,530,655,350,38,2304,1494,438,872,-125,-83,449,-1395,-543,364,1687
3059,05000US55025,"Dane County, Wisconsin",23350,18509,19557,9390,19739,5713,7309,16820,17950,80563,7310,37575,37895,7749,19915,51294,24124,32388,16040,-18338,21380,-6893,-34474,-6174,48175
3060,05000US55027,"Dodge County, Wisconsin",1684,1951,2580,1405,2462,1180,1903,3992,3678,14017,1235,3985,4485,365,7510,9284,3003,4518,449,-1905,3502,-4427,-5292,675,9499
3061,05000US55029,"Door County, Wisconsin",498,508,848,341,664,523,904,1690,1529,6090,575,1070,1085,125,2058,2859,1438,4100,-77,-237,880,-631,-1169,91,1990
3062,05000US55031,"Douglas County, Wisconsin",1498,1103,1349,588,1615,799,1047,2182,2031,7107,1445,1965,2365,375,4955,4429,1555,1943,53,-1016,1828,-3109,-2247,476,5164
3063,05000US55033,"Dunn County, Wisconsin",1070,939,1200,698,1353,676,838,1744,1520,7007,840,1710,2295,414,3458,4499,1433,2193,230,-1095,1637,-1944,-2755,87,4814
3064,05000US55035,"Eau Claire County, Wisconsin",3554,3239,3310,1588,3359,1238,1983,4108,3902,15078,2015,5300,7260,484,7240,11135,3365,4098,1539,-3950,4463,-4019,-7027,537,10980
3065,05000US55037,"Florence County, Wisconsin",81,72,47,30,50,161,195,334,297,794,110,144,8,8,773,478,218,359,-29,39,72,-417,-144,79,435
3066,05000US55039,"Fond du Lac County, Wisconsin",2358,2465,2748,1329,3039,1304,2169,4091,4120,18612,1520,5450,4550,405,10114,10845,3654,5383,838,-1802,3963,-6641,-6754,466,13229
3067,05000US55041,"Forest County, Wisconsin",342,139,167,134,247,277,374,663,599,1332,470,415,119,8,1399,821,353,579,-128,48,373,-748,-158,246,753
3068,05000US55043,"Grant County, Wisconsin",1265,1507,1339,597,1285,843,1201,2032,1915,7833,1310,2350,2140,189,5409,4389,1552,2317,-45,-801,1693,-3365,-2357,363,5516
3069,05000US55045,"Green County, Wisconsin",834,754,1114,338,899,572,987,1737,1573,6572,845,2060,945,80,3648,4110,1363,2104,-11,169,1157,-2089,-2373,210,4468
3070,05000US55047,"Green Lake County, Wisconsin",388,487,577,208,409,357,606,894,957,3335,475,865,600,114,2309,2000,633,1241,-87,-23,503,-1346,-1106,324,2094
3071,05000US55049,"Iowa County, Wisconsin",487,539,494,273,732,426,587,1200,1089,4291,535,1105,820,74,2095,2353,968,1963,-48,-326,931,-1082,-1153,121,2328
3072,05000US55051,"Iron County, Wisconsin",236,183,154,73,71,200,293,424,348,1055,259,334,99,10,1227,393,160,638,-23,55,134,-734,31,188,417
3073,05000US55053,"Jackson County, Wisconsin",343,478,552,223,478,506,619,948,852,3330,585,1000,435,45,2553,2043,538,1079,-242,117,656,-1428,-1095,314,2251
3074,05000US55055,"Jefferson County, Wisconsin",1989,2100,2399,1267,2164,1100,1495,3897,3422,13597,1335,3890,4409,305,5380,10039,3294,4535,654,-2010,3126,-2785,-6142,128,9062
3075,05000US55057,"Juneau County, Wisconsin",476,497,502,294,578,570,1055,1333,1237,3956,485,855,885,99,3938,2339,664,1225,-9,-383,773,-2313,-1006,573,2731
3076,05000US55059,"Kenosha County, Wisconsin",5565,4310,4764,2100,4985,2520,3548,6228,5815,24387,2730,6905,10645,1475,13375,16105,5789,7210,2835,-5881,5610,-7307,-9877,26,17177
3077,05000US55061,"Kewaunee County, Wisconsin",506,282,451,183,395,424,674,1137,1089,3396,610,925,250,19,2714,2318,623,840,-104,201,559,-1616,-1181,466,2556
3078,05000US55063,"La Crosse County, Wisconsin",4110,3140,4294,2140,3314,1408,2413,4783,4369,17992,2185,7140,6650,1005,9220,12684,3724,4738,1925,-2356,4449,-5399,-7901,645,13254
3079,05000US55065,"Lafayette County, Wisconsin",316,279,456,205,379,303,423,805,795,3001,435,710,445,34,2325,1452,472,890,-119,11,550,-1599,-647,323,2111
3080,05000US55067,"Langlade County, Wisconsin",678,412,479,199,229,466,734,1098,1196,3280,630,1015,319,60,3605,1653,604,853,48,160,368,-2405,-555,592,2427
3081,05000US55069,"Lincoln County, Wisconsin",587,623,619,361,643,502,789,1545,1447,5777,620,1430,735,44,4155,2788,1034,1928,-33,-116,960,-2864,-1243,413,3849
3082,05000US55071,"Manitowoc County, Wisconsin",1615,1774,2215,1097,1818,1496,2227,4269,4090,14502,1605,4390,2230,295,11553,8694,2354,3519,10,-15,2620,-7830,-4425,1736,10983
3083,05000US55073,"Marathon County, Wisconsin",2934,3350,3044,1752,3835,1995,3186,6165,5420,24330,2075,6140,6170,520,13360,15495,4622,7015,859,-3126,5067,-8179,-9330,798,17315
3084,05000US55075,"Marinette County, Wisconsin",1183,1120,1076,380,1013,1185,1428,2567,2352,6868,1035,2240,1345,134,6960,3920,1197,2038,148,-269,1259,-4347,-1353,1155,4830
3085,05000US55077,"Marquette County, Wisconsin",187,260,298,146,328,436,579,928,885,2592,310,530,355,33,2005,1568,658,1122,-123,-57,441,-990,-640,227,1470
3086,05000US55078,"Menominee County, Wisconsin",154,119,113,14,50,137,143,154,112,389,310,130,20,0,565,150,45,125,-156,93,64,-285,4,67,264
3087,05000US55079,"Milwaukee County, Wisconsin",60085,37870,39299,18125,36965,14464,18680,31545,27825,103429,22445,79870,75005,15015,79225,67690,19734,26115,37640,-35706,40075,-46081,-36145,8091,77314
3088,05000US55081,"Monroe County, Wisconsin",1059,719,1061,683,1828,786,977,1996,1857,7454,785,1745,2485,353,4415,4839,1449,1961,274,-1424,2158,-2652,-2843,408,5493
3089,05000US55083,"Oconto County, Wisconsin",509,529,749,272,549,761,1173,2012,2004,7524,655,1340,545,70,4502,4087,1712,3014,-146,204,751,-2568,-2075,292,4510
3090,05000US55085,"Oneida County, Wisconsin",433,512,582,339,595,1088,1087,2061,1867,6994,370,865,1145,69,3584,3670,1518,4056,63,-563,865,-1409,-1609,349,2938
3091,05000US55087,"Outagamie County, Wisconsin",4314,4673,5313,2583,4414,2458,4016,8568,7986,29564,2865,11595,6455,395,19860,19825,6259,5798,1449,-1142,6602,-13386,-11257,1727,23766
3092,05000US55089,"Ozaukee County, Wisconsin",1533,1625,1909,975,2640,898,1505,3205,2950,18549,869,3405,3635,765,2245,8095,4445,11725,664,-1726,2850,158,-4890,-1495,6824
3093,05000US55091,"Pepin County, Wisconsin",133,147,136,50,96,201,236,409,357,1351,199,255,110,8,952,808,305,471,-66,26,138,-515,-399,52,880
3094,05000US55093,"Pierce County, Wisconsin",1264,964,880,383,659,649,1116,1893,1849,6158,1260,2385,425,95,4457,3618,1508,1663,4,455,947,-2692,-1725,341,4495
3095,05000US55095,"Polk County, Wisconsin",654,964,1069,311,937,896,1325,2367,1972,8203,745,1390,1550,239,4088,4968,1967,3437,-91,-481,1009,-1867,-2601,5,4766
3096,05000US55097,"Portage County, Wisconsin",2234,1818,1950,908,1893,1016,1360,2863,2899,11768,1295,4200,2980,330,5519,7985,2648,3372,939,-1030,2471,-3143,-5122,251,8396
3097,05000US55099,"Price County, Wisconsin",333,306,308,196,303,459,542,984,911,2448,495,635,223,73,2449,1483,607,806,-162,85,426,-1448,-499,304,1642
3098,05000US55101,"Racine County, Wisconsin",4664,4880,5260,2390,6255,2318,3603,6813,6135,34651,2005,6775,12465,2210,14205,17219,8229,13020,2659,-7205,6435,-8284,-10406,-2094,21631
3099,05000US55103,"Richland County, Wisconsin",543,298,394,222,497,382,552,1094,909,2889,590,805,490,65,2399,1617,508,1183,-47,-96,654,-1465,-523,401,1706
3100,05000US55105,"Rock County, Wisconsin",4190,4043,4610,2248,5100,2383,3442,6399,5146,27617,2170,6080,10855,1105,16499,16734,5053,6380,2020,-6245,6243,-10674,-10335,93,21237
3101,05000US55107,"Rusk County, Wisconsin",359,306,363,156,256,509,593,1071,860,2066,435,620,330,40,2694,1162,338,772,-76,33,372,-1592,-91,522,1294
3102,05000US55109,"St. Croix County, Wisconsin",1802,1749,1860,1189,1539,1309,1927,3721,3415,15346,1470,4265,2029,360,7800,8548,4368,4712,332,-169,2368,-4564,-4827,-953,10634
3103,05000US55111,"Sauk County, Wisconsin",1508,1690,2063,878,1890,860,1263,2896,2548,10868,1230,2695,3595,505,4495,6210,2646,4695,278,-1532,2263,-2372,-3314,-98,6173
3104,05000US55113,"Sawyer County, Wisconsin",581,503,471,208,290,440,713,956,854,2818,665,780,525,74,1657,1734,663,1746,-84,-54,424,-504,-778,191,1072
3105,05000US55115,"Shawano County, Wisconsin",820,779,1039,382,1004,897,1374,2114,2043,7181,860,2235,885,59,5260,3994,1423,2443,-40,154,1327,-2989,-1880,620,4738
3106,05000US55117,"Sheboygan County, Wisconsin",2502,3412,4045,1518,2985,1623,2752,5483,5205,19183,2765,8015,3390,270,13145,11674,3964,4629,-263,655,4233,-8770,-6191,1241,14554
3107,05000US55119,"Taylor County, Wisconsin",499,460,424,217,426,492,738,1058,1123,3546,535,1050,365,85,2968,2129,694,1045,-36,59,558,-1738,-1071,429,2501
3108,05000US55121,"Trempealeau County, Wisconsin",543,669,873,437,781,545,765,1216,1332,4989,705,1520,1035,50,2981,3075,1147,1493,-162,-162,1168,-1671,-1859,185,3496
3109,05000US55123,"Vernon County, Wisconsin",783,591,548,241,593,787,1073,1546,1409,4865,925,950,805,84,3454,2789,1160,2084,-142,-257,750,-1594,-1243,249,2781
3110,05000US55125,"Vilas County, Wisconsin",833,517,564,249,383,602,1063,1564,1443,3978,615,1015,845,65,1625,2129,1061,3882,218,-281,567,40,-565,382,96
3111,05000US55127,"Walworth County, Wisconsin",3259,2250,2880,1369,2939,1563,2149,4137,3575,16684,1750,4305,5620,1025,4855,10280,4488,8554,1509,-2740,3283,-1143,-6143,-913,8130
3112,05000US55129,"Washburn County, Wisconsin",485,229,351,189,293,450,633,971,912,2882,375,660,460,49,1982,1664,652,1392,110,-109,433,-899,-693,260,1490
3113,05000US55131,"Washington County, Wisconsin",1954,2200,2955,1595,3352,1775,2715,5775,5544,27187,1450,5175,4324,1125,6735,15139,8174,12089,504,-1369,3822,-2245,-9364,-2630,15098
3114,05000US55133,"Waukesha County, Wisconsin",5925,6198,8440,4765,11960,4335,6709,13265,13390,84559,2895,8499,19910,5960,7935,34065,27245,51759,3030,-11470,10765,3109,-20800,-13855,32800
3115,05000US55135,"Waupaca County, Wisconsin",1225,1068,1369,539,1537,843,1348,2616,2357,9547,1050,2470,1900,320,5879,5273,1778,3382,175,-531,1756,-3688,-2657,579,6165
3116,05000US55137,"Waushara County, Wisconsin",466,473,372,196,335,584,827,1569,1299,4150,440,880,455,55,3053,2544,964,1674,26,-83,476,-1642,-975,335,2476
3117,05000US55139,"Winnebago County, Wisconsin",5459,5450,5799,2539,5475,2031,3168,6878,6878,27551,3050,12545,8135,1005,17400,16414,4422,7623,2409,-2336,7009,-12201,-9536,2456,19928
3118,05000US55141,"Wood County, Wisconsin",1843,2217,1985,903,1764,1389,1998,4295,3280,13336,1290,4295,2735,395,10889,7800,2364,2822,553,-750,2272,-7502,-3505,916,10514
3119,05000US56001,"Albany County, Wyoming",3080,1775,1435,859,898,409,609,1099,1182,4964,1490,3535,2805,245,1550,2665,1405,2439,1590,-1370,1512,-532,-1566,-223,2525
3120,05000US56003,"Big Horn County, Wyoming",365,258,233,104,257,342,412,685,630,1447,615,480,134,4,1490,885,304,604,-250,99,357,-736,-200,326,843
3121,05000US56005,"Campbell County, Wyoming",1100,1000,1005,350,1560,840,1148,1450,1445,7814,830,2465,1685,30,3900,5409,2050,1605,270,-680,1880,-1912,-3959,-605,6209
3122,05000US56007,"Carbon County, Wyoming",365,151,410,244,648,533,430,732,591,2194,610,515,640,55,1739,1734,544,569,-245,-230,837,-776,-1002,47,1625
3123,05000US56009,"Converse County, Wyoming",300,245,370,125,470,235,540,674,620,2255,685,435,315,75,1210,1430,829,800,-385,55,520,-435,-756,-209,1455
3124,05000US56011,"Crook County, Wyoming",52,78,138,75,282,165,303,350,353,1350,189,335,94,4,579,660,574,639,-137,44,353,-111,-310,-221,711
3125,05000US56013,"Fremont County, Wyoming",983,790,1135,399,1155,778,1315,2144,1593,5283,1515,1625,1185,155,3280,3595,1340,2623,-532,-50,1399,-1187,-1451,253,2660
3126,05000US56015,"Goshen County, Wyoming",305,299,359,63,238,500,383,844,648,1965,410,650,210,10,1710,1345,465,665,-105,149,291,-827,-501,183,1300
3127,05000US56017,"Hot Springs County, Wyoming",128,126,89,78,118,169,247,347,239,788,155,260,99,4,810,564,135,279,-27,-10,192,-394,-217,104,509
3128,05000US56019,"Johnson County, Wyoming",255,80,349,185,199,294,305,517,564,1285,240,415,330,80,565,650,385,1110,15,19,304,34,-133,179,175
3129,05000US56021,"Laramie County, Wyoming",2300,1985,3159,1164,3170,1579,1995,4050,3695,16052,1350,4090,5345,1019,5545,10220,4665,6500,950,-2186,3315,-1971,-6170,-970,9552
3130,05000US56023,"Lincoln County, Wyoming",179,284,422,131,508,413,683,895,785,2967,340,735,374,65,1258,2148,664,1609,-161,48,574,-162,-1253,121,1358
3131,05000US56025,"Natrona County, Wyoming",1940,2025,2720,1488,2830,1525,1950,3535,3125,12650,1630,4155,4230,990,5028,8435,3760,5070,310,-1510,3328,-1553,-4900,-635,7580
3132,05000US56027,"Niobrara County, Wyoming",100,45,55,35,50,107,114,172,92,251,130,125,20,10,315,205,54,124,-30,35,75,-94,-33,38,127
3133,05000US56029,"Park County, Wyoming",525,559,765,399,1030,404,810,1399,1505,4689,750,1535,930,65,1494,2465,1370,3335,-225,-165,1364,-280,-1066,135,1354
3134,05000US56031,"Platte County, Wyoming",259,216,149,55,219,245,415,619,514,1319,349,450,84,0,1068,964,375,535,-90,65,274,-408,-345,139,784
3135,05000US56033,"Sheridan County, Wyoming",855,754,1075,505,928,700,810,1574,1260,4955,790,1825,1295,219,1610,2275,1445,3675,65,-220,1214,-100,-701,-185,1280
3136,05000US56035,"Sublette County, Wyoming",67,154,215,38,314,119,114,450,435,1455,348,135,270,25,395,810,515,825,-281,-55,327,-162,-360,-80,630
3137,05000US56037,"Sweetwater County, Wyoming",1173,705,769,470,1149,1063,979,1725,1505,6900,925,1780,1400,154,4035,4810,1849,1505,248,-631,1465,-1993,-3085,-344,5395
3138,05000US56039,"Teton County, Wyoming",385,590,705,470,1510,400,245,369,539,3490,655,565,1515,925,550,465,170,3965,-270,-810,1055,95,-96,369,-475
3139,05000US56041,"Uinta County, Wyoming",545,653,188,260,489,488,553,983,958,2949,555,1375,194,25,1834,2260,592,954,-10,-6,724,-793,-1277,366,1995
3140,05000US56043,"Washakie County, Wyoming",204,203,254,68,113,217,320,469,454,1265,290,445,90,4,1005,905,275,474,-86,164,177,-468,-436,179,791
3141,05000US56045,"Weston County, Wyoming",189,59,129,150,199,294,244,430,385,1245,194,345,145,65,1040,545,410,440,-5,-16,284,-502,-115,-25,805
3142,05000US72001,"Adjuntas Municipio, Puerto Rico",1059,398,499,149,679,774,372,515,510,1399,1455,265,705,375,615,609,400,1740,-396,-206,453,531,-94,110,-341
3143,05000US72003,"Aguada Municipio, Puerto Rico",925,590,565,350,815,1180,1015,1795,1695,4575,1580,320,750,600,595,1595,1870,5710,-655,-185,565,1600,200,-175,-1135
3144,05000US72005,"Aguadilla Municipio, Puerto Rico",3255,960,1515,513,2105,1119,910,2285,2084,7530,3690,1280,935,2450,965,1025,1645,9715,-435,580,168,1064,1260,439,-2185
3145,05000US72007,"Aguas Buenas Municipio, Puerto Rico",1060,549,435,325,520,800,835,1188,1009,2365,1755,365,535,225,665,1210,925,3010,-695,-100,620,970,-22,84,-645
3146,05000US72009,"Aibonito Municipio, Puerto Rico",420,325,289,164,495,810,390,1050,1050,3745,400,205,380,715,630,825,635,5100,20,-91,-56,570,225,415,-1355
3147,05000US72011,"Añasco Municipio, Puerto Rico",374,338,495,310,523,749,610,1215,1128,4070,960,280,360,450,595,1080,1310,4375,-586,135,383,764,135,-182,-305
3148,05000US72013,"Arecibo Municipio, Puerto Rico",4115,1215,1790,755,2495,2663,1910,3224,3344,11854,4975,1170,1865,2340,3095,2790,3458,13170,-860,-75,910,1478,434,-114,-1316
3149,05000US72015,"Arroyo Municipio, Puerto Rico",445,290,139,105,305,645,555,940,695,2275,235,55,390,605,740,630,555,3175,210,-251,-195,460,310,140,-900
3150,05000US72017,"Barceloneta Municipio, Puerto Rico",820,405,120,185,585,1275,780,1205,970,2220,1010,220,460,420,1100,1265,960,2890,-190,-340,350,955,-60,10,-670
3151,05000US72019,"Barranquitas Municipio, Puerto Rico",755,375,424,105,405,1115,720,1045,800,3579,545,245,525,740,829,1185,840,4535,210,-101,-230,1006,-140,-40,-956
3152,05000US72021,"Bayamón Municipio, Puerto Rico",7000,2955,3375,1905,6285,3890,4204,6300,5705,29265,7650,2510,3940,7400,2280,4245,7285,36320,-650,-565,790,5814,2055,-1580,-7055
3153,05000US72023,"Cabo Rojo Municipio, Puerto Rico",2300,1005,1045,775,1735,940,950,1194,1334,5615,4085,885,805,1085,615,955,605,7794,-1785,240,1425,1275,239,729,-2179
3154,05000US72025,"Caguas Municipio, Puerto Rico",4670,1800,3030,1218,4940,3244,2645,4640,4225,20449,5140,1645,3400,5470,1854,2850,4745,25690,-470,-370,688,4035,1790,-520,-5241
3155,05000US72027,"Camuy Municipio, Puerto Rico",1155,615,700,235,840,750,555,1545,1570,4220,1595,570,655,720,1075,750,1115,5435,-440,45,355,230,795,455,-1215
3156,05000US72029,"Canóvanas Municipio, Puerto Rico",1295,569,655,200,635,1498,1210,2040,1955,5475,1855,340,495,655,1700,1905,1675,6320,-560,160,180,1008,135,280,-845
3157,05000US72031,"Carolina Municipio, Puerto Rico",4555,2390,3170,2235,7290,2880,2860,5135,4750,29330,6230,2000,3115,8295,2275,3020,5630,34595,-1675,55,1230,3465,2115,-880,-5265
3158,05000US72033,"Cataño Municipio, Puerto Rico",1560,420,770,169,670,693,660,810,535,3015,1930,405,565,695,444,835,944,3400,-370,205,144,909,-25,-409,-385
3159,05000US72035,"Cayey Municipio, Puerto Rico",1560,1060,1180,405,1455,980,1169,1715,1575,5865,2675,475,1525,980,1010,1290,1975,6865,-1115,-345,880,1139,425,-400,-1000
3160,05000US72037,"Ceiba Municipio, Puerto Rico",200,165,210,160,415,510,505,495,440,1424,430,95,405,225,340,629,1200,1275,-230,-195,350,675,-134,-760,149
3161,05000US72039,"Ciales Municipio, Puerto Rico",729,155,444,220,445,540,390,690,720,1974,1135,110,485,255,510,435,455,2619,-406,-41,410,420,255,265,-645
3162,05000US72041,"Cidra Municipio, Puerto Rico",1200,560,750,275,1055,919,1000,1635,1445,4684,1855,410,860,710,750,1374,1595,5795,-655,-110,620,1169,261,-150,-1111
3163,05000US72043,"Coamo Municipio, Puerto Rico",970,384,475,289,1155,1513,995,1445,1270,5855,995,220,790,1275,1315,2015,1135,6325,-25,-315,169,1193,-570,135,-470
3164,05000US72045,"Comerío Municipio, Puerto Rico",1045,405,430,150,214,884,448,790,724,1284,1275,345,495,135,844,1100,680,1324,-230,-65,229,488,-310,44,-40
3165,05000US72047,"Corozal Municipio, Puerto Rico",970,205,335,300,430,2305,1260,1550,1320,3015,1170,285,525,275,1645,2450,1880,2960,-200,-190,455,1920,-900,-560,55
3166,05000US72049,"Culebra Municipio, Puerto Rico",22,8,32,26,67,14,28,65,65,228,40,14,19,90,34,79,4,253,-18,13,3,8,-14,61,-25
3167,05000US72051,"Dorado Municipio, Puerto Rico",675,400,435,305,935,1075,704,1240,1204,5550,1160,290,365,935,935,1310,1015,6185,-485,70,305,844,-70,189,-635
3168,05000US72053,"Fajardo Municipio, Puerto Rico",1480,735,734,375,989,980,729,1275,1089,4264,1815,615,770,1120,814,1220,2054,4550,-335,-36,244,895,55,-965,-286
3169,05000US72054,"Florida Municipio, Puerto Rico",575,95,240,20,130,515,575,515,610,1155,440,165,340,110,155,730,1440,920,135,-100,40,935,-215,-830,235
3170,05000US72055,"Guánica Municipio, Puerto Rico",489,265,355,113,222,854,360,680,629,1604,775,250,180,245,275,650,1035,3189,-286,175,90,939,30,-406,-1585
3171,05000US72057,"Guayama Municipio, Puerto Rico",1360,700,950,365,710,1720,760,1880,1900,5395,1335,405,975,1375,1355,1715,1290,7015,25,-25,-300,1125,165,610,-1620
3172,05000US72059,"Guayanilla Municipio, Puerto Rico",645,340,405,150,460,525,410,664,738,2414,1025,500,310,165,585,689,785,2659,-380,95,445,350,-25,-47,-245
3173,05000US72061,"Guaynabo Municipio, Puerto Rico",1880,1250,1500,615,3440,1775,1590,2950,2810,16360,3070,855,1425,3335,984,1940,2035,20590,-1190,75,720,2381,1010,775,-4230
3174,05000US72063,"Gurabo Municipio, Puerto Rico",595,339,460,185,1100,1289,995,1460,1384,8029,960,300,360,1060,994,1275,1105,9539,-365,100,225,1290,185,279,-1510
3175,05000US72065,"Hatillo Municipio, Puerto Rico",1114,515,880,255,960,1205,1135,1765,1645,5655,1500,445,850,920,1585,1010,1465,6835,-386,30,295,755,755,180,-1180
3176,05000US72067,"Hormigueros Municipio, Puerto Rico",463,330,303,185,340,400,475,690,635,2409,520,270,445,390,195,480,1229,2850,-57,-142,135,680,210,-594,-441
3177,05000US72069,"Humacao Municipio, Puerto Rico",1745,915,1180,335,780,1520,1655,2505,2305,6420,2225,715,1035,975,1630,3610,2520,6150,-480,145,140,1545,-1105,-215,270
3178,05000US72071,"Isabela Municipio, Puerto Rico",1740,805,975,270,1775,1230,955,1700,1725,4850,1910,875,1090,1680,710,915,1410,7080,-170,-115,365,1475,785,315,-2230
3179,05000US72073,"Jayuya Municipio, Puerto Rico",534,259,259,14,738,415,280,650,515,1369,720,205,565,305,280,624,325,1850,-186,-306,447,415,26,190,-481
3180,05000US72075,"Juana Díaz Municipio, Puerto Rico",1199,653,674,355,1165,1470,1020,2035,1930,6216,1770,710,775,800,1915,2230,1423,6483,-571,-101,720,575,-195,507,-267
3181,05000US72077,"Juncos Municipio, Puerto Rico",1610,550,760,170,600,1120,1255,1555,1230,4025,1780,670,910,330,1045,1295,2010,4885,-170,-150,440,1330,260,-780,-860
3182,05000US72079,"Lajas Municipio, Puerto Rico",1299,580,665,265,685,565,400,835,825,2294,2275,415,500,304,535,840,395,2905,-976,165,646,430,-5,430,-611
3183,05000US72081,"Lares Municipio, Puerto Rico",1690,510,795,315,1080,1035,825,735,635,2684,2280,670,995,450,845,940,1010,2995,-590,-200,945,1015,-205,-375,-311
3184,05000US72083,"Las Marías Municipio, Puerto Rico",525,95,80,55,170,299,239,290,239,1160,460,130,275,65,350,610,245,900,65,-195,160,188,-320,-6,260
3185,05000US72085,"Las Piedras Municipio, Puerto Rico",1375,400,435,270,720,1335,1090,1580,1565,4320,1650,175,685,690,1055,1580,1900,4990,-275,-250,300,1370,0,-335,-670
3186,05000US72087,"Loíza Municipio, Puerto Rico",995,225,580,158,555,1338,850,1010,945,2685,1400,375,455,300,985,1100,1499,2980,-405,125,413,1203,-90,-554,-295
3187,05000US72089,"Luquillo Municipio, Puerto Rico",715,345,340,60,485,505,475,865,810,2375,780,330,280,570,315,625,1105,2870,-65,60,-25,665,240,-295,-495
3188,05000US72091,"Manatí Municipio, Puerto Rico",1895,590,500,260,875,1840,1530,1930,1710,5225,1640,580,1090,820,1265,2485,2410,5905,255,-590,315,2105,-555,-700,-680
3189,05000US72093,"Maricao Municipio, Puerto Rico",225,93,80,35,75,235,200,165,130,610,335,65,55,49,250,240,135,785,-110,25,61,185,-75,-5,-175
3190,05000US72095,"Maunabo Municipio, Puerto Rico",254,150,145,70,315,300,189,635,605,1670,405,185,200,140,335,490,310,1900,-151,-55,245,154,145,295,-230
3191,05000US72097,"Mayagüez Municipio, Puerto Rico",6055,1590,1814,819,2045,2454,1751,2559,2510,9010,4700,1500,3245,2880,2040,3205,3235,10115,1355,-1431,-16,2165,-646,-725,-1105
3192,05000US72099,"Moca Municipio, Puerto Rico",1460,710,635,285,1245,1595,1040,1660,1465,3675,1960,490,1040,830,1180,1155,1185,5305,-500,-405,700,1455,505,280,-1630
3193,05000US72101,"Morovis Municipio, Puerto Rico",1045,259,839,205,654,1024,955,1485,1495,2830,1515,469,730,285,1435,1335,1220,3220,-470,109,574,544,150,275,-390
3194,05000US72103,"Naguabo Municipio, Puerto Rico",815,185,470,70,185,755,775,1480,1290,2790,795,320,525,90,1205,1635,2055,1930,20,-55,165,325,-155,-765,860
3195,05000US72105,"Naranjito Municipio, Puerto Rico",629,375,263,235,330,1100,970,1310,1265,2725,930,279,445,185,1415,1430,1270,2795,-301,-182,380,655,-120,-5,-70
3196,05000US72107,"Orocovis Municipio, Puerto Rico",860,164,370,145,585,659,500,820,770,2290,1150,325,425,229,585,830,480,2875,-290,-55,501,574,-10,290,-585
3197,05000US72109,"Patillas Municipio, Puerto Rico",795,280,335,75,425,640,435,735,760,2080,1135,165,320,295,340,805,340,3100,-340,15,205,735,-70,420,-1020
3198,05000US72111,"Peñuelas Municipio, Puerto Rico",633,214,274,145,494,579,520,804,834,2865,875,295,310,294,670,1170,869,2749,-242,-36,345,429,-366,-35,116
3199,05000US72113,"Ponce Municipio, Puerto Rico",8205,2835,2909,1240,3504,4609,3210,5193,4923,18689,9140,2845,2525,4190,4564,4920,5485,21020,-935,384,554,3255,273,-562,-2331
3200,05000US72115,"Quebradillas Municipio, Puerto Rico",885,550,585,280,890,580,615,755,675,2855,1300,530,605,760,195,605,445,4220,-415,-20,410,1000,150,230,-1365
3201,05000US72117,"Rincón Municipio, Puerto Rico",490,170,154,234,334,345,330,590,605,2075,675,135,195,365,140,320,565,2830,-185,-41,203,535,270,40,-755
3202,05000US72119,"Río Grande Municipio, Puerto Rico",908,834,808,420,799,1500,1050,1994,1849,6315,1670,250,870,989,1074,1925,2494,6975,-762,-62,230,1476,69,-645,-660
3203,05000US72121,"Sabana Grande Municipio, Puerto Rico",560,304,444,130,443,582,682,1055,1014,2885,835,329,290,430,294,819,744,4969,-275,154,143,970,236,270,-2084
3204,05000US72123,"Salinas Municipio, Puerto Rico",685,245,500,95,504,1330,690,1665,1509,4189,670,275,525,565,1410,1485,990,5074,15,-25,34,610,180,519,-885
3205,05000US72125,"San Germán Municipio, Puerto Rico",1030,720,530,265,795,1080,850,1484,1349,4475,1220,570,610,945,1105,1260,905,5535,-190,-80,115,825,224,444,-1060
3206,05000US72127,"San Juan Municipio, Puerto Rico",25040,8695,10804,4835,17665,6744,6159,9459,8067,50564,23120,7855,14200,21875,5175,6995,7140,62910,1920,-3396,625,7728,2464,927,-12346
3207,05000US72129,"San Lorenzo Municipio, Puerto Rico",1100,489,633,310,720,1465,1215,1984,1830,4820,1285,295,1100,580,1050,1655,1865,6165,-185,-467,450,1630,329,-35,-1345
3208,05000US72131,"San Sebastián Municipio, Puerto Rico",1705,740,1015,505,1365,1620,910,1480,1525,4075,2360,610,1500,860,710,1165,1325,6070,-655,-485,1010,1820,315,200,-1995
3209,05000US72133,"Santa Isabel Municipio, Puerto Rico",750,120,410,100,694,934,500,905,885,2945,480,340,455,805,460,960,695,3644,270,-45,-11,974,-55,190,-699
3210,05000US72135,"Toa Alta Municipio, Puerto Rico",965,605,485,370,1270,2090,1240,2610,2590,11060,1225,465,645,1355,1430,2450,2020,13010,-260,-160,285,1900,160,570,-1950
3211,05000US72137,"Toa Baja Municipio, Puerto Rico",1995,1140,1224,680,2295,2390,1878,2820,2675,11605,2595,950,1565,2205,1490,2510,3300,13995,-600,-341,770,2778,310,-625,-2390
3212,05000US72139,"Trujillo Alto Municipio, Puerto Rico",1720,1005,1565,700,3050,1040,1125,1735,1540,11360,3085,905,1630,2425,1000,1150,2165,12460,-1365,-65,1325,1165,585,-625,-1100
3213,05000US72141,"Utuado Municipio, Puerto Rico",1370,265,659,275,880,805,575,909,944,3345,1805,515,710,430,880,874,1105,3660,-435,-51,725,500,35,-161,-315
3214,05000US72143,"Vega Alta Municipio, Puerto Rico",1320,515,810,350,855,1345,1130,1720,1560,3605,1625,580,860,790,685,1770,1610,4845,-305,-50,415,1790,-50,-50,-1240
3215,05000US72145,"Vega Baja Municipio, Puerto Rico",1049,270,565,190,830,2870,2124,2135,1919,6210,1125,430,774,565,1425,2620,3135,8115,-76,-209,455,3569,-485,-1216,-1905
3216,05000US72147,"Vieques Municipio, Puerto Rico",160,45,85,50,215,214,155,380,380,1010,195,95,40,220,180,120,100,1800,-35,45,45,189,260,280,-790
3217,05000US72149,"Villalba Municipio, Puerto Rico",575,315,384,250,664,650,614,815,860,2864,1175,210,555,250,825,1090,660,3139,-600,-171,664,439,-275,200,-275
3218,05000US72151,"Yabucoa Municipio, Puerto Rico",1630,615,570,175,395,1375,1180,1690,1459,3465,1900,580,555,360,1570,2870,1765,2440,-270,15,210,985,-1180,-306,1025
3219,05000US72153,"Yauco Municipio, Puerto Rico",885,560,400,93,628,1345,845,1219,1130,3995,1500,440,304,309,625,1015,1465,7219,-615,96,412,1565,204,-335,-3224
